//MAP CONVERTED BY dmm2tgm.py THIS HEADER COMMENT PREVENTS RECONVERSION, DO NOT REMOVE
"aa" = (
/turf/open/asphalt{
	icon_state = "tile"
	},
/area/desert_dam/exterior/valley/valley_medical)
"af" = (
/obj/structure/platform{
	dir = 1
	},
/obj/structure/platform{
	dir = 4
	},
/turf/open/auto_turf/ice/layer1,
/area/desert_dam/exterior/river/riverside_south)
"ah" = (
/turf/open/asphalt/cement_sunbleached{
	icon_state = "cement_sunbleached2"
	},
/area/desert_dam/exterior/valley/valley_medical)
"am" = (
/turf/open/asphalt/cement_sunbleached{
	icon_state = "cement_sunbleached9"
	},
/area/desert_dam/exterior/valley/valley_medical)
"ao" = (
/turf/open/asphalt/cement_sunbleached{
	icon_state = "cement_sunbleached14"
	},
/area/desert_dam/exterior/valley/valley_medical)
"ap" = (
/turf/open/asphalt/cement_sunbleached{
	icon_state = "cement_sunbleached12"
	},
/area/desert_dam/exterior/valley/valley_medical)
"aq" = (
/turf/open/asphalt/cement_sunbleached,
/area/desert_dam/exterior/valley/valley_medical)
"ar" = (
/turf/open/asphalt/cement_sunbleached{
	icon_state = "cement_sunbleached1"
	},
/area/desert_dam/exterior/valley/valley_medical)
"as" = (
/obj/structure/stairs,
/obj/structure/platform{
	dir = 8
	},
/turf/open/asphalt{
	icon_state = "tile"
	},
/area/desert_dam/exterior/valley/valley_medical)
"at" = (
/obj/structure/stairs,
/obj/structure/platform{
	dir = 4
	},
/turf/open/asphalt{
	icon_state = "tile"
	},
/area/desert_dam/exterior/valley/valley_medical)
"au" = (
/turf/open/asphalt/cement_sunbleached{
	icon_state = "cement_sunbleached3"
	},
/area/desert_dam/exterior/valley/valley_medical)
"av" = (
/obj/structure/platform_decoration{
	dir = 8;
	icon_state = "platform_deco"
	},
/turf/open/auto_turf/ice/layer1,
/area/desert_dam/exterior/river/riverside_south)
"ax" = (
/obj/structure/platform{
	dir = 1
	},
/turf/open/auto_turf/snow/layer2,
/area/desert_dam/exterior/river/riverside_south)
"ay" = (
/obj/structure/platform_decoration{
	dir = 4;
	icon_state = "platform_deco"
	},
/turf/open/auto_turf/snow/layer2,
/area/desert_dam/exterior/valley/valley_medical)
"az" = (
/obj/structure/platform_decoration{
	dir = 8;
	icon_state = "platform_deco"
	},
/turf/open/auto_turf/snow/layer2,
/area/desert_dam/exterior/valley/valley_medical)
"aA" = (
/obj/structure/platform{
	dir = 1
	},
/obj/structure/platform{
	dir = 4
	},
/turf/open/auto_turf/snow/layer2,
/area/desert_dam/exterior/valley/valley_medical)
"aD" = (
/turf/open/auto_turf/snow/layer2,
/area/desert_dam/exterior/valley/valley_medical)
"aE" = (
/obj/structure/platform{
	dir = 4
	},
/turf/open/auto_turf/snow/layer2,
/area/desert_dam/exterior/valley/valley_medical)
"aJ" = (
/turf/closed/wall/shiva/ice,
/area/desert_dam/exterior/rock)
"aM" = (
/obj/structure/platform_decoration,
/turf/open/auto_turf/ice/layer1,
/area/desert_dam/exterior/river/riverside_south)
"aQ" = (
/obj/structure/platform{
	dir = 4
	},
/obj/structure/platform,
/turf/open/auto_turf/ice/layer1,
/area/desert_dam/exterior/river/riverside_south)
"aV" = (
/turf/open/asphalt/cement_sunbleached{
	icon_state = "cement_sunbleached4"
	},
/area/desert_dam/exterior/river/riverside_south)
"aW" = (
/turf/open/asphalt/cement_sunbleached{
	icon_state = "cement_sunbleached4"
	},
/area/desert_dam/exterior/valley/valley_medical)
"aY" = (
/turf/open/asphalt/cement_sunbleached{
	icon_state = "cement_sunbleached12"
	},
/area/desert_dam/exterior/river/riverside_south)
"aZ" = (
/turf/open/asphalt/cement_sunbleached{
	icon_state = "cement_sunbleached15"
	},
/area/desert_dam/exterior/valley/valley_medical)
"ba" = (
/obj/structure/platform{
	dir = 1
	},
/obj/structure/platform{
	dir = 8
	},
/turf/open/auto_turf/ice/layer1,
/area/desert_dam/exterior/river/riverside_south)
"bd" = (
/obj/structure/platform{
	dir = 1
	},
/turf/open/auto_turf/ice/layer1,
/area/desert_dam/exterior/river/riverside_south)
"bi" = (
/obj/structure/catwalk/bigred,
/turf/open/auto_turf/ice/layer1,
/area/desert_dam/exterior/river/riverside_south)
"bk" = (
/obj/structure/platform{
	dir = 4
	},
/turf/open/auto_turf/ice/layer1,
/area/desert_dam/exterior/river/riverside_south)
"bl" = (
/turf/open/asphalt/cement_sunbleached,
/area/desert_dam/exterior/river/riverside_south)
"bp" = (
/obj/structure/platform{
	dir = 4
	},
/turf/open/auto_turf/snow/layer2,
/area/desert_dam/exterior/river/riverside_south)
"bq" = (
/obj/structure/platform{
	dir = 8
	},
/turf/open/auto_turf/ice/layer1,
/area/desert_dam/exterior/river/riverside_south)
"br" = (
/turf/open/auto_turf/ice/layer1,
/area/desert_dam/exterior/river/riverside_south)
"bs" = (
/obj/structure/platform,
/obj/structure/platform{
	dir = 4
	},
/turf/open/auto_turf/snow/layer2,
/area/desert_dam/exterior/river/riverside_south)
"bt" = (
/obj/structure/platform,
/obj/structure/platform{
	dir = 8
	},
/turf/open/auto_turf/ice/layer1,
/area/desert_dam/exterior/river/riverside_south)
"bu" = (
/obj/structure/platform,
/turf/open/auto_turf/ice/layer1,
/area/desert_dam/exterior/river/riverside_south)
"bv" = (
/obj/structure/platform_decoration{
	dir = 1;
	icon_state = "platform_deco"
	},
/turf/open/auto_turf/ice/layer1,
/area/desert_dam/exterior/river/riverside_south)
"bx" = (
/turf/open/asphalt{
	icon_state = "tile"
	},
/area/desert_dam/exterior/valley/valley_cargo)
"by" = (
/obj/structure/largecrate/random/barrel/blue,
/turf/open/asphalt{
	icon_state = "tile"
	},
/area/desert_dam/exterior/valley/valley_cargo)
"bz" = (
/obj/structure/largecrate/random/barrel/white,
/turf/open/asphalt{
	icon_state = "tile"
	},
/area/desert_dam/exterior/valley/valley_cargo)
"bA" = (
/obj/structure/platform{
	dir = 8
	},
/turf/open/auto_turf/snow/layer2,
/area/desert_dam/exterior/river/riverside_south)
"bB" = (
/turf/open/auto_turf/snow/layer2,
/area/desert_dam/exterior/river/riverside_south)

(1,1,1) = {"
aa
af
bk
bk
av
br
br
br
br
br
aM
bk
bk
bk
bk
bk
bk
bk
bk
bp
bs
bx
"}
(2,1,1) = {"
aa
aa
aa
aa
bd
br
br
br
br
br
bu
bi
bi
bi
bi
bi
bi
bi
bl
bl
bl
bx
"}
(3,1,1) = {"
aD
ah
ao
aa
ax
br
br
br
br
br
bu
bi
bi
bi
bi
bi
bi
bi
bl
bl
bl
bx
"}
(4,1,1) = {"
aD
aq
ap
as
ay
aD
br
br
aJ
br
bu
bi
bi
ba
bq
bq
bq
bq
bq
bq
bt
bx
"}
(5,1,1) = {"
aD
aq
ap
at
az
aD
aD
aJ
aJ
aJ
bu
bi
bi
bd
br
br
br
br
br
br
bu
by
"}
(6,1,1) = {"
aq
aq
ap
aa
aA
aE
aE
aJ
aJ
aJ
aQ
aV
aY
bd
br
br
br
br
br
br
bu
bz
"}
(7,1,1) = {"
aq
aq
ap
aa
aa
aa
aa
aa
aa
aa
aa
aW
ap
bd
br
br
br
br
br
br
bu
by
"}
(8,1,1) = {"
aa
aW
aq
au
au
au
au
au
au
au
au
aq
ap
bd
br
br
br
br
br
br
bv
bA
"}
(9,1,1) = {"
aa
am
ar
ar
ar
ar
ar
ar
ar
ar
ar
ar
aZ
bd
br
br
br
br
br
br
br
bB
"}
(10,1,1) = {"
aD
aD
aD
aD
aD
aD
aD
aD
aD
aD
aD
aD
aD
bd
br
br
br
br
br
br
br
br
"}
