"aa" = (/turf/closed/mineral,/area/lv624/ground/caves/central2)
"ab" = (/turf/open/gm/grass,/area/lv624/ground/caves/central2)
"ac" = (/obj/structure/jungle/planttop1,/turf/open/gm/grass,/area/lv624/ground/caves/central2)
"ad" = (/obj/structure/jungle/plantbot1,/turf/open/gm/grass,/area/lv624/ground/caves/central2)
"ae" = (/turf/closed/gm/dense{icon_state = "wall2"},/area/lv624/ground/caves/central2)
"af" = (/turf/open/gm/dirtgrassborder{icon_state = "grassdirt_corner"},/area/lv624/ground/caves/central2)
"ag" = (/turf/open/gm/dirtgrassborder,/area/lv624/ground/caves/central2)
"ah" = (/turf/closed/wall/wood,/area/lv624/ground/caves/central2)
"ai" = (/obj/structure/window_frame/wood,/turf/open/floor/wood,/area/lv624/ground/caves/central2)
"aj" = (/turf/open/gm/dirtgrassborder{dir = 1; icon_state = "grassdirt_corner"},/area/lv624/ground/caves/central2)
"ak" = (/turf/open/gm/dirtgrassborder{dir = 4},/area/lv624/ground/caves/central2)
"al" = (/turf/open/gm/dirt,/area/lv624/ground/caves/central2)
"am" = (/obj/structure/bed/alien,/turf/open/floor/wood,/area/lv624/ground/caves/central2)
"an" = (/obj/structure/closet/cabinet,/turf/open/floor/wood,/area/lv624/ground/caves/central2)
"ao" = (/turf/open/floor/wood,/area/lv624/ground/caves/central2)
"ap" = (/obj/structure/table/woodentable/poor,/obj/item/tool/candle,/obj/item/tool/match{pixel_x = 6; pixel_y = 3},/obj/item/explosive/grenade/frag/m15,/obj/item/weapon/gun/shotgun/pump/cmb,/obj/item/ammo_magazine/shotgun/buckshot,/turf/open/floor/wood,/area/lv624/ground/caves/central2)
"aq" = (/obj/structure/table/woodentable/poor,/obj/item/explosive/grenade/frag/m15,/obj/item/weapon/gun/shotgun/pump/cmb,/obj/item/ammo_magazine/shotgun/buckshot,/turf/open/floor/wood,/area/lv624/ground/caves/central2)
"ar" = (/turf/open/gm/dirtgrassborder{dir = 4; icon_state = "grassdirt_corner2"},/area/lv624/ground/caves/central2)
"as" = (/obj/structure/flora/ausbushes/fullgrass,/turf/open/gm/dirt,/area/lv624/ground/caves/central2)
"at" = (/turf/open/gm/dirtgrassborder{icon_state = "grassdirt_corner2"},/area/lv624/ground/caves/central2)
"au" = (/obj/structure/barricade/metal{dir = 4},/turf/open/gm/grass,/area/lv624/ground/caves/central2)
"av" = (/obj/structure/curtain/red,/turf/open/floor/wood,/area/lv624/ground/caves/central2)
"aw" = (/turf/open/gm/coast{icon_state = "beachcorner"},/area/lv624/ground/caves/central2)
"ax" = (/turf/open/gm/coast,/area/lv624/ground/caves/central2)
"ay" = (/turf/open/gm/coast{dir = 1; icon_state = "beachcorner"},/area/lv624/ground/caves/central2)
"az" = (/turf/open/gm/coast{dir = 4},/area/lv624/ground/caves/central2)
"aA" = (/turf/open/gm/river,/area/lv624/ground/caves/central2)
"aB" = (/turf/open/gm/coast{dir = 1; icon_state = "beachcorner2"},/area/lv624/ground/caves/central2)
"aC" = (/turf/open/gm/coast{dir = 2; icon_state = "beachcorner2"},/area/lv624/ground/caves/central2)
"aD" = (/turf/open/gm/dirtgrassborder{dir = 8},/area/lv624/ground/caves/central2)
"aE" = (/turf/open/gm/coast{tag = "icon-beach (SOUTHEAST)"; icon_state = "beach"; dir = 6},/area/lv624/ground/caves/central2)
"aF" = (/obj/structure/jungle/plantbot1{icon_state = "alienplant1"; luminosity = 2},/turf/open/gm/river,/area/lv624/ground/caves/central2)
"aG" = (/obj/structure/flora/ausbushes/reedbush,/turf/open/gm/river,/area/lv624/ground/caves/central2)
"aH" = (/obj/effect/landmark{name = "surv_spawn"; pixel_x = -1},/turf/open/gm/grass,/area/lv624/ground/caves/central2)
"aI" = (/obj/structure/table/woodentable/poor,/obj/item/weapon/gun/shotgun/pump/cmb,/obj/item/ammo_magazine/revolver/small,/obj/item/ammo_magazine/revolver/small,/turf/open/floor/wood,/area/lv624/ground/caves/central2)
"aJ" = (/obj/structure/table/woodentable/poor,/obj/item/device/flashlight/lantern,/obj/item/weapon/gun/shotgun/pump/cmb,/obj/item/ammo_magazine/revolver/small,/obj/item/ammo_magazine/revolver/small,/turf/open/floor/wood,/area/lv624/ground/caves/central2)
"aK" = (/obj/item/weapon/gun/revolver/small,/turf/open/gm/dirtgrassborder,/area/lv624/ground/caves/central2)
"aL" = (/obj/structure/barricade/metal{dir = 4},/turf/open/gm/dirtgrassborder,/area/lv624/ground/caves/central2)
"aM" = (/obj/structure/barricade/metal{dir = 4},/turf/open/gm/dirt,/area/lv624/ground/caves/central2)
"aN" = (/obj/item/weapon/gun/revolver/small,/turf/open/gm/dirt,/area/lv624/ground/caves/central2)
"aO" = (/obj/structure/barricade/metal{dir = 8},/turf/open/gm/grass,/area/lv624/ground/caves/central2)
"aP" = (/obj/structure/barricade/metal{dir = 8},/obj/structure/barricade/metal,/turf/open/gm/grass,/area/lv624/ground/caves/central2)
"aQ" = (/obj/structure/barricade/metal,/turf/open/gm/grass,/area/lv624/ground/caves/central2)
"aR" = (/obj/structure/barricade/metal,/turf/open/gm/dirtgrassborder{icon_state = "grassdirt_corner"},/area/lv624/ground/caves/central2)
"aS" = (/obj/structure/barricade/metal,/turf/open/gm/dirtgrassborder,/area/lv624/ground/caves/central2)
"aT" = (/obj/structure/barricade/metal,/turf/open/gm/dirtgrassborder{icon_state = "grassdirt_corner2"},/area/lv624/ground/caves/central2)
"aU" = (/obj/structure/barricade/metal,/turf/open/gm/dirt,/area/lv624/ground/caves/central2)
"aV" = (/obj/structure/barricade/plasteel,/turf/open/gm/dirt,/area/lv624/ground/caves/central2)
"aW" = (/obj/structure/barricade/metal{dir = 4},/obj/structure/barricade/metal,/turf/open/gm/dirt,/area/lv624/ground/caves/central2)
"aX" = (/obj/structure/flora/ausbushes/fullgrass,/obj/structure/barricade/metal{dir = 4},/turf/open/gm/dirt,/area/lv624/ground/caves/central2)
"aY" = (/obj/structure/barricade/metal{dir = 8},/obj/structure/barricade/metal,/turf/open/gm/dirtgrassborder,/area/lv624/ground/caves/central2)
"aZ" = (/obj/structure/barricade/metal,/obj/structure/barricade/metal{dir = 4},/turf/open/gm/dirt,/area/lv624/ground/caves/central2)
"ba" = (/obj/item/storage/toolbox/emergency,/turf/open/floor/wood,/area/lv624/ground/caves/central2)
"bb" = (/obj/item/storage/toolbox/mechanical,/turf/open/floor/wood,/area/lv624/ground/caves/central2)
"bc" = (/obj/item/storage/box/m94,/turf/open/gm/dirtgrassborder{icon_state = "grassdirt_corner2"},/area/lv624/ground/caves/central2)
"bd" = (/obj/item/storage/box/m56d_hmg,/turf/open/floor/wood,/area/lv624/ground/caves/central2)
"be" = (/obj/item/storage/firstaid/regular,/turf/open/gm/grass,/area/lv624/ground/caves/central2)
"bf" = (/obj/item/storage/firstaid/adv,/turf/open/gm/dirt,/area/lv624/ground/caves/central2)

(1,1,1) = {"
aaaaaaaaaaaaaaaaaaaaaaaaaaaaaaaaaaaaaaaaaaaaaaaaaaaaaaaaaaaaaaaaaaaaaaaaaaaaaaaa
aaaaaaaaaaaaaaaaaaaaaaaaaaaaahahahahahahahababaaaaababababaaaaaaaaaaaaaaaaaaaaaa
aaaaaaaaaaaaaaaaaaaaaaabababahamanbaapaqahababauabababacabababauababababaaaaaaaa
aaaaaaaaaaaaaaaaaaaaabaHaHabahaoaoaoaoaoahababauabababadabababauababababababaaaa
aaaaaaaaaaaaaaaaaaaeabaHaHabaiaoaoaoaoaoaiababauabababababababauabababababababaa
aaaaaaaaaaaaaaaeaeaeabaHaHabahaIaJaobdbbahagaKaLagagagagagagagaLagajababacababab
aaaaaaaaaaaaaeaeaeaeaeaHaHabahahahavahahahalalaMalalalalalalalaMalarajabadababab
aaaaaaaaaaaeaeaeaeaeaeaHaHababbebeakbfbfasalalaMalalalalalalalaMalalaragajabafag
aaaaaaaaaeaeaeaeaeaeaeababababafagbcalalaNalalaMalalalalalalalaMalalalalaragatal
aaaaaaaeaeaeababababaOaPaQaRaSaTaUaVaUaUaUaUaUaWalalalalalalalaXalalalalalalalal
aaaaaeaeababababababaOabafatalalalalalalalalalalalalalalalalalaMalalalalalalalal
aaaaababababababafagaYaSaTaUaUaUaUaUaUaUaUaUaUaUaUaUaUaUaUaUaUaZalalalalalalalal
aaaaababababababakalalalalalalalawaxaxaxayalalalalalalalalalalawaxaxaxayasalalal
aaaaababababababakalalasalalalalazaAaAaAaBaxaxaxaxaxaxaxaxaxaxaCaAaAaAaBaxaxaxax
alaDababababababakalalalawaxaxaxaEaAaAaAaAaFaAaAaAaAaGaAaAaAaAaAaAaAaAaAaAaAaAaA
"}
