"abl" = (/turf/open/gm/dirt,/area/lv624/ground/caves/central1)
"abm" = (/turf/closed/mineral,/area/lv624/ground/caves/central1)
"abv" = (/obj/effect/alien/weeds/node,/turf/open/gm/dirt,/area/lv624/ground/caves/central1)
"acf" = (/turf/closed/mineral,/area/lv624/ground/caves/east1)
"abr" = (/obj/structure/mineral_door/resin,/turf/open/gm/dirt,/area/lv624/ground/caves/central1)
"abw" = (/obj/structure/mineral_door/resin,/obj/effect/alien/weeds/node,/turf/open/gm/dirt,/area/lv624/ground/caves/central1)
"abT" = (/turf/closed/mineral,/area/lv624/ground/sand6)
"acw" = (/obj/structure/foamedmetal,/turf/open/shuttle{icon_state = "floor4"},/area/lv624/ground/sand6)
"acx" = (/turf/closed/wall/r_wall,/area/lv624/ground/sand6)
"acB" = (/obj/structure/foamedmetal{layer = 4},/turf/open/shuttle{icon_state = "floor4"},/area/lv624/ground/sand6)
"acD" = (/obj/effect/spider/stickyweb,/turf/open/shuttle{icon_state = "floor4"},/area/lv624/ground/sand6)
"acE" = (/obj/effect/decal/remains/human,/obj/item/explosive/grenade/HE,/obj/effect/landmark{name = "good_item"},/turf/open/shuttle{icon_state = "floor4"},/area/lv624/ground/sand6)
"acF" = (/turf/closed/wall/sulaco,/area/lv624/ground/sand6)
"acH" = (/obj/machinery/constructable_frame{icon_state = "box_1"},/turf/open/shuttle{icon_state = "floor4"},/area/lv624/ground/sand6)
"acJ" = (/turf/open/shuttle{icon_state = "floor4"},/area/lv624/ground/sand6)
"acL" = (/obj/structure/foamedmetal{layer = 3.5},/turf/open/shuttle{icon_state = "floor4"},/area/lv624/ground/sand6)
"acM" = (/obj/structure/bed/chair{dir = 4},/obj/effect/spider/stickyweb,/turf/open/shuttle{icon_state = "floor4"},/area/lv624/ground/sand6)
"acN" = (/obj/effect/spider/stickyweb,/obj/item/explosive/grenade/HE,/turf/open/shuttle{icon_state = "floor4"},/area/lv624/ground/sand6)
"acQ" = (/obj/structure/bed/chair{dir = 4},/turf/open/shuttle{icon_state = "floor4"},/area/lv624/ground/sand6)
"acT" = (/obj/effect/decal/remains/human,/turf/open/shuttle{icon_state = "floor4"},/area/lv624/ground/sand6)
"acU" = (/obj/structure/foamedmetal,/obj/structure/bed/chair{dir = 8},/turf/open/shuttle{icon_state = "floor4"},/area/lv624/ground/sand6)
"acV" = (/obj/effect/landmark/corpsespawner/security{corpsebelt = null; corpsesuit = /obj/item/clothing/suit/storage/CMB; corpseuniform = /obj/item/clothing/under/CM_uniform; name = "Deputy Edgar Nogi"},/turf/open/shuttle{icon_state = "floor4"},/area/lv624/ground/sand6)
"acW" = (/obj/effect/spawner/random/toolbox,/turf/open/shuttle{icon_state = "floor4"},/area/lv624/ground/sand6)
"acX" = (/obj/structure/foamedmetal,/obj/structure/bed/chair{dir = 8},/obj/item/explosive/grenade/HE,/turf/open/shuttle{icon_state = "floor4"},/area/lv624/ground/sand6)
"ada" = (/obj/item/tool/crowbar,/turf/open/shuttle{icon_state = "floor4"},/area/lv624/ground/sand6)
"adb" = (/obj/structure/bed/chair{dir = 8},/turf/open/shuttle{icon_state = "floor4"},/area/lv624/ground/sand6)
"acA" = (/turf/open/gm/dirt,/area/lv624/ground/sand5)
"add" = (/obj/item/ammo_casing,/turf/open/shuttle{icon_state = "floor4"},/area/lv624/ground/sand6)
"adf" = (/obj/structure/bed/chair{dir = 4},/obj/item/weapon/gun/shotgun/pump/cmb,/turf/open/shuttle{icon_state = "floor4"},/area/lv624/ground/sand6)
"adg" = (/obj/item/stack/cable_coil/random,/turf/open/shuttle{icon_state = "floor4"},/area/lv624/ground/sand6)
"acI" = (/obj/effect/alien/weeds/node,/turf/open/gm/dirt,/area/lv624/ground/sand5)
"adh" = (/obj/item/storage/firstaid/adv,/turf/open/shuttle{icon_state = "floor4"},/area/lv624/ground/sand6)
"adi" = (/obj/structure/girder,/turf/open/gm/dirt,/area/lv624/ground/sand6)
"adj" = (/obj/item/clothing/suit/armor/bulletproof,/turf/open/shuttle{icon_state = "floor4"},/area/lv624/ground/sand6)
"adk" = (/obj/structure/girder,/turf/open/shuttle{icon_state = "floor4"},/area/lv624/ground/sand6)
"adl" = (/obj/effect/landmark{name = "crap_item"},/turf/open/gm/dirt,/area/lv624/ground/sand5)
"acR" = (/turf/open/gm/dirt,/area/lv624/ground/sand6)
"adn" = (/obj/structure/girder/displaced,/turf/closed/shuttle{icon_state = "wall3"},/area/lv624/ground/sand6)
"ads" = (/obj/structure/foamedmetal,/turf/open/gm/dirt,/area/lv624/ground/sand6)
"adu" = (/obj/structure/girder,/turf/closed/shuttle{icon_state = "wall3"},/area/lv624/ground/sand6)
"adw" = (/obj/structure/foamedmetal{layer = 4},/turf/open/gm/dirt,/area/lv624/ground/sand6)
"adx" = (/obj/structure/foamedmetal,/obj/effect/decal/remains/human{layer = 2.9},/turf/open/gm/dirt,/area/lv624/ground/sand6)
"acg" = (/turf/open/gm/dirt,/area/lv624/ground/caves/east1)
"adz" = (/turf/closed/wall,/area/lv624/ground/sand5)
"adA" = (/turf/open/floor/airless{dir = 5; icon_state = "asteroidfloor"},/area/lv624/ground/sand6)
"aaN" = (/obj/effect/alien/weeds/node,/turf/open/gm/dirt,/area/lv624/ground/caves/east1)
"acP" = (/turf/closed/mineral,/area/lv624/ground/sand5)
"adC" = (/obj/structure/rack,/obj/item/stack/sheet/mineral/gold{amount = 2},/obj/item/stack/sheet/mineral/platinum{pixel_x = -6},/turf/open/floor{icon_state = "vault"; dir = 8},/area/lv624/ground/sand5)
"adD" = (/obj/structure/rack,/obj/item/stack/sheet/mineral/diamond{amount = 2},/turf/open/floor{icon_state = "vault"; dir = 8},/area/lv624/ground/sand5)
"adE" = (/obj/structure/rack,/obj/item/stack/sheet/metal{amount = 50; pixel_x = 4; pixel_y = 4},/obj/item/stack/sheet/metal{amount = 30},/turf/open/floor{icon_state = "vault"; dir = 8},/area/lv624/ground/sand5)
"adF" = (/obj/structure/rack,/obj/item/tool/shovel,/turf/open/floor{icon_state = "vault"; dir = 8},/area/lv624/ground/sand5)
"adI" = (/obj/machinery/door/airlock/almayer/secure{dir = 4; icon_state = "door_locked"; id = ""; locked = 1; name = "Mining Storage"; req_access_txt = "100"},/turf/open/floor{icon_state = "dark"},/area/lv624/ground/sand5)
"adM" = (/turf/open/floor{icon_state = "dark"},/area/lv624/ground/sand5)
"adN" = (/obj/structure/rack,/obj/item/stack/sheet/mineral/iron{amount = 5},/obj/item/stack/sheet/mineral/platinum,/obj/machinery/light{dir = 4; icon_state = "tube1"},/turf/open/floor{icon_state = "vault"; dir = 8},/area/lv624/ground/sand5)
"adq" = (/obj/effect/alien/weeds/node,/turf/open/gm/dirt,/area/lv624/ground/sand6)
"adQ" = (/obj/structure/rack,/obj/item/stack/sheet/mineral/tritium{pixel_x = -4},/turf/open/floor{icon_state = "vault"; dir = 8},/area/lv624/ground/sand5)
"adR" = (/obj/structure/rack,/obj/item/stack/sheet/mineral/silver{amount = 20},/turf/open/floor{icon_state = "vault"; dir = 8},/area/lv624/ground/sand5)
"adS" = (/obj/structure/rack,/turf/open/floor{icon_state = "vault"; dir = 8},/area/lv624/ground/sand5)
"adT" = (/obj/structure/rack,/obj/item/tool/pickaxe,/turf/open/floor{icon_state = "vault"; dir = 8},/area/lv624/ground/sand5)
"adU" = (/obj/effect/landmark{name = "crap_item"},/turf/open/floor/airless{dir = 5; icon_state = "asteroidfloor"},/area/lv624/ground/sand6)
"adV" = (/obj/effect/decal/remains/human,/turf/open/gm/dirt,/area/lv624/ground/sand6)
"adW" = (/obj/structure/shuttle/engine/propulsion,/turf/open/gm/dirt,/area/lv624/ground/sand6)
"aea" = (/obj/effect/landmark{name = "crap_item"},/turf/open/gm/dirt,/area/lv624/ground/sand6)
"aef" = (/obj/effect/landmark{name = "hunter_secondary"},/turf/open/gm/dirt,/area/lv624/ground/sand5)
(1,1,1) = {"
ablabmabmablablablablablablablablabvablablablablabmabmabmabmabmabmabmabmabmabmacfacfacfacf
abmabmabmabrabwabrabrabmabmabmabmablablablabmabmabmabmabmabmabmabmabmabmabmabmacfacfacfacf
abmabmabmablablablablabmabmabmabmabmabmabmabmabmabmabmabmabmabmabmabmabmabmabmacfacfacfacf
abmabmabmabmablablablablabmabmabmabmabmabmabmabmabmabmabmabmabmabmabmabmabmabmacfacfacfacf
abmabmabmabmablablablablablablabmabmabmabmabmabmabTabTabTacwacwacxabTabTabTabTacfacfacfacf
abmabmabmabmablablablablablablabmabmabmabmabmabmabTabTacBacDacEabTabTabTabTabTacfacfacfacf
abmabmabmabmablablablabvabmabmabmabmabmabmabmabmacFacwacHacJacJabTabTacLacFabTacfacfacfacf
abmabmabmablablablablablabmabmabmabmabmabmabmabmacFacFacMacJacJacNabTacwacFacFacfacfacfacf
abmabmabmablablablablabmabmabmabmabmabmabmabmabmacFacFacQacTacJacJacLacUacFacFacfacfacfacf
abmabmabmablablablablablablabmabmabmabmabmabmabmacFacFacQacJacJacVacWacXacFacFacfacfacfacf
abmabmabmablabvablablablablablabmabmabmabmabmabmacFacFacQadaacJacJacJadbacFacFacfacfacfacf
abmabmabmablablablablablablablabmabmabmabmacAacAacFacFacQaddacJacJacTadbacFacFacfacfacfacf
abmabmabmablablablablablablabmabmabmacAacAacAacAacFacFadfadgacJaddacJadbacFacFacfacfacfacf
abmabmabmabmablablablablablabmabmacAacAacIacAacAacFacFacQacTaddacJadhadbacFacFacfacfacfacf
abmabmabmabmablablablablabmabmacAacAacAacAacAacAadiacFacQadjacJacwacJadkacFadiacfacfacfacf
abmabmabmablablablacAacAadlacAacAacAacAacAacAacAacRacFacFacFacwacwacFacFacFadiacfacfacfacf
abmabmabmablablacAacIacAacAacAacAacAacAacAacAacAacRadnacFadsadsadsacFaduacFacRacfacfacfacf
abmabmabmabmacAacAacAacAacAacAacAacAacAacAacAacAacRacRadwadxadiadsadsacRacRacRacRacRacRacg
abmabmabmacAacAacAacAadzadzadzadzadzadzadzacAacAacRacRacRadsadsadxacRadAacRacRacRacRacRaaN
acPacPacAacAacAacAacAadzadCadDadEadFadFadzacIacAacFacFacRacRacRacRadAacJacFacRacRacRacRacg
acAacAacAacAacAacAacAadIadMadMadMadMadNadzacAacAacRacRacRacRacRadqacRacRacRacRacRacRacRacg
acAacAacAacAacIacAacAadzadQadRadSadTadSadzacAacAacRacFadUacRacRadVacRadiacRadWacRacRacRacf
acPacAacAacAacAacAacAadzadzadzadzadzadzadzacAacAacRacRacJadAacRacRacRacRacRaeaacRacRacRacf
acAacAacAacAacAacAacAacAacAacAacAacAacAacAacAacAacRacRadqacRacRacRadAacRacRacRacRacRabTacf
acAacAacAacAacAacAacAacAacAacAacAacIacAacAacAacAacRacRacRadiacRacRacJacFacRacRadqacRabTabT
acAacAacAacAaefacAacAacAacAacAacAacAacAacAacAacAacRacRacRacRacRacRacRacRacRacRacRacRabTabT
"}

