"aa" = (/obj/structure/foamedmetal,/turf/open/shuttle{icon_state = "floor4"},/area/lv624/ground/caves/central1)
"ab" = (/turf/closed/wall/r_wall,/area/lv624/ground/caves/central1)
"ac" = (/obj/structure/foamedmetal{layer = 4},/turf/open/shuttle{icon_state = "floor4"},/area/lv624/ground/caves/central1)
"ad" = (/obj/effect/spider/stickyweb,/turf/open/shuttle{icon_state = "floor4"},/area/lv624/ground/caves/central1)
"ae" = (/obj/effect/decal/remains/human,/obj/item/explosive/grenade/HE,/obj/effect/landmark{name = "good_item"},/turf/open/shuttle{icon_state = "floor4"},/area/lv624/ground/caves/central1)
"af" = (/turf/closed/wall/sulaco,/area/lv624/ground/caves/central1)
"ag" = (/obj/machinery/constructable_frame{icon_state = "box_1"},/turf/open/shuttle{icon_state = "floor4"},/area/lv624/ground/caves/central1)
"ah" = (/turf/open/shuttle{icon_state = "floor4"},/area/lv624/ground/caves/central1)
"ai" = (/obj/structure/foamedmetal{layer = 3.5},/turf/open/shuttle{icon_state = "floor4"},/area/lv624/ground/caves/central1)
"aj" = (/obj/structure/bed/chair{dir = 4},/obj/effect/spider/stickyweb,/turf/open/shuttle{icon_state = "floor4"},/area/lv624/ground/caves/central1)
"ak" = (/obj/effect/spider/stickyweb,/obj/item/explosive/grenade/HE,/turf/open/shuttle{icon_state = "floor4"},/area/lv624/ground/caves/central1)
"al" = (/obj/structure/bed/chair{dir = 4},/turf/open/shuttle{icon_state = "floor4"},/area/lv624/ground/caves/central1)
"am" = (/obj/effect/decal/remains/human,/turf/open/shuttle{icon_state = "floor4"},/area/lv624/ground/caves/central1)
"an" = (/obj/structure/foamedmetal,/obj/structure/bed/chair{dir = 8},/turf/open/shuttle{icon_state = "floor4"},/area/lv624/ground/caves/central1)
"ao" = (/obj/effect/landmark/corpsespawner/security{corpsebelt = null; corpsesuit = /obj/item/clothing/suit/storage/CMB; corpseuniform = /obj/item/clothing/under/CM_uniform; name = "Deputy Edgar Nogi"},/turf/open/shuttle{icon_state = "floor4"},/area/lv624/ground/caves/central1)
"ap" = (/obj/effect/spawner/random/toolbox,/turf/open/shuttle{icon_state = "floor4"},/area/lv624/ground/caves/central1)
"aq" = (/obj/structure/foamedmetal,/obj/structure/bed/chair{dir = 8},/obj/item/explosive/grenade/HE,/turf/open/shuttle{icon_state = "floor4"},/area/lv624/ground/caves/central1)
"ar" = (/obj/item/tool/crowbar,/turf/open/shuttle{icon_state = "floor4"},/area/lv624/ground/caves/central1)
"as" = (/obj/structure/bed/chair{dir = 8},/turf/open/shuttle{icon_state = "floor4"},/area/lv624/ground/caves/central1)
"at" = (/obj/item/ammo_casing,/turf/open/shuttle{icon_state = "floor4"},/area/lv624/ground/caves/central1)
"au" = (/turf/closed/mineral,/area/lv624/ground/sand5)
"av" = (/obj/structure/bed/chair{dir = 4},/obj/item/weapon/gun/shotgun/pump/cmb,/turf/open/shuttle{icon_state = "floor4"},/area/lv624/ground/caves/central1)
"aw" = (/obj/item/stack/cable_coil/random,/turf/open/shuttle{icon_state = "floor4"},/area/lv624/ground/caves/central1)
"ax" = (/turf/closed/wall/sulaco,/area/lv624/ground/sand5)
"ay" = (/obj/item/storage/firstaid/adv,/turf/open/shuttle{icon_state = "floor4"},/area/lv624/ground/caves/central1)
"az" = (/obj/structure/girder,/turf/open/shuttle{icon_state = "floor4"},/area/lv624/ground/caves/central1)
"aA" = (/obj/structure/girder,/turf/open/gm/dirt,/area/lv624/ground/caves/central1)
"aB" = (/obj/item/clothing/suit/armor/bulletproof,/turf/open/shuttle{icon_state = "floor4"},/area/lv624/ground/caves/central1)
"aC" = (/turf/open/shuttle{icon_state = "floor4"},/area/lv624/ground/sand5)
"aD" = (/obj/structure/girder/displaced,/turf/closed/shuttle{icon_state = "wall3"},/area/lv624/ground/caves/central1)
"aE" = (/obj/structure/girder,/turf/open/gm/dirt,/area/lv624/ground/sand5)
"aF" = (/obj/structure/foamedmetal,/turf/open/gm/dirt,/area/lv624/ground/caves/central1)
"aG" = (/obj/structure/girder,/turf/closed/shuttle{icon_state = "wall3"},/area/lv624/ground/caves/central1)
"aH" = (/obj/structure/foamedmetal,/turf/open/gm/dirt,/area/lv624/ground/sand5)
"aJ" = (/obj/structure/foamedmetal{layer = 4},/turf/open/gm/dirt,/area/lv624/ground/sand5)
"aK" = (/obj/structure/foamedmetal,/obj/effect/decal/remains/human{layer = 2.9},/turf/open/gm/dirt,/area/lv624/ground/sand5)
"aL" = (/obj/structure/mineral_door/resin,/turf/open/gm/dirt,/area/lv624/ground/caves/east1)
"aM" = (/turf/open/floor/airless{dir = 5; icon_state = "asteroidfloor"},/area/lv624/ground/sand5)
"aN" = (/obj/effect/alien/weeds/node,/turf/open/gm/dirt,/area/lv624/ground/caves/east1)
"aO" = (/turf/closed/wall,/area/lv624/ground/sand6)
"aP" = (/obj/structure/rack,/obj/item/stack/sheet/mineral/gold{amount = 2},/obj/item/stack/sheet/mineral/platinum{pixel_x = -6},/turf/open/floor{icon_state = "vault"; dir = 8},/area/lv624/ground/sand6)
"aQ" = (/obj/structure/rack,/obj/item/stack/sheet/mineral/diamond{amount = 2},/turf/open/floor{icon_state = "vault"; dir = 8},/area/lv624/ground/sand6)
"aR" = (/obj/structure/rack,/obj/item/stack/sheet/metal{amount = 50; pixel_x = 4; pixel_y = 4},/obj/item/stack/sheet/metal{amount = 30},/turf/open/floor{icon_state = "vault"; dir = 8},/area/lv624/ground/sand6)
"aS" = (/obj/structure/rack,/obj/item/tool/shovel,/turf/open/floor{icon_state = "vault"; dir = 8},/area/lv624/ground/sand6)
"aT" = (/obj/machinery/door/airlock/almayer/secure{dir = 4; icon_state = "door_locked"; id = ""; locked = 1; name = "Mining Storage"},/turf/open/floor{icon_state = "dark"},/area/lv624/ground/sand6)
"aU" = (/turf/open/floor{icon_state = "dark"},/area/lv624/ground/sand6)
"aV" = (/obj/structure/rack,/obj/item/stack/sheet/mineral/iron{amount = 5},/obj/item/stack/sheet/mineral/platinum,/obj/machinery/light{dir = 4; icon_state = "tube1"},/turf/open/floor{icon_state = "vault"; dir = 8},/area/lv624/ground/sand6)
"aW" = (/obj/effect/landmark{name = "crap_item"},/turf/open/floor/airless{dir = 5; icon_state = "asteroidfloor"},/area/lv624/ground/sand5)
"aX" = (/obj/effect/decal/remains/human,/turf/open/gm/dirt,/area/lv624/ground/sand5)
"aY" = (/obj/structure/shuttle/engine/propulsion,/turf/open/gm/dirt,/area/lv624/ground/sand5)
"aZ" = (/obj/structure/rack,/obj/item/stack/sheet/mineral/tritium{pixel_x = -4},/turf/open/floor{icon_state = "vault"; dir = 8},/area/lv624/ground/sand6)
"ba" = (/obj/structure/rack,/obj/item/stack/sheet/mineral/silver{amount = 20},/turf/open/floor{icon_state = "vault"; dir = 8},/area/lv624/ground/sand6)
"bb" = (/obj/structure/rack,/turf/open/floor{icon_state = "vault"; dir = 8},/area/lv624/ground/sand6)
"bc" = (/obj/structure/rack,/obj/item/tool/pickaxe,/turf/open/floor{icon_state = "vault"; dir = 8},/area/lv624/ground/sand6)
"bd" = (/obj/effect/landmark{name = "hunter_secondary"},/turf/open/gm/dirt,/area/lv624/ground/sand6)
"bl" = (/turf/open/gm/dirt,/area/lv624/ground/caves/central1)
"bm" = (/turf/closed/mineral,/area/lv624/ground/caves/central1)
"br" = (/obj/structure/mineral_door/resin,/turf/open/gm/dirt,/area/lv624/ground/caves/central1)
"bw" = (/obj/structure/mineral_door/resin,/obj/effect/alien/weeds/node,/turf/open/gm/dirt,/area/lv624/ground/caves/central1)
"bT" = (/turf/closed/mineral,/area/lv624/ground/sand6)
"cf" = (/turf/closed/mineral,/area/lv624/ground/caves/east1)
"cg" = (/turf/open/gm/dirt,/area/lv624/ground/caves/east1)
"co" = (/obj/effect/landmark{name = "crap_item"},/turf/open/gm/dirt,/area/lv624/ground/caves/east1)
"cA" = (/turf/open/gm/dirt,/area/lv624/ground/sand5)
"cI" = (/obj/effect/alien/weeds/node,/turf/open/gm/dirt,/area/lv624/ground/sand5)
"cR" = (/turf/open/gm/dirt,/area/lv624/ground/sand6)
"dl" = (/obj/effect/landmark{name = "crap_item"},/turf/open/gm/dirt,/area/lv624/ground/sand5)
"dq" = (/obj/effect/alien/weeds/node,/turf/open/gm/dirt,/area/lv624/ground/sand6)
"ea" = (/obj/effect/landmark{name = "crap_item"},/turf/open/gm/dirt,/area/lv624/ground/sand6)

(1,1,1) = {"
bmbmbmbmbmbmbmbmbmbmbmbmblblblblbmbmbmbmbmbmbmcfcfcfcfcfcfcf
bmbmbmbmbmbmbmbmbmbmbmbmbrbwbrbrbmbmbmbmbmbmbmcfcfcfcfcfcfcf
bmbmbmbmbmbmbmbmbmbmbmbmblblblblbmbmbmbmbmbmbmcfcfcfcfcfcfcf
bmbmbmbmbmbmbmbmbmbmbmbmbmblblblblbmbmbmbmbmbmcfcfcfcfcfcfcf
bmbmbmbmaaaaabbmbmbmbmbmbmcRcRcRcRcRcRbTbTbTbTcfcfcfcfcfcfcf
bmbmbmacadaebmbmbmbmbmbmbmcRcRcRcRcRcRbTbTbTbTcfcfcfcfcfcfcf
bmafaaagahahbmbmaiafbmbmbmcRcRcRdqbTbTbTbTbTbTcfcfcfcfcfcfcf
bmafafajahahakbmaaafafbmcRcRcRcRcRbTbTbTbTbTbTcfcfcfcfcfcfcg
bmafafalamahahaianafafbmcRcRcRcRbTbTbTbTbTbTbTcfcfcfcfcfcfcg
bmafafalahahaoapaqafafbmcRcRcRcRcRcRbTbTbTbTbTcfcfcfcfcfcfcg
bmafafalarahahahasafafbmcRdqcRcRcRcRcRbTbTbTbTcfcfcfcfcfcgcg
blafafalatahahamasafafbmcRcRcRcRcRcRcRbTbTbTbTcgcfcfcfcfcgcg
blafafavawahatahasafafbmcRcRcRcRcRcRbTbTbTcRcRcgcfcfcfcfcgcg
blafafalamatahayasafafbmbmcRcRcRcRcRbTbTcRcRdqcgcfcfcfcfcgcg
blaAafalaBahaaahazafaAbmbmcRcRcRcRbTbTcRcRcRcRcgcfcfcfaNcgcg
blblafafafaaaaafafafaAbmcRcRcRcRcReacRcRcRcRcRcgcfcfcfcgcgcg
blblaDafaFaFaFafaGafblbmcRcRcRdqcRcRcRcRcRcRcRcgcfcfcfcfaLaL
cAcAcAaJaKaEaHaHcAcAcAcAaucRcRcRcRcRcRcRcRcRcRcRcRcRcgcgcgcg
cAcAcAcAaHaHaKcAaMcAcAcAcAcRcRcRaOaOaOaOaOaOaOcRcRcRaNcgcgcg
cAaxaxcAcAcAcAaMaCaxcAcAcAcRcRcRaOaPaQaRaSaSaOdqcRcRcgcgcgco
cAcAcAcAcAcAcIcAcAcAcAcAcAcRcRcRaTaUaUaUaUaVaOcRcRcRcgcgcgcg
cAcAaxaWcAcAaXcAaEcAaYcAcAdqcRcRaOaZbabbbcbbaOcRcRcRcfcfcgcg
cAcAcAaCaMcAcAcAcAcAdlcAcAcRcRcRaOaOaOaOaOaOaOcRcRcRcfcfcfcf
cAcAcAcIcAcAcAaMcAcAcAcAcAcRcRcRcRcRcRcRcRcRcRcRcRbTcfcfcfcf
cAcAcAcAaEcAcAaCaxcAcAcIcAcRcRcRcRcRcRcRdqcRcRcRcRbTbTbTbTbT
cAcAcAcAcAcAcAcAcAcAcAcAcAbdcRcRcRcRcRcRcRcRcRcRcRbTbTbTbTcR
"}
