//MAP CONVERTED BY dmm2tgm.py THIS HEADER COMMENT PREVENTS RECONVERSION, DO NOT REMOVE
"a" = (
/obj/item/clothing/shoes/snow,
/obj/structure/surface/rack,
/obj/item/clothing/shoes/snow,
/obj/item/clothing/suit/storage/snow_suit,
/obj/item/clothing/suit/storage/snow_suit,
/obj/item/tank/emergency_oxygen/engi,
/obj/effect/decal/strata_decals/grime/grime3{
	dir = 8
	},
/obj/item/clothing/mask/rebreather,
/obj/item/tank/emergency_oxygen/engi,
/obj/item/clothing/mask/rebreather,
/turf/open/floor/shiva/multi_tiles/east,
/area/shiva/exterior/lz2_fortress)
"d" = (
/obj/structure/flora/bush/snow{
	icon_state = "snowgrassbb_1"
	},
/turf/open/auto_turf/snow/layer3,
/area/shiva/exterior/cp_lz2)
"h" = (
/turf/open/floor/shiva/north,
/area/shiva/exterior/lz2_fortress)
"p" = (
/turf/open/auto_turf/snow/layer3,
/area/shiva/exterior/cp_lz2)
"r" = (
/turf/open/auto_turf/snow/layer4,
/area/shiva/exterior/cp_lz2)
"A" = (
/turf/closed/wall/shiva/prefabricated/reinforced/hull,
/area/shiva/exterior/lz2_fortress)
"B" = (
/obj/structure/largecrate/random/mini/chest/c,
/turf/open/auto_turf/snow/layer3,
/area/shiva/exterior/cp_lz2)
"C" = (
/turf/closed/wall/shiva/prefabricated/pink,
/area/shiva/exterior/lz2_fortress)
"I" = (
/turf/open/auto_turf/snow/layer2,
/area/shiva/exterior/cp_lz2)
"L" = (
/obj/structure/flora/bush/snow{
	icon_state = "snowgrassall_1"
	},
/turf/open/auto_turf/snow/layer3,
/area/shiva/exterior/cp_lz2)
"O" = (
/obj/structure/flora/bush/snow{
	icon_state = "snowgrassgb_2"
	},
/turf/open/auto_turf/snow/layer2,
/area/shiva/exterior/cp_lz2)
"X" = (
/turf/open/floor/shiva/radiator_tile,
/area/shiva/exterior/lz2_fortress)

(1,1,1) = {"
h
h
h
h
h
h
h
C
C
r
r
"}
(2,1,1) = {"
a
a
X
X
a
a
C
C
C
L
r
"}
(3,1,1) = {"
C
C
A
A
C
C
C
A
A
A
A
"}
(4,1,1) = {"
C
C
A
A
C
C
C
A
A
A
A
"}
(5,1,1) = {"
I
O
A
A
r
r
B
A
A
r
r
"}
(6,1,1) = {"
I
I
A
A
p
d
r
A
A
r
p
"}
