//MAP CONVERTED BY dmm2tgm.py THIS HEADER COMMENT PREVENTS RECONVERSION, DO NOT REMOVE
"a" = (
/turf/closed/wall/shiva/prefabricated/reinforced/hull,
/area/shiva/exterior/lz2_fortress)
"b" = (
/obj/item/lightstick/red/spoke/planted{
	layer = 2.99;
	pixel_x = 12;
	pixel_y = 28
	},
/turf/open/floor/shiva/north,
/area/shiva/exterior/lz2_fortress)
"c" = (
/obj/structure/machinery/door_control{
	id = "seelz_shutters";
	pixel_y = -22
	},
/turf/open/floor/shiva/radiator_tile,
/area/shiva/exterior/lz2_fortress)
"d" = (
/obj/structure/machinery/door_control{
	id = "selz_shutters";
	pixel_y = 22
	},
/turf/open/floor/shiva/radiator_tile,
/area/shiva/exterior/lz2_fortress)
"e" = (
/obj/structure/machinery/door_control{
	id = "seelz_shutters";
	pixel_y = -22
	},
/turf/open/floor/shiva/north,
/area/shiva/exterior/lz2_fortress)
"h" = (
/turf/open/floor/shiva/multi_tiles/east,
/area/shiva/exterior/lz2_fortress)
"p" = (
/obj/effect/decal/cleanable/blood{
	dir = 4;
	icon_state = "gib6"
	},
/turf/open/floor/shiva/north,
/area/shiva/exterior/lz2_fortress)
"u" = (
/obj/item/lightstick/red/spoke/planted{
	pixel_x = 12;
	pixel_y = 25
	},
/turf/open/floor/shiva/north,
/area/shiva/exterior/lz2_fortress)
"A" = (
/obj/effect/decal/cleanable/blood,
/turf/open/floor/shiva/north,
/area/shiva/exterior/lz2_fortress)
"B" = (
/turf/open/auto_turf/snow/layer0,
/area/shiva/exterior/cp_lz2)
"D" = (
/obj/structure/machinery/door_control{
	id = "selz_shutters";
	pixel_y = -22
	},
/turf/open/floor/shiva/radiator_tile,
/area/shiva/exterior/lz2_fortress)
"E" = (
/obj/structure/machinery/door_control{
	id = "seelz_shutters";
	pixel_y = 22
	},
/turf/open/floor/shiva/north,
/area/shiva/exterior/lz2_fortress)
"F" = (
/obj/item/lightstick/red/spoke/planted{
	layer = 3.1;
	pixel_x = -13;
	pixel_y = 25
	},
/turf/open/auto_turf/snow/layer1,
/area/shiva/exterior/cp_lz2)
"I" = (
/obj/item/lightstick/red/spoke/planted{
	layer = 2.99;
	pixel_x = -13;
	pixel_y = 28
	},
/turf/open/auto_turf/snow/layer0,
/area/shiva/exterior/cp_lz2)
"M" = (
/obj/structure/machinery/door_control{
	id = "seelz_shutters";
	pixel_y = 22
	},
/turf/open/floor/shiva/radiator_tile,
/area/shiva/exterior/lz2_fortress)
"N" = (
/turf/open/auto_turf/snow/layer1,
/area/shiva/exterior/cp_lz2)
"Q" = (
/obj/structure/machinery/door/poddoor/shutters/almayer{
	density = 0;
	dir = 4;
	id = "selz_shutters";
	name = "\improper Landing Zone Shutters"
	},
/turf/open/floor/plating/plating_catwalk/shiva,
/area/shiva/exterior/lz2_fortress)
"R" = (
/turf/open/floor/shiva/floor3,
/area/shiva/exterior/lz2_fortress)
"S" = (
/obj/structure/machinery/power/apc/directional/no_power/west,
/turf/open/floor/plating,
/area/shiva/exterior/cp_lz2)
"U" = (
/obj/structure/machinery/power/apc/directional/no_power/east,
/turf/open/floor/shiva/north,
/area/shiva/exterior/lz2_fortress)
"V" = (
/turf/open/auto_turf/snow/layer2,
/area/shiva/exterior/cp_lz2)
"W" = (
/obj/structure/machinery/door_control{
	id = "selz_shutters";
	pixel_y = -22
	},
/turf/open/floor/shiva/north,
/area/shiva/exterior/lz2_fortress)
"X" = (
/obj/structure/machinery/door_control{
	id = "selz_shutters";
	pixel_y = 22
	},
/turf/open/floor/shiva/north,
/area/shiva/exterior/lz2_fortress)
"Y" = (
/turf/open/floor/shiva/north,
/area/shiva/exterior/lz2_fortress)
"Z" = (
/obj/structure/machinery/door/poddoor/shutters/almayer{
	density = 0;
	dir = 4;
	id = "seelz_shutters";
	name = "\improper Landing Zone Shutters"
	},
/turf/open/floor/plating/plating_catwalk/shiva,
/area/shiva/exterior/lz2_fortress)

(1,1,1) = {"
U
Y
b
R
R
Y
u
Y
"}
(2,1,1) = {"
a
a
d
h
h
D
a
a
"}
(3,1,1) = {"
a
a
Q
Q
Q
Q
a
a
"}
(4,1,1) = {"
a
a
X
A
Y
W
a
a
"}
(5,1,1) = {"
a
a
E
p
Y
e
a
a
"}
(6,1,1) = {"
a
a
Z
Z
Z
Z
a
a
"}
(7,1,1) = {"
a
a
M
h
h
c
a
a
"}
(8,1,1) = {"
S
N
I
B
B
B
F
V
"}
