//MAP CONVERTED BY dmm2tgm.py THIS HEADER COMMENT PREVENTS RECONVERSION, DO NOT REMOVE
"aa" = (
/turf/open/asphalt{
	icon_state = "tile"
	},
/area/desert_dam/exterior/valley/valley_bridge)
"af" = (
/turf/open/asphalt/cement_sunbleached{
	icon_state = "cement_sunbleached3"
	},
/area/desert_dam/exterior/valley/valley_bridge)
"ag" = (
/turf/open/asphalt/cement_sunbleached{
	icon_state = "cement_sunbleached1"
	},
/area/desert_dam/exterior/valley/valley_bridge)
"ai" = (
/turf/open/auto_turf/snow/layer2,
/area/desert_dam/exterior/valley/valley_bridge)
"aj" = (
/turf/closed/wall/shiva/ice,
/area/desert_dam/exterior/rock)
"al" = (
/obj/structure/platform_decoration{
	dir = 4;
	icon_state = "platform_deco"
	},
/turf/open/auto_turf/ice/layer1,
/area/desert_dam/exterior/river/riverside_east)
"ao" = (
/turf/open/asphalt/cement_sunbleached{
	icon_state = "cement_sunbleached14"
	},
/area/desert_dam/exterior/valley/valley_bridge)
"ap" = (
/turf/open/asphalt/cement_sunbleached{
	icon_state = "cement_sunbleached15"
	},
/area/desert_dam/exterior/valley/valley_bridge)
"au" = (
/obj/structure/platform_decoration{
	dir = 8;
	icon_state = "platform_deco"
	},
/turf/open/auto_turf/ice/layer1,
/area/desert_dam/exterior/river/riverside_east)
"av" = (
/obj/structure/platform{
	dir = 1
	},
/obj/structure/platform{
	dir = 4
	},
/turf/open/auto_turf/ice/layer1,
/area/desert_dam/exterior/river/riverside_east)
"ay" = (
/obj/structure/platform{
	dir = 1
	},
/obj/structure/platform{
	dir = 8
	},
/turf/open/auto_turf/ice/layer1,
/area/desert_dam/exterior/river/riverside_east)
"aA" = (
/obj/structure/platform{
	dir = 1
	},
/turf/open/auto_turf/ice/layer1,
/area/desert_dam/exterior/river/riverside_east)
"aB" = (
/obj/structure/platform{
	dir = 1
	},
/turf/open/auto_turf/snow/layer2,
/area/desert_dam/exterior/river/riverside_east)
"aI" = (
/obj/structure/platform{
	dir = 8
	},
/turf/open/auto_turf/ice/layer1,
/area/desert_dam/exterior/river/riverside_east)
"aP" = (
/obj/structure/platform_decoration,
/turf/open/auto_turf/ice/layer1,
/area/desert_dam/exterior/river/riverside_east)
"aQ" = (
/obj/structure/platform,
/obj/structure/platform{
	dir = 4
	},
/turf/open/auto_turf/ice/layer1,
/area/desert_dam/exterior/river/riverside_east)
"aR" = (
/obj/structure/catwalk/bigred,
/turf/open/auto_turf/ice/layer1,
/area/desert_dam/exterior/river/riverside_east)
"aS" = (
/obj/structure/platform,
/obj/structure/platform{
	dir = 8
	},
/turf/open/auto_turf/ice/layer1,
/area/desert_dam/exterior/river/riverside_east)
"aU" = (
/obj/structure/platform,
/turf/open/auto_turf/ice/layer1,
/area/desert_dam/exterior/river/riverside_east)
"aW" = (
/turf/open/auto_turf/ice/layer1,
/area/desert_dam/exterior/river/riverside_east)
"aX" = (
/obj/structure/platform{
	dir = 4
	},
/turf/open/auto_turf/ice/layer1,
/area/desert_dam/exterior/river/riverside_east)
"aY" = (
/turf/open/asphalt{
	icon_state = "tile"
	},
/area/desert_dam/exterior/valley/valley_medical)
"aZ" = (
/turf/open/asphalt/cement_sunbleached{
	icon_state = "cement_sunbleached3"
	},
/area/desert_dam/exterior/valley/valley_medical)
"ba" = (
/turf/open/asphalt/cement_sunbleached{
	icon_state = "cement_sunbleached1"
	},
/area/desert_dam/exterior/valley/valley_medical)
"bc" = (
/turf/open/auto_turf/snow/layer2,
/area/desert_dam/exterior/river/riverside_east)
"bd" = (
/obj/structure/platform_decoration{
	dir = 8;
	icon_state = "platform_deco"
	},
/turf/open/auto_turf/snow/layer2,
/area/desert_dam/exterior/river/riverside_east)
"be" = (
/obj/structure/stairs{
	dir = 8
	},
/obj/structure/platform{
	dir = 1
	},
/turf/open/asphalt/cement_sunbleached{
	icon_state = "cement_sunbleached2"
	},
/area/desert_dam/exterior/valley/valley_medical)
"bf" = (
/turf/open/asphalt/cement_sunbleached,
/area/desert_dam/exterior/valley/valley_medical)
"bg" = (
/turf/open/asphalt/cement_sunbleached{
	icon_state = "cement_sunbleached4"
	},
/area/desert_dam/exterior/valley/valley_medical)
"bh" = (
/turf/open/asphalt/cement_sunbleached{
	icon_state = "cement_sunbleached9"
	},
/area/desert_dam/exterior/valley/valley_medical)
"bi" = (
/obj/structure/platform,
/turf/open/auto_turf/snow/layer2,
/area/desert_dam/exterior/river/riverside_east)
"bj" = (
/obj/structure/platform_decoration{
	dir = 1;
	icon_state = "platform_deco"
	},
/turf/open/auto_turf/snow/layer2,
/area/desert_dam/exterior/river/riverside_east)
"bk" = (
/obj/structure/platform_decoration,
/turf/open/auto_turf/snow/layer2,
/area/desert_dam/exterior/river/riverside_east)
"bl" = (
/obj/structure/stairs{
	dir = 8
	},
/obj/structure/platform,
/turf/open/asphalt/cement_sunbleached{
	icon_state = "cement_sunbleached14"
	},
/area/desert_dam/exterior/valley/valley_medical)
"bm" = (
/obj/structure/platform,
/turf/open/asphalt/cement_sunbleached,
/area/desert_dam/exterior/valley/valley_medical)
"bo" = (
/obj/structure/stairs{
	dir = 1
	},
/obj/structure/platform{
	dir = 8
	},
/turf/open/asphalt/cement_sunbleached{
	icon_state = "cement_sunbleached3"
	},
/area/desert_dam/exterior/valley/valley_medical)
"bp" = (
/obj/structure/stairs{
	dir = 1
	},
/obj/structure/platform{
	dir = 4
	},
/turf/open/asphalt/cement_sunbleached{
	icon_state = "cement_sunbleached1"
	},
/area/desert_dam/exterior/valley/valley_medical)

(1,1,1) = {"
aa
aA
aW
aW
aW
aW
aW
aW
aW
aW
bc
bi
aY
"}
(2,1,1) = {"
ay
al
aW
aW
aW
aW
aW
aW
aW
aW
bc
bi
aY
"}
(3,1,1) = {"
al
aW
aW
aW
aW
aW
aW
aW
aW
aW
bc
bi
aY
"}
(4,1,1) = {"
aW
aW
aW
aW
aW
aW
aW
aW
aW
aW
bc
bi
aY
"}
(5,1,1) = {"
aW
aW
aW
aW
aW
aW
aW
aW
aW
aW
bc
bj
bo
"}
(6,1,1) = {"
aX
aX
au
aW
aW
aW
aW
aW
aP
aX
bd
bk
bp
"}
(7,1,1) = {"
aa
aa
av
aX
aX
aX
aX
aX
aQ
aY
be
bl
aY
"}
(8,1,1) = {"
af
ao
aR
aR
aR
aR
aR
aR
aR
aZ
bf
bm
aY
"}
(9,1,1) = {"
ag
ap
aR
aR
aR
aR
aR
aR
aR
ba
bf
bm
aY
"}
(10,1,1) = {"
aa
aa
ay
aI
aI
aI
aI
aI
aS
aY
bg
bm
aY
"}
(11,1,1) = {"
ai
aa
aA
aW
aW
aW
aW
aW
aU
aY
bg
bf
aZ
"}
(12,1,1) = {"
aj
aa
aA
aW
aW
aW
aW
aW
aU
aY
bg
bf
bf
"}
(13,1,1) = {"
aj
aa
aB
aW
aW
aW
aW
aW
aU
aY
bg
bf
bf
"}
(14,1,1) = {"
aj
aa
aB
aW
aW
aW
aW
aW
aU
aY
bh
ba
ba
"}
