//MAP CONVERTED BY dmm2tgm.py THIS HEADER COMMENT PREVENTS RECONVERSION, DO NOT REMOVE
"aq" = (
/turf/closed/shuttle/upp_dropship2{
	icon_state = "32"
	},
/area/shuttle/drop_upp2/korolev)
"ar" = (
/obj/structure/blocker/invisible_wall,
/turf/closed/shuttle/upp_dropship2{
	icon_state = "93a"
	},
/area/shuttle/drop_upp2/korolev)
"aw" = (
/turf/closed/shuttle/upp_dropship2{
	icon_state = "38"
	},
/area/shuttle/drop_upp2/korolev)
"aQ" = (
/obj/structure/machinery/computer/shuttle/dropship/flight/upp{
	req_one_access = list(235, 240)
	},
/obj/structure/blocker/invisible_wall,
/turf/open/shuttle/dropship/medium_grey_single_wide_up_to_down,
/area/shuttle/drop_upp2/korolev)
"aT" = (
/turf/closed/shuttle/upp_dropship2{
	icon_state = "53";
	dir = 1
	},
/area/shuttle/drop_upp2/korolev)
"bM" = (
/obj/structure/platform/strata/metal{
	dir = 1
	},
/turf/open/shuttle/dropship/medium_grey_single_wide_up_to_down,
/area/shuttle/drop_upp2/korolev)
"bT" = (
/turf/closed/shuttle/upp_dropship2/transparent{
	icon_state = "86"
	},
/area/shuttle/drop_upp2/korolev)
"cU" = (
/obj/structure/shuttle/part/dropshipupp2/left_outer_wing_connector{
	icon_state = "tail_3_red"
	},
/turf/template_noop,
/area/shuttle/drop_upp2/korolev)
"da" = (
/turf/closed/shuttle/upp_dropship2/transparent{
	icon_state = "78"
	},
/area/shuttle/drop_upp2/korolev)
"dl" = (
/obj/item/device/radio/intercom/korolev{
	pixel_y = 24
	},
/turf/open/shuttle/dropship/light_grey_top_right,
/area/shuttle/drop_upp2/korolev)
"dV" = (
/obj/effect/attach_point/crew_weapon/dropship_upp2,
/obj/item/device/radio/intercom/korolev{
	pixel_y = 24
	},
/turf/open/shuttle/dropship/medium_grey_single_wide_up_to_down,
/area/shuttle/drop_upp2/korolev)
"er" = (
/obj/structure/shuttle/part/dropshipupp2/transparent/nose_top_left,
/turf/template_noop,
/area/shuttle/drop_upp2/korolev)
"eN" = (
/obj/item/device/radio/intercom/korolev{
	pixel_y = 24
	},
/turf/open/shuttle/dropship/medium_grey_single_wide_up_to_down,
/area/shuttle/drop_upp2/korolev)
"fp" = (
/obj/structure/stairs,
/turf/open/shuttle/dropship/medium_grey_single_wide_up_to_down,
/area/shuttle/drop_upp2/korolev)
"fs" = (
/turf/closed/shuttle/upp_dropship2{
	icon_state = "81"
	},
/area/shuttle/drop_upp2/korolev)
"fK" = (
/obj/structure/shuttle/part/dropshipupp2/left_inner_wing_connector,
/turf/template_noop,
/area/shuttle/drop_upp2/korolev)
"fN" = (
/turf/closed/shuttle/upp_dropship2{
	icon_state = "23"
	},
/area/shuttle/drop_upp2/korolev)
"gz" = (
/turf/closed/shuttle/upp_dropship2{
	icon_state = "30"
	},
/area/shuttle/drop_upp2/korolev)
"hK" = (
/turf/closed/shuttle/upp_dropship2{
	icon_state = "64"
	},
/area/shuttle/drop_upp2/korolev)
"ja" = (
/turf/closed/shuttle/upp_dropship2{
	icon_state = "29"
	},
/area/shuttle/drop_upp2/korolev)
"ju" = (
/turf/open/shuttle/dropship/light_grey_left_to_right,
/area/shuttle/drop_upp2/korolev)
"lj" = (
/obj/structure/shuttle/part/dropshipupp2/lower_right_wall,
/turf/template_noop,
/area/shuttle/drop_upp2/korolev)
"lM" = (
/obj/structure/shuttle/part/dropshipupp2/transparent/right_inner_bottom_wing{
	icon_state = "tail_5_red"
	},
/turf/template_noop,
/area/shuttle/drop_upp2/korolev)
"mb" = (
/turf/closed/shuttle/upp_dropship2/transparent{
	icon_state = "98"
	},
/area/shuttle/drop_upp2/korolev)
"mh" = (
/obj/item/device/radio/intercom/korolev{
	pixel_y = 43;
	pixel_x = 21
	},
/turf/open/shuttle/dropship/medium_grey_single_wide_up_to_down,
/area/shuttle/drop_upp2/korolev)
"mO" = (
/obj/structure/shuttle/part/dropshipupp2/transparent/outer_left_weapons,
/obj/effect/attach_point/weapon/dropship_upp2/left_fore,
/turf/template_noop,
/area/shuttle/drop_upp2/korolev)
"nn" = (
/obj/structure/machinery/door/airlock/multi_tile/almayer/dropshiprear/upp2{
	id = "aft_door"
	},
/turf/open/shuttle/dropship/medium_grey_single_wide_up_to_down,
/area/shuttle/drop_upp2/korolev)
"oi" = (
/turf/closed/shuttle/upp_dropship2/transparent{
	icon_state = "89"
	},
/area/shuttle/drop_upp2/korolev)
"oG" = (
/obj/structure/shuttle/part/dropshipupp2/nose_front_left,
/turf/template_noop,
/area/shuttle/drop_upp2/korolev)
"pC" = (
/turf/open/shuttle/dropship/light_grey_top_right,
/area/shuttle/drop_upp2/korolev)
"qc" = (
/turf/open/shuttle/dropship/medium_grey_single_wide_up_to_down,
/area/shuttle/drop_upp2/korolev)
"qB" = (
/turf/closed/shuttle/upp_dropship2{
	icon_state = "47"
	},
/area/shuttle/drop_upp2/korolev)
"rf" = (
/obj/structure/shuttle/part/dropshipupp2/transparent/middle_left_wing{
	icon_state = "upp_wing_left_red_logo"
	},
/obj/structure/machinery/light/dropship/red{
	dir = 8
	},
/turf/template_noop,
/area/shuttle/drop_upp2/korolev)
"rV" = (
/obj/effect/attach_point/crew_weapon/dropship_upp2,
/turf/open/shuttle/dropship/medium_grey_single_wide_up_to_down,
/area/shuttle/drop_upp2/korolev)
"sC" = (
/obj/structure/shuttle/part/dropshipupp2/transparent/nose_center,
/turf/template_noop,
/area/shuttle/drop_upp2/korolev)
"te" = (
/obj/effect/attach_point/fuel/dropship_upp2{
	dir = 1
	},
/turf/closed/shuttle/upp_dropship2{
	icon_state = "28"
	},
/area/shuttle/drop_upp2/korolev)
"ti" = (
/obj/structure/shuttle/part/dropshipupp2/transparent/nose_top_right,
/turf/template_noop,
/area/shuttle/drop_upp2/korolev)
"tP" = (
/obj/effect/decal/warning_stripes{
	icon_state = "S"
	},
/turf/open/shuttle/dropship/light_grey_single_wide_up_to_down,
/area/shuttle/drop_upp2/korolev)
"tX" = (
/turf/closed/shuttle/upp_dropship2{
	icon_state = "39"
	},
/area/shuttle/drop_upp2/korolev)
"uw" = (
/obj/structure/shuttle/part/dropshipupp2/lower_left_wall,
/turf/template_noop,
/area/shuttle/drop_upp2/korolev)
"uB" = (
/obj/structure/shuttle/part/dropshipupp2/transparent/lower_left_wing{
	icon_state = "upp_wing_eng_left_red"
	},
/obj/effect/attach_point/weapon/dropship_upp2/left_wing,
/turf/template_noop,
/area/shuttle/drop_upp2/korolev)
"uR" = (
/turf/closed/shuttle/upp_dropship2{
	icon_state = "27"
	},
/area/shuttle/drop_upp2/korolev)
"uX" = (
/obj/structure/machinery/door_control{
	name = "Dropship Lockdown";
	pixel_y = -19;
	id = "dropship_korolev";
	throw_range = 15;
	normaldoorcontrol = 3;
	req_one_access_txt = "235;240"
	},
/turf/open/shuttle/dropship/light_grey_left_to_right,
/area/shuttle/drop_upp2/korolev)
"vy" = (
/obj/structure/shuttle/part/dropshipupp2/transparent/middle_right_wing{
	icon_state = "upp_wing_right_red_logo"
	},
/obj/structure/machinery/light/dropship/green{
	dir = 4
	},
/turf/template_noop,
/area/shuttle/drop_upp2/korolev)
"vZ" = (
/turf/closed/shuttle/upp_dropship2{
	icon_state = "22"
	},
/area/shuttle/drop_upp2/korolev)
"wa" = (
/turf/closed/shuttle/upp_dropship2{
	icon_state = "10"
	},
/area/shuttle/drop_upp2/korolev)
"wk" = (
/obj/structure/shuttle/part/dropshipupp2/transparent/upper_right_wing{
	icon_state = "upp_wing_top_right_red"
	},
/turf/template_noop,
/area/shuttle/drop_upp2/korolev)
"wx" = (
/turf/closed/shuttle/upp_dropship2{
	icon_state = "31"
	},
/area/shuttle/drop_upp2/korolev)
"wL" = (
/turf/closed/shuttle/upp_dropship2{
	icon_state = "25"
	},
/area/shuttle/drop_upp2/korolev)
"wQ" = (
/turf/closed/shuttle/upp_dropship2{
	icon_state = "17"
	},
/area/shuttle/drop_upp2/korolev)
"xm" = (
/obj/item/device/radio/intercom/korolev{
	pixel_y = 24
	},
/turf/open/shuttle/dropship/light_grey_top_left,
/area/shuttle/drop_upp2/korolev)
"xK" = (
/turf/closed/shuttle/upp_dropship2{
	icon_state = "53"
	},
/area/shuttle/drop_upp2/korolev)
"xL" = (
/turf/closed/shuttle/upp_dropship2{
	icon_state = "56"
	},
/area/shuttle/drop_upp2/korolev)
"zz" = (
/turf/closed/shuttle/upp_dropship2{
	icon_state = "75"
	},
/area/shuttle/drop_upp2/korolev)
"zI" = (
/obj/structure/shuttle/part/dropshipupp2/transparent/upper_right_wing{
	icon_state = "tail_6_red"
	},
/turf/template_noop,
/area/shuttle/drop_upp2/korolev)
"AB" = (
/turf/closed/shuttle/upp_dropship2{
	icon_state = "19"
	},
/area/shuttle/drop_upp2/korolev)
"Bv" = (
/turf/open/shuttle/dropship/light_grey_bottom_left,
/area/shuttle/drop_upp2/korolev)
"BA" = (
/obj/structure/shuttle/part/dropshipupp2/transparent/left_outer_inner_wing{
	icon_state = "tail_2_red"
	},
/turf/template_noop,
/area/shuttle/drop_upp2/korolev)
"Cg" = (
/turf/closed/shuttle/upp_dropship2{
	icon_state = "21"
	},
/area/shuttle/drop_upp2/korolev)
"Cq" = (
/obj/structure/shuttle/part/dropshipupp2/transparent/lower_right_wing{
	icon_state = "upp_wing_eng_right_red"
	},
/obj/effect/attach_point/weapon/dropship_upp2/right_wing,
/turf/template_noop,
/area/shuttle/drop_upp2/korolev)
"CR" = (
/turf/open/shuttle/dropship/light_grey_bottom_right,
/area/shuttle/drop_upp2/korolev)
"Dh" = (
/turf/closed/shuttle/upp_dropship2{
	icon_state = "73"
	},
/area/shuttle/drop_upp2/korolev)
"Dt" = (
/turf/closed/shuttle/upp_dropship2/transparent{
	icon_state = "97"
	},
/area/shuttle/drop_upp2/korolev)
"DO" = (
/turf/closed/shuttle/upp_dropship2{
	icon_state = "77"
	},
/area/shuttle/drop_upp2/korolev)
"Gq" = (
/obj/item/device/radio/intercom/korolev{
	pixel_x = -10
	},
/turf/closed/shuttle/upp_dropship2{
	icon_state = "18"
	},
/area/shuttle/drop_upp2/korolev)
"Gr" = (
/obj/structure/machinery/door/airlock/multi_tile/almayer/dropshiprear/dropshipside/upp2{
	dir = 1;
	id = "starboard_door"
	},
/turf/open/shuttle/dropship/medium_grey_single_wide_up_to_down,
/area/shuttle/drop_upp2/korolev)
"GN" = (
/turf/closed/shuttle/upp_dropship2{
	icon_state = "69"
	},
/area/shuttle/drop_upp2/korolev)
"GO" = (
/obj/structure/shuttle/part/dropshipupp2/nose_front_right,
/turf/template_noop,
/area/shuttle/drop_upp2/korolev)
"Ha" = (
/obj/structure/shuttle/part/dropshipupp2/right_outer_wing_connector{
	icon_state = "tail_4_red"
	},
/turf/template_noop,
/area/shuttle/drop_upp2/korolev)
"Hg" = (
/obj/structure/shuttle/part/dropshipupp2/transparent/inner_left_weapons,
/obj/effect/attach_point/electronics/dropship_upp2,
/turf/template_noop,
/area/shuttle/drop_upp2/korolev)
"Hi" = (
/turf/template_noop,
/area/space)
"HQ" = (
/turf/closed/shuttle/upp_dropship2/transparent{
	icon_state = "96"
	},
/area/shuttle/drop_upp2/korolev)
"HY" = (
/obj/structure/shuttle/part/dropshipupp2/transparent/outer_right_weapons,
/obj/effect/attach_point/weapon/dropship_upp2/right_fore,
/turf/template_noop,
/area/shuttle/drop_upp2/korolev)
"Id" = (
/obj/structure/bed/chair/vehicle{
	pixel_x = -8
	},
/obj/structure/bed/chair/vehicle{
	pixel_x = 8
	},
/obj/structure/machinery/cm_vending/sorted/medical/wall_med{
	pixel_x = 30
	},
/turf/open/shuttle/dropship/medium_grey_single_wide_up_to_down,
/area/shuttle/drop_upp2/korolev)
"Iq" = (
/turf/closed/shuttle/upp_dropship2{
	icon_state = "67"
	},
/area/shuttle/drop_upp2/korolev)
"Iu" = (
/obj/structure/machinery/door/airlock/hatch/cockpit/upp{
	req_access = null;
	req_one_access = list(235, 240)
	},
/obj/structure/blocker/forcefield/multitile_vehicles,
/turf/open/shuttle/dropship/medium_grey_single_wide_up_to_down,
/area/shuttle/drop_upp2/korolev)
"Kj" = (
/turf/closed/shuttle/upp_dropship2{
	icon_state = "94"
	},
/area/shuttle/drop_upp2/korolev)
"Lj" = (
/obj/structure/shuttle/part/dropshipupp2/transparent/upper_left_wing{
	icon_state = "tail_1_red"
	},
/turf/template_noop,
/area/shuttle/drop_upp2/korolev)
"Lu" = (
/obj/structure/blocker/invisible_wall,
/turf/closed/shuttle/upp_dropship2{
	icon_state = "93b"
	},
/area/shuttle/drop_upp2/korolev)
"LN" = (
/turf/closed/shuttle/upp_dropship2{
	icon_state = "35"
	},
/area/shuttle/drop_upp2/korolev)
"MI" = (
/turf/closed/shuttle/upp_dropship2{
	icon_state = "83"
	},
/area/shuttle/drop_upp2/korolev)
"NI" = (
/obj/effect/attach_point/fuel/dropship_upp2{
	dir = 1;
	pixel_x = -32
	},
/turf/closed/shuttle/upp_dropship2{
	icon_state = "33"
	},
/area/shuttle/drop_upp2/korolev)
"NP" = (
/obj/structure/barricade/handrail/strata,
/obj/effect/decal/warning_stripes{
	icon_state = "S"
	},
/turf/open/shuttle/dropship/medium_grey_single_wide_up_to_down,
/area/shuttle/drop_upp2/korolev)
"Oe" = (
/obj/structure/bed/chair/dropship/pilot{
	dir = 1
	},
/turf/open/shuttle/dropship/medium_grey_single_wide_up_to_down,
/area/shuttle/drop_upp2/korolev)
"Ph" = (
/obj/structure/bed/chair/vehicle{
	pixel_x = -8
	},
/obj/structure/bed/chair/vehicle{
	pixel_x = 8
	},
/turf/open/shuttle/dropship/medium_grey_single_wide_up_to_down,
/area/shuttle/drop_upp2/korolev)
"PD" = (
/obj/item/device/radio/intercom/korolev{
	pixel_x = 10
	},
/turf/closed/shuttle/upp_dropship2{
	icon_state = "19"
	},
/area/shuttle/drop_upp2/korolev)
"Qj" = (
/obj/structure/shuttle/part/dropshipupp2/transparent/upper_left_wing{
	icon_state = "upp_wing_top_left_red"
	},
/turf/template_noop,
/area/shuttle/drop_upp2/korolev)
"QP" = (
/obj/structure/shuttle/part/dropshipupp2/right_inner_wing_connector,
/turf/template_noop,
/area/shuttle/drop_upp2/korolev)
"QS" = (
/turf/closed/shuttle/upp_dropship2{
	icon_state = "92"
	},
/area/shuttle/drop_upp2/korolev)
"RA" = (
/obj/docking_port/mobile/marine_dropship/korolev,
/turf/closed/shuttle/upp_dropship2{
	icon_state = "53";
	dir = 1
	},
/area/shuttle/drop_upp2/korolev)
"Sg" = (
/obj/structure/machinery/door/airlock/multi_tile/almayer/dropshiprear/dropshipside/upp2{
	dir = 2;
	id = "port_door"
	},
/turf/open/shuttle/dropship/medium_grey_single_wide_up_to_down,
/area/shuttle/drop_upp2/korolev)
"SR" = (
/turf/closed/shuttle/upp_dropship2{
	icon_state = "48"
	},
/area/shuttle/drop_upp2/korolev)
"Tj" = (
/turf/open/shuttle/dropship/light_grey_top_left,
/area/shuttle/drop_upp2/korolev)
"TD" = (
/turf/closed/shuttle/upp_dropship2{
	icon_state = "16"
	},
/area/shuttle/drop_upp2/korolev)
"Ub" = (
/turf/closed/shuttle/upp_dropship2{
	icon_state = "62"
	},
/area/shuttle/drop_upp2/korolev)
"Ud" = (
/turf/closed/shuttle/upp_dropship2{
	icon_state = "34"
	},
/area/shuttle/drop_upp2/korolev)
"Ux" = (
/turf/open/shuttle/dropship/light_grey_single_wide_up_to_down,
/area/shuttle/drop_upp2/korolev)
"VY" = (
/turf/closed/shuttle/upp_dropship2{
	icon_state = "82"
	},
/area/shuttle/drop_upp2/korolev)
"Wf" = (
/turf/closed/shuttle/upp_dropship2{
	icon_state = "18"
	},
/area/shuttle/drop_upp2/korolev)
"WJ" = (
/obj/structure/bed/chair/vehicle{
	pixel_x = -8
	},
/obj/structure/bed/chair/vehicle{
	pixel_x = 8
	},
/obj/structure/machinery/cm_vending/sorted/medical/wall_med{
	pixel_x = -30
	},
/turf/open/shuttle/dropship/medium_grey_single_wide_up_to_down,
/area/shuttle/drop_upp2/korolev)
"WU" = (
/turf/closed/shuttle/upp_dropship2{
	icon_state = "72"
	},
/area/shuttle/drop_upp2/korolev)
"Xy" = (
/turf/closed/shuttle/upp_dropship2{
	icon_state = "20"
	},
/area/shuttle/drop_upp2/korolev)
"Yp" = (
/turf/closed/shuttle/upp_dropship2{
	icon_state = "26"
	},
/area/shuttle/drop_upp2/korolev)
"Yw" = (
/obj/structure/sign/flag/upp{
	pixel_y = 30
	},
/obj/structure/bed/chair/vehicle{
	pixel_x = -8
	},
/obj/structure/bed/chair/vehicle{
	pixel_x = 8
	},
/turf/open/shuttle/dropship/medium_grey_single_wide_up_to_down,
/area/shuttle/drop_upp2/korolev)
"Zb" = (
/turf/closed/shuttle/upp_dropship2{
	icon_state = "24"
	},
/area/shuttle/drop_upp2/korolev)
"ZO" = (
/obj/structure/shuttle/part/dropshipupp2/transparent/inner_right_weapons,
/obj/effect/attach_point/electronics/dropship_upp2,
/turf/template_noop,
/area/shuttle/drop_upp2/korolev)

(1,1,1) = {"
Hi
Hi
Hi
Hi
Hi
Qj
rf
uB
Hi
Hi
Hi
Hi
Hi
Hi
Ud
te
vZ
TD
Hi
Hi
Hi
"}
(2,1,1) = {"
Hi
Hi
Hi
mO
zz
WU
Iq
Ub
qc
Sg
Gq
Wf
uw
Hi
LN
ja
fN
wQ
Hi
Hi
Lj
"}
(3,1,1) = {"
Hi
Hi
Hi
Hg
VY
Yw
Ph
Ph
qc
qc
Ph
Ph
qB
Wf
Wf
gz
Zb
Wf
uw
Hi
BA
"}
(4,1,1) = {"
er
oG
QS
bT
fs
xm
Ux
Ux
Ux
Ux
Ux
Bv
NP
bM
Ph
WJ
Ph
Ph
wa
fK
cU
"}
(5,1,1) = {"
sC
HQ
ar
Oe
da
ju
Ph
Ph
Ph
ju
Ph
pC
tP
fp
Ux
Ux
Ux
Ux
nn
Hi
Hi
"}
(6,1,1) = {"
sC
Dt
aQ
mh
Iu
uX
aT
xK
dV
ju
RA
xL
xL
xK
eN
rV
qc
rV
qc
Hi
Hi
"}
(7,1,1) = {"
sC
mb
Lu
Oe
da
ju
Ph
Ph
Ph
ju
Ph
Tj
tP
fp
Ux
Ux
Ux
Ux
qc
Hi
Hi
"}
(8,1,1) = {"
ti
GO
Kj
oi
DO
dl
Ux
Ux
Ux
Ux
Ux
CR
NP
bM
Ph
Id
Ph
Ph
wa
QP
Ha
"}
(9,1,1) = {"
Hi
Hi
Hi
ZO
VY
Yw
Ph
Ph
qc
qc
Ph
Ph
SR
AB
AB
wx
wL
AB
lj
Hi
lM
"}
(10,1,1) = {"
Hi
Hi
Hi
HY
MI
Dh
GN
hK
qc
Gr
PD
AB
lj
Hi
aw
aq
Yp
Xy
Hi
Hi
zI
"}
(11,1,1) = {"
Hi
Hi
Hi
Hi
Hi
wk
vy
Cq
Hi
Hi
Hi
Hi
Hi
Hi
tX
NI
uR
Cg
Hi
Hi
Hi
"}
