//MAP CONVERTED BY dmm2tgm.py THIS HEADER COMMENT PREVENTS RECONVERSION, DO NOT REMOVE
"ac" = (
/turf/closed/shuttle/dropship2/transparent{
	icon_state = "80"
	},
/area/shuttle/drop2/sulaco)
"aH" = (
/obj/structure/blocker/invisible_wall,
/obj/structure/machinery/computer/cameras/dropship/two,
/turf/open/shuttle/dropship{
	icon_state = "rasputin15"
	},
/area/shuttle/drop2/sulaco)
"by" = (
/obj/effect/attach_point/fuel/dropship2{
	dir = 1
	},
/turf/closed/shuttle/dropship2/transparent{
	icon_state = "28"
	},
/area/shuttle/drop2/sulaco)
"bJ" = (
/turf/closed/shuttle/dropship2{
	icon_state = "68"
	},
/area/shuttle/drop2/sulaco)
"bN" = (
/obj/item/device/radio/intercom/normandy{
	pixel_y = 24
	},
/turf/open/shuttle/dropship{
	icon_state = "rasputin7"
	},
/area/shuttle/drop2/sulaco)
"do" = (
/obj/effect/attach_point/crew_weapon/dropship2,
/turf/open/shuttle/dropship{
	icon_state = "rasputin3"
	},
/area/shuttle/drop2/sulaco)
"eu" = (
/turf/closed/shuttle/dropship2{
	icon_state = "75"
	},
/area/shuttle/drop2/sulaco)
"fb" = (
/turf/closed/shuttle/dropship2/transparent{
	icon_state = "23"
	},
/area/shuttle/drop2/sulaco)
"fm" = (
/turf/closed/shuttle/dropship2/transparent{
	icon_state = "29"
	},
/area/shuttle/drop2/sulaco)
"fx" = (
/turf/closed/shuttle/dropship2{
	icon_state = "69"
	},
/area/shuttle/drop2/sulaco)
"fI" = (
/turf/closed/shuttle/dropship2{
	icon_state = "73"
	},
/area/shuttle/drop2/sulaco)
"gD" = (
/turf/closed/shuttle/dropship2/transparent{
	icon_state = "38"
	},
/area/shuttle/drop2/sulaco)
"gG" = (
/obj/item/device/radio/intercom/normandy{
	layer = 3.5;
	pixel_x = 10
	},
/turf/closed/shuttle/dropship2{
	icon_state = "54"
	},
/area/shuttle/drop2/sulaco)
"gP" = (
/obj/structure/bed/chair/dropship/pilot{
	dir = 1
	},
/turf/open/shuttle/dropship{
	icon_state = "rasputin15"
	},
/area/shuttle/drop2/sulaco)
"it" = (
/obj/structure/bed/chair/vehicle{
	dir = 1;
	pixel_x = 8
	},
/obj/structure/bed/chair/vehicle{
	dir = 1;
	pixel_x = -8
	},
/turf/open/shuttle/dropship{
	icon_state = "rasputin15"
	},
/area/shuttle/drop2/sulaco)
"iu" = (
/obj/effect/attach_point/weapon/dropship2/right_wing,
/obj/structure/shuttle/part/dropship2/transparent/lower_right_wing,
/turf/template_noop,
/area/shuttle/drop2/sulaco)
"jc" = (
/obj/item/device/radio/intercom/normandy{
	layer = 3.5;
	pixel_x = -10
	},
/turf/closed/shuttle/dropship2{
	icon_state = "52"
	},
/area/shuttle/drop2/sulaco)
"jq" = (
/turf/closed/shuttle/dropship2{
	icon_state = "92"
	},
/area/shuttle/drop2/sulaco)
"lh" = (
/turf/closed/shuttle/dropship2/transparent{
	icon_state = "26"
	},
/area/shuttle/drop2/sulaco)
"lH" = (
/obj/structure/machinery/computer/dropship_weapons/dropship2,
/obj/structure/transmitter/rotary{
	name = "Normandy Telephone";
	phone_category = "Dropship";
	phone_id = "Normandy";
	pixel_x = 11;
	pixel_y = 16
	},
/obj/structure/blocker/invisible_wall,
/turf/open/shuttle/dropship{
	icon_state = "rasputin15"
	},
/area/shuttle/drop2/sulaco)
"lJ" = (
/turf/closed/shuttle/dropship2{
	icon_state = "62"
	},
/area/shuttle/drop2/sulaco)
"lV" = (
/obj/structure/shuttle/part/dropship2/transparent/upper_left_wing,
/turf/template_noop,
/area/shuttle/drop2/sulaco)
"mz" = (
/obj/structure/machinery/camera/autoname/almayer/dropship_two{
	dir = 4;
	pixel_x = -16
	},
/obj/structure/bed/chair/vehicle{
	dir = 1;
	pixel_x = 8
	},
/obj/structure/bed/chair/vehicle{
	dir = 1;
	pixel_x = -8
	},
/turf/open/shuttle/dropship{
	icon_state = "rasputin15"
	},
/area/shuttle/drop2/sulaco)
"mJ" = (
/obj/structure/shuttle/part/dropship2/transparent/engine_left_exhaust,
/turf/template_noop,
/area/shuttle/drop2/sulaco)
"nU" = (
/obj/effect/attach_point/weapon/dropship2/right_fore,
/obj/structure/shuttle/part/dropship2/transparent/outer_right_weapons,
/turf/template_noop,
/area/shuttle/drop2/sulaco)
"oj" = (
/obj/structure/shuttle/part/dropship2/transparent/middle_right_wing,
/turf/template_noop,
/area/shuttle/drop2/sulaco)
"oS" = (
/turf/closed/shuttle/dropship2/transparent{
	icon_state = "86"
	},
/area/shuttle/drop2/sulaco)
"oW" = (
/turf/closed/shuttle/dropship2/transparent{
	icon_state = "32"
	},
/area/shuttle/drop2/sulaco)
"pU" = (
/turf/closed/shuttle/dropship2{
	icon_state = "50"
	},
/area/shuttle/drop2/sulaco)
"qg" = (
/turf/open/shuttle/dropship{
	icon_state = "rasputin8"
	},
/area/shuttle/drop2/sulaco)
"qq" = (
/obj/structure/shuttle/part/dropship2/transparent/left_outer_bottom_wing,
/turf/template_noop,
/area/shuttle/drop2/sulaco)
"rc" = (
/obj/item/device/radio/intercom/normandy{
	pixel_y = 24
	},
/turf/open/shuttle/dropship{
	icon_state = "rasputin5"
	},
/area/shuttle/drop2/sulaco)
"ru" = (
/obj/structure/shuttle/part/dropship2/transparent/left_outer_inner_wing,
/turf/template_noop,
/area/shuttle/drop2/sulaco)
"rZ" = (
/obj/structure/shuttle/part/dropship2/transparent/nose_center,
/turf/template_noop,
/area/shuttle/drop2/sulaco)
"sk" = (
/turf/closed/shuttle/dropship2/transparent{
	icon_state = "22"
	},
/area/shuttle/drop2/sulaco)
"to" = (
/obj/effect/attach_point/fuel/dropship2{
	dir = 1;
	pixel_x = -32
	},
/turf/closed/shuttle/dropship2/transparent{
	icon_state = "33"
	},
/area/shuttle/drop2/sulaco)
"tr" = (
/obj/structure/shuttle/part/dropship2/transparent/right_inner_bottom_wing,
/turf/template_noop,
/area/shuttle/drop2/sulaco)
"uo" = (
/obj/effect/attach_point/electronics/dropship2{
	dir = 1
	},
/obj/structure/shuttle/part/dropship2/transparent/inner_right_weapons,
/turf/template_noop,
/area/shuttle/drop2/sulaco)
"uS" = (
/obj/structure/shuttle/part/dropship2/lower_left_wall,
/turf/open/space/basic,
/area/shuttle/drop2/sulaco)
"uU" = (
/obj/structure/shuttle/part/dropship2/nose_front_right,
/turf/template_noop,
/area/shuttle/drop2/sulaco)
"vd" = (
/turf/open/shuttle/dropship{
	icon_state = "rasputin3"
	},
/area/shuttle/drop2/sulaco)
"wX" = (
/turf/closed/shuttle/dropship2{
	icon_state = "83"
	},
/area/shuttle/drop2/sulaco)
"xe" = (
/turf/closed/shuttle/dropship2{
	icon_state = "18"
	},
/area/shuttle/drop2/sulaco)
"xx" = (
/turf/open/shuttle/dropship{
	icon_state = "rasputin5"
	},
/area/shuttle/drop2/sulaco)
"xG" = (
/obj/structure/shuttle/part/dropship2/transparent/engine_right_exhaust,
/turf/template_noop,
/area/shuttle/drop2/sulaco)
"xL" = (
/obj/docking_port/mobile/marine_dropship/normandy,
/turf/closed/shuttle/dropship2{
	icon_state = "53"
	},
/area/shuttle/drop2/sulaco)
"xU" = (
/turf/closed/shuttle/dropship2{
	icon_state = "94"
	},
/area/shuttle/drop2/sulaco)
"yl" = (
/turf/closed/shuttle/dropship2{
	icon_state = "82"
	},
/area/shuttle/drop2/sulaco)
"yu" = (
/obj/structure/shuttle/part/dropship2/transparent/right_outer_bottom_wing,
/turf/template_noop,
/area/shuttle/drop2/sulaco)
"yQ" = (
/obj/structure/shuttle/part/dropship2/bottom_left_wall,
/turf/template_noop,
/area/shuttle/drop2/sulaco)
"zp" = (
/obj/structure/shuttle/part/dropship2/transparent/middle_left_wing,
/turf/template_noop,
/area/shuttle/drop2/sulaco)
"zt" = (
/turf/closed/shuttle/dropship2/transparent{
	icon_state = "27"
	},
/area/shuttle/drop2/sulaco)
"zX" = (
/obj/structure/machinery/door/airlock/hatch/cockpit/two{
	req_access = null;
	req_access_txt = "22";
	req_one_access = null;
	dir = 1
	},
/obj/structure/blocker/forcefield/multitile_vehicles,
/turf/open/shuttle/dropship{
	icon_state = "rasputin15"
	},
/area/shuttle/drop2/sulaco)
"AN" = (
/turf/closed/shuttle/dropship2{
	icon_state = "48"
	},
/area/shuttle/drop2/sulaco)
"Bb" = (
/turf/closed/shuttle/dropship2{
	icon_state = "56"
	},
/area/shuttle/drop2/sulaco)
"Bi" = (
/turf/closed/shuttle/dropship2/transparent{
	icon_state = "97"
	},
/area/shuttle/drop2/sulaco)
"Bs" = (
/turf/closed/shuttle/dropship2{
	icon_state = "59"
	},
/area/shuttle/drop2/sulaco)
"BC" = (
/turf/closed/shuttle/dropship2{
	icon_state = "43"
	},
/area/shuttle/drop2/sulaco)
"Ce" = (
/obj/structure/shuttle/part/dropship2/transparent/engine_left_cap,
/turf/template_noop,
/area/shuttle/drop2/sulaco)
"Cl" = (
/turf/closed/shuttle/dropship2{
	icon_state = "42"
	},
/area/shuttle/drop2/sulaco)
"Co" = (
/turf/open/shuttle/dropship{
	icon_state = "rasputin4"
	},
/area/shuttle/drop2/sulaco)
"CT" = (
/obj/structure/shuttle/part/dropship2/bottom_right_wall,
/turf/template_noop,
/area/shuttle/drop2/sulaco)
"Dp" = (
/obj/structure/shuttle/part/dropship2/left_outer_wing_connector,
/turf/open/space/basic,
/area/shuttle/drop2/sulaco)
"Dy" = (
/turf/closed/shuttle/dropship2/transparent{
	icon_state = "35"
	},
/area/shuttle/drop2/sulaco)
"En" = (
/obj/structure/machinery/door/airlock/dropship_hatch/two{
	dir = 8;
	id = "starboard_door"
	},
/turf/open/shuttle/dropship{
	icon_state = "rasputin15"
	},
/area/shuttle/drop2/sulaco)
"Eo" = (
/turf/closed/shuttle/dropship2{
	icon_state = "47"
	},
/area/shuttle/drop2/sulaco)
"Fq" = (
/obj/structure/machinery/cm_vending/sorted/medical/wall_med{
	pixel_x = -30
	},
/obj/structure/bed/chair/vehicle{
	dir = 1;
	pixel_x = 8
	},
/obj/structure/bed/chair/vehicle{
	dir = 1;
	pixel_x = -8
	},
/turf/open/shuttle/dropship{
	icon_state = "rasputin15"
	},
/area/shuttle/drop2/sulaco)
"FN" = (
/obj/structure/shuttle/part/dropship2/left_inner_wing_connector,
/turf/open/space/basic,
/area/shuttle/drop2/sulaco)
"GE" = (
/turf/closed/shuttle/dropship2{
	icon_state = "67"
	},
/area/shuttle/drop2/sulaco)
"GN" = (
/obj/structure/machinery/door_control{
	id = "dropship_normandy";
	name = "Dropship Lockdown";
	normaldoorcontrol = 3;
	pixel_y = -19;
	req_one_access_txt = "3;22";
	throw_range = 15
	},
/turf/open/shuttle/dropship{
	icon_state = "floor8"
	},
/area/shuttle/drop2/sulaco)
"HB" = (
/turf/closed/shuttle/dropship2/transparent{
	icon_state = "78"
	},
/area/shuttle/drop2/sulaco)
"Jh" = (
/obj/structure/shuttle/part/dropship2/transparent/upper_right_wing,
/turf/template_noop,
/area/shuttle/drop2/sulaco)
"Kl" = (
/turf/closed/shuttle/dropship2{
	icon_state = "10"
	},
/area/shuttle/drop2/sulaco)
"Kq" = (
/obj/structure/shuttle/part/dropship2/right_inner_wing_connector,
/turf/open/space/basic,
/area/shuttle/drop2/sulaco)
"Le" = (
/turf/closed/shuttle/dropship2/transparent{
	icon_state = "98"
	},
/area/shuttle/drop2/sulaco)
"Lh" = (
/obj/item/device/radio/intercom/normandy{
	pixel_y = 24
	},
/turf/open/shuttle/dropship{
	icon_state = "rasputin6"
	},
/area/shuttle/drop2/sulaco)
"Lk" = (
/turf/closed/shuttle/dropship2{
	icon_state = "30"
	},
/area/shuttle/drop2/sulaco)
"Lq" = (
/turf/closed/shuttle/dropship2{
	icon_state = "19"
	},
/area/shuttle/drop2/sulaco)
"LG" = (
/obj/structure/shuttle/part/dropship2/transparent/nose_top_left,
/turf/template_noop,
/area/shuttle/drop2/sulaco)
"LJ" = (
/obj/structure/bed/chair/dropship/pilot{
	dir = 1
	},
/obj/structure/machinery/camera/autoname/almayer/dropship_two{
	pixel_x = 8;
	pixel_y = -16
	},
/turf/open/shuttle/dropship{
	icon_state = "rasputin15"
	},
/area/shuttle/drop2/sulaco)
"ME" = (
/turf/closed/shuttle/dropship2/transparent{
	icon_state = "96"
	},
/area/shuttle/drop2/sulaco)
"ML" = (
/turf/closed/shuttle/dropship2{
	icon_state = "77"
	},
/area/shuttle/drop2/sulaco)
"MQ" = (
/obj/structure/blocker/invisible_wall,
/obj/structure/machinery/computer/shuttle/dropship/flight,
/turf/open/shuttle/dropship{
	icon_state = "rasputin15"
	},
/area/shuttle/drop2/sulaco)
"Nw" = (
/turf/closed/shuttle/dropship2{
	icon_state = "37"
	},
/area/shuttle/drop2/sulaco)
"OI" = (
/turf/closed/shuttle/dropship2{
	icon_state = "72"
	},
/area/shuttle/drop2/sulaco)
"OJ" = (
/obj/structure/machinery/cm_vending/sorted/medical/wall_med{
	pixel_x = 30
	},
/obj/structure/bed/chair/vehicle{
	dir = 1;
	pixel_x = 8
	},
/obj/structure/bed/chair/vehicle{
	dir = 1;
	pixel_x = -8
	},
/turf/open/shuttle/dropship{
	icon_state = "rasputin15"
	},
/area/shuttle/drop2/sulaco)
"Px" = (
/turf/closed/shuttle/dropship2{
	icon_state = "31"
	},
/area/shuttle/drop2/sulaco)
"PJ" = (
/turf/open/shuttle/dropship{
	icon_state = "rasputin15"
	},
/area/shuttle/drop2/sulaco)
"Qd" = (
/obj/structure/machinery/camera/autoname/almayer/dropship_two{
	dir = 8;
	pixel_x = 16
	},
/obj/structure/bed/chair/vehicle{
	pixel_x = 8
	},
/obj/structure/bed/chair/vehicle{
	pixel_x = -8
	},
/turf/open/shuttle/dropship{
	icon_state = "rasputin15"
	},
/area/shuttle/drop2/sulaco)
"Qo" = (
/turf/closed/shuttle/dropship2{
	icon_state = "76"
	},
/area/shuttle/drop2/sulaco)
"QF" = (
/turf/closed/shuttle/dropship2{
	icon_state = "14"
	},
/area/shuttle/drop2/sulaco)
"QT" = (
/obj/effect/attach_point/weapon/dropship2/left_wing,
/obj/structure/shuttle/part/dropship2/transparent/lower_left_wing,
/turf/template_noop,
/area/shuttle/drop2/sulaco)
"Rr" = (
/turf/template_noop,
/area/template_noop)
"RE" = (
/obj/structure/machinery/door/airlock/multi_tile/almayer/dropshiprear/ds2{
	id = "aft_door"
	},
/turf/open/shuttle/dropship{
	icon_state = "rasputin15"
	},
/area/shuttle/drop2/sulaco)
"RG" = (
/turf/closed/shuttle/dropship2{
	icon_state = "51"
	},
/area/shuttle/drop2/sulaco)
"Sp" = (
/obj/structure/shuttle/part/dropship2/transparent/engine_right_cap,
/turf/template_noop,
/area/shuttle/drop2/sulaco)
"SC" = (
/obj/structure/machinery/door/airlock/dropship_hatch/two{
	id = "port_door"
	},
/turf/open/shuttle/dropship{
	icon_state = "rasputin15"
	},
/area/shuttle/drop2/sulaco)
"SO" = (
/turf/closed/shuttle/dropship2{
	icon_state = "36"
	},
/area/shuttle/drop2/sulaco)
"SQ" = (
/turf/closed/shuttle/dropship2/transparent{
	icon_state = "34"
	},
/area/shuttle/drop2/sulaco)
"SY" = (
/obj/structure/bed/chair/vehicle{
	pixel_x = 8
	},
/obj/structure/bed/chair/vehicle{
	pixel_x = -8
	},
/turf/open/shuttle/dropship{
	icon_state = "rasputin15"
	},
/area/shuttle/drop2/sulaco)
"Tp" = (
/turf/closed/shuttle/dropship2{
	icon_state = "64"
	},
/area/shuttle/drop2/sulaco)
"TH" = (
/obj/structure/shuttle/part/dropship2/lower_right_wall,
/turf/open/space/basic,
/area/shuttle/drop2/sulaco)
"TZ" = (
/turf/closed/shuttle/dropship2{
	icon_state = "81"
	},
/area/shuttle/drop2/sulaco)
"UP" = (
/turf/closed/shuttle/dropship2/transparent{
	icon_state = "39"
	},
/area/shuttle/drop2/sulaco)
"UX" = (
/turf/closed/shuttle/dropship2{
	icon_state = "24"
	},
/area/shuttle/drop2/sulaco)
"Vs" = (
/turf/closed/shuttle/dropship2/transparent{
	icon_state = "89"
	},
/area/shuttle/drop2/sulaco)
"VA" = (
/turf/closed/shuttle/dropship2{
	icon_state = "25"
	},
/area/shuttle/drop2/sulaco)
"VZ" = (
/obj/item/device/radio/intercom/normandy{
	layer = 3.5;
	pixel_x = 21;
	pixel_y = 43
	},
/turf/open/shuttle/dropship{
	icon_state = "rasputin15"
	},
/area/shuttle/drop2/sulaco)
"Wi" = (
/obj/structure/shuttle/part/dropship2/transparent/nose_top_right,
/turf/template_noop,
/area/shuttle/drop2/sulaco)
"WO" = (
/obj/effect/attach_point/electronics/dropship2{
	dir = 1
	},
/obj/structure/shuttle/part/dropship2/transparent/inner_left_weapons,
/turf/template_noop,
/area/shuttle/drop2/sulaco)
"Xy" = (
/obj/structure/shuttle/part/dropship2/nose_front_left,
/turf/template_noop,
/area/shuttle/drop2/sulaco)
"Ya" = (
/obj/effect/attach_point/weapon/dropship2/left_fore,
/obj/structure/shuttle/part/dropship2/transparent/outer_left_weapons,
/turf/template_noop,
/area/shuttle/drop2/sulaco)
"Ze" = (
/obj/structure/shuttle/part/dropship2/right_outer_wing_connector,
/turf/open/space/basic,
/area/shuttle/drop2/sulaco)
"ZK" = (
/turf/closed/shuttle/dropship2{
	icon_state = "63"
	},
/area/shuttle/drop2/sulaco)

(1,1,1) = {"
Rr
Rr
Rr
Rr
Rr
lV
zp
QT
Rr
Rr
Rr
Rr
Rr
Ce
SQ
by
sk
mJ
Rr
Rr
Rr
"}
(2,1,1) = {"
Rr
Rr
Rr
Ya
eu
OI
GE
lJ
SC
SC
jc
pU
uS
Sp
Dy
fm
fb
xG
Rr
Rr
qq
"}
(3,1,1) = {"
Rr
Rr
Rr
WO
Qo
SY
mz
SY
PJ
PJ
SY
it
Eo
Cl
SO
Lk
UX
xe
yQ
Rr
ru
"}
(4,1,1) = {"
LG
Xy
jq
oS
ML
Lh
vd
vd
vd
vd
vd
Co
SY
Fq
SY
it
SY
it
Kl
FN
Dp
"}
(5,1,1) = {"
rZ
ME
aH
LJ
HB
xx
SY
it
SY
it
SY
xx
vd
vd
vd
vd
vd
vd
RE
Rr
Rr
"}
(6,1,1) = {"
rZ
Bi
MQ
VZ
zX
GN
bJ
ZK
Bs
Bb
xL
rc
vd
do
vd
do
vd
do
PJ
Rr
Rr
"}
(7,1,1) = {"
rZ
Le
lH
gP
ac
xx
SY
it
SY
it
SY
xx
vd
vd
vd
vd
vd
vd
PJ
Rr
Rr
"}
(8,1,1) = {"
Wi
uU
xU
Vs
TZ
bN
vd
vd
vd
vd
vd
qg
SY
OJ
Qd
it
SY
it
QF
Kq
Ze
"}
(9,1,1) = {"
Rr
Rr
Rr
uo
yl
SY
it
SY
PJ
PJ
SY
it
AN
BC
Nw
Px
VA
Lq
CT
Rr
tr
"}
(10,1,1) = {"
Rr
Rr
Rr
nU
wX
fI
fx
Tp
En
En
gG
RG
TH
Ce
gD
oW
lh
mJ
Rr
Rr
yu
"}
(11,1,1) = {"
Rr
Rr
Rr
Rr
Rr
Jh
oj
iu
Rr
Rr
Rr
Rr
Rr
Sp
UP
to
zt
xG
Rr
Rr
Rr
"}
