//MAP CONVERTED BY dmm2tgm.py THIS HEADER COMMENT PREVENTS RECONVERSION, DO NOT REMOVE
"a" = (
/turf/open/floor/plating/bare_catwalk,
/area/shuttle/elevator_req_uscm)
"b" = (
/obj/docking_port/mobile/marine_dropship/req_uscm,
/turf/open/floor/plating/bare_catwalk,
/area/shuttle/elevator_req_uscm)
"s" = (
/turf/open/floor/almayer/test_floor5,
/area/shuttle/elevator_req_uscm)

(1,1,1) = {"
a
a
a
a
a
"}
(2,1,1) = {"
a
s
a
s
a
"}
(3,1,1) = {"
a
a
b
a
a
"}
(4,1,1) = {"
a
s
a
s
a
"}
(5,1,1) = {"
a
a
a
a
a
"}
