//MAP CONVERTED BY dmm2tgm.py THIS HEADER COMMENT PREVENTS RECONVERSION, DO NOT REMOVE
"a" = (
/turf/closed/shuttle/ert{
	icon_state = "rightengine_1";
	opacity = 0
	},
/area/shuttle/ert)
"b" = (
/turf/closed/shuttle/ert{
	icon_state = "wy_leftengine"
	},
/area/shuttle/ert)
"c" = (
/turf/closed/shuttle/ert{
	icon_state = "wy21"
	},
/area/shuttle/ert)
"d" = (
/turf/open/shuttle/dropship/light_grey_top_left,
/area/shuttle/ert)
"e" = (
/turf/closed/shuttle/ert{
	icon_state = "wy13"
	},
/area/shuttle/ert)
"f" = (
/obj/structure/surface/rack,
/obj/effect/landmark/ert_spawns/distress_pmc/item,
/obj/item/storage/firstaid/regular,
/obj/item/storage/belt/medical/lifesaver/full,
/obj/item/device/healthanalyzer,
/turf/open/shuttle/dropship/medium_grey_single_wide_up_to_down,
/area/shuttle/ert)
"g" = (
/obj/structure/surface/rack,
/obj/effect/landmark/ert_spawns/distress_pmc/item,
/obj/item/storage/firstaid/adv{
	pixel_x = 2;
	pixel_y = -5
	},
/turf/open/shuttle/dropship/medium_grey_single_wide_up_to_down,
/area/shuttle/ert)
"h" = (
/turf/open/shuttle/dropship/light_grey_bottom_right,
/area/shuttle/ert)
"i" = (
/turf/template_noop,
/area/template_noop)
"j" = (
/turf/closed/shuttle/ert{
	icon_state = "wy12"
	},
/area/shuttle/ert)
"k" = (
/turf/open/shuttle/dropship/medium_grey_single_wide_up_to_down,
/area/shuttle/ert)
"l" = (
/turf/closed/shuttle/ert{
	icon_state = "wy23"
	},
/area/shuttle/ert)
"m" = (
/turf/open/shuttle/dropship/light_grey_top_right,
/area/shuttle/ert)
"n" = (
/turf/closed/shuttle/ert{
	icon_state = "wy17"
	},
/area/shuttle/ert)
"o" = (
/obj/docking_port/mobile/emergency_response/ert2,
/turf/closed/shuttle/ert{
	icon_state = "leftengine_1";
	opacity = 0
	},
/area/shuttle/ert)
"p" = (
/turf/closed/shuttle/ert{
	icon_state = "wy4"
	},
/area/shuttle/ert)
"q" = (
/obj/structure/machinery/door/airlock/almayer/generic{
	dir = 2
	},
/turf/open/shuttle/dropship/medium_grey_single_wide_up_to_down,
/area/shuttle/ert)
"r" = (
/turf/closed/shuttle/ert{
	icon_state = "wy5"
	},
/area/shuttle/ert)
"s" = (
/turf/open/shuttle/dropship/light_grey_single_wide_up_to_down,
/area/shuttle/ert)
"t" = (
/obj/structure/machinery/door/airlock/almayer/generic,
/turf/open/shuttle/dropship/light_grey_single_wide_up_to_down,
/area/shuttle/ert)
"u" = (
/obj/structure/bed/chair/dropship/passenger{
	dir = 4
	},
/obj/effect/landmark/ert_spawns/distress_pmc,
/turf/open/shuttle/dropship/medium_grey_single_wide_up_to_down,
/area/shuttle/ert)
"v" = (
/turf/closed/shuttle/ert{
	icon_state = "wy8"
	},
/area/shuttle/ert)
"w" = (
/turf/closed/shuttle/ert{
	icon_state = "wy_rightengine"
	},
/area/shuttle/ert)
"x" = (
/turf/closed/shuttle/ert{
	icon_state = "wy16"
	},
/area/shuttle/ert)
"y" = (
/turf/closed/shuttle/ert{
	icon_state = "wy25"
	},
/area/shuttle/ert)
"z" = (
/turf/closed/shuttle/ert{
	icon_state = "leftengine_3";
	opacity = 0
	},
/area/shuttle/ert)
"A" = (
/turf/closed/shuttle/ert{
	icon_state = "wy27"
	},
/area/shuttle/ert)
"D" = (
/turf/closed/shuttle/ert{
	icon_state = "wy15"
	},
/area/shuttle/ert)
"E" = (
/turf/closed/shuttle/ert{
	icon_state = "wy22"
	},
/area/shuttle/ert)
"F" = (
/turf/closed/shuttle/ert{
	icon_state = "wy19"
	},
/area/shuttle/ert)
"G" = (
/turf/open/shuttle/dropship/light_grey_single_wide_left_to_right,
/area/shuttle/ert)
"H" = (
/obj/structure/bed/chair/dropship/passenger,
/obj/effect/landmark/ert_spawns/distress_pmc,
/turf/open/shuttle/dropship/medium_grey_single_wide_up_to_down,
/area/shuttle/ert)
"I" = (
/obj/structure/blocker/invisible_wall,
/obj/structure/machinery/computer/shuttle/ert,
/turf/open/shuttle/dropship/medium_grey_single_wide_up_to_down,
/area/shuttle/ert)
"J" = (
/obj/effect/landmark/ert_spawns/distress_pmc,
/turf/open/shuttle/dropship/light_grey_single_wide_up_to_down,
/area/shuttle/ert)
"K" = (
/turf/closed/shuttle/ert{
	icon_state = "wy20"
	},
/area/shuttle/ert)
"L" = (
/obj/structure/bed/chair/dropship/passenger{
	dir = 8
	},
/obj/effect/landmark/ert_spawns/distress_pmc,
/turf/open/shuttle/dropship/medium_grey_single_wide_up_to_down,
/area/shuttle/ert)
"M" = (
/turf/closed/shuttle/ert{
	icon_state = "rightengine_2";
	opacity = 0
	},
/area/shuttle/ert)
"N" = (
/turf/closed/shuttle/ert{
	icon_state = "wy9"
	},
/area/shuttle/ert)
"P" = (
/turf/closed/shuttle/ert{
	icon_state = "leftengine_2";
	opacity = 0
	},
/area/shuttle/ert)
"Q" = (
/obj/structure/surface/rack,
/obj/effect/landmark/ert_spawns/distress_pmc/item,
/obj/item/storage/toolbox/syndicate,
/turf/open/shuttle/dropship/medium_grey_single_wide_up_to_down,
/area/shuttle/ert)
"R" = (
/turf/closed/shuttle/ert{
	icon_state = "wy14"
	},
/area/shuttle/ert)
"S" = (
/turf/closed/shuttle/ert{
	icon_state = "rightengine_3";
	opacity = 0
	},
/area/shuttle/ert)
"T" = (
/turf/closed/shuttle/ert{
	icon_state = "wy2"
	},
/area/shuttle/ert)
"U" = (
/turf/closed/shuttle/ert{
	icon_state = "wy1"
	},
/area/shuttle/ert)
"X" = (
/turf/closed/shuttle/ert{
	icon_state = "wy3"
	},
/area/shuttle/ert)
"Y" = (
/turf/open/shuttle/dropship/light_grey_bottom_left,
/area/shuttle/ert)
"Z" = (
/turf/closed/shuttle/ert{
	icon_state = "wy18"
	},
/area/shuttle/ert)

(1,1,1) = {"
i
K
Z
t
x
R
j
t
p
b
z
P
o
"}
(2,1,1) = {"
i
c
Q
k
u
u
u
k
f
v
p
p
U
"}
(3,1,1) = {"
K
E
d
J
J
J
J
J
Y
k
k
k
q
"}
(4,1,1) = {"
A
I
G
H
H
H
H
H
G
s
s
s
T
"}
(5,1,1) = {"
y
l
m
J
J
J
J
J
h
k
k
k
q
"}
(6,1,1) = {"
i
c
g
k
L
L
L
k
f
N
r
r
X
"}
(7,1,1) = {"
i
y
F
t
n
D
e
t
r
w
S
M
a
"}
