//MAP CONVERTED BY dmm2tgm.py THIS HEADER COMMENT PREVENTS RECONVERSION, DO NOT REMOVE
"a" = (
/turf/open/shuttle/dropship/medium_grey_single_wide_up_to_down,
/area/shuttle/ert)
"b" = (
/turf/closed/shuttle/ert{
	icon_state = "twe25"
	},
/area/shuttle/ert)
"e" = (
/obj/effect/landmark/ert_spawns/distress_twe,
/turf/open/shuttle/dropship/light_grey_single_wide_up_to_down,
/area/shuttle/ert)
"f" = (
/turf/open/shuttle/dropship/light_grey_single_wide_up_to_down,
/area/shuttle/ert)
"g" = (
/obj/structure/surface/rack,
/obj/item/storage/toolbox/syndicate,
/obj/item/storage/toolbox/syndicate,
/turf/open/shuttle/dropship/medium_grey_single_wide_up_to_down,
/area/shuttle/ert)
"h" = (
/turf/open/shuttle/dropship/light_grey_single_wide_left_to_right,
/area/shuttle/ert)
"i" = (
/turf/closed/shuttle/ert{
	icon_state = "twe3"
	},
/area/shuttle/ert)
"j" = (
/turf/closed/shuttle/ert{
	icon_state = "twe23"
	},
/area/shuttle/ert)
"k" = (
/turf/closed/shuttle/ert{
	icon_state = "rightengine_3";
	opacity = 0
	},
/area/shuttle/ert)
"l" = (
/turf/closed/shuttle/ert{
	icon_state = "leftengine_2";
	opacity = 0
	},
/area/shuttle/ert)
"o" = (
/turf/closed/shuttle/ert{
	icon_state = "twe1"
	},
/area/shuttle/ert)
"p" = (
/turf/open/shuttle/dropship/light_grey_bottom_right,
/area/shuttle/ert)
"q" = (
/obj/docking_port/mobile/emergency_response/ert4,
/turf/closed/shuttle/ert{
	icon_state = "leftengine_1";
	opacity = 0
	},
/area/shuttle/ert)
"r" = (
/obj/structure/blocker/invisible_wall,
/obj/structure/machinery/computer/shuttle/ert,
/turf/open/shuttle/dropship/medium_grey_single_wide_up_to_down,
/area/shuttle/ert)
"s" = (
/turf/open/shuttle/dropship/light_grey_top_right,
/area/shuttle/ert)
"t" = (
/obj/structure/surface/rack,
/obj/item/storage/firstaid/regular,
/obj/item/storage/belt/medical/lifesaver/full,
/obj/item/device/healthanalyzer,
/turf/open/shuttle/dropship/medium_grey_single_wide_up_to_down,
/area/shuttle/ert)
"v" = (
/turf/closed/shuttle/ert{
	icon_state = "rightengine_2";
	opacity = 0
	},
/area/shuttle/ert)
"x" = (
/turf/closed/shuttle/ert{
	icon_state = "twe4"
	},
/area/shuttle/ert)
"y" = (
/turf/closed/shuttle/ert{
	icon_state = "twe_leftengine"
	},
/area/shuttle/ert)
"z" = (
/turf/closed/shuttle/ert{
	icon_state = "twe27"
	},
/area/shuttle/ert)
"A" = (
/turf/closed/shuttle/ert{
	icon_state = "twe21"
	},
/area/shuttle/ert)
"D" = (
/obj/structure/machinery/door/airlock/almayer/generic,
/turf/open/shuttle/dropship/light_grey_single_wide_up_to_down,
/area/shuttle/ert)
"E" = (
/turf/closed/shuttle/ert{
	icon_state = "twe22"
	},
/area/shuttle/ert)
"F" = (
/turf/closed/shuttle/ert{
	icon_state = "twe8"
	},
/area/shuttle/ert)
"G" = (
/turf/closed/shuttle/ert{
	icon_state = "twe2"
	},
/area/shuttle/ert)
"H" = (
/obj/structure/bed/chair/dropship/passenger{
	dir = 8
	},
/obj/effect/landmark/ert_spawns/distress_twe,
/turf/open/shuttle/dropship/medium_grey_single_wide_up_to_down,
/area/shuttle/ert)
"J" = (
/turf/closed/shuttle/ert{
	icon_state = "twe_rightengine"
	},
/area/shuttle/ert)
"K" = (
/turf/open/shuttle/dropship/light_grey_bottom_left,
/area/shuttle/ert)
"L" = (
/turf/open/shuttle/dropship/light_grey_top_left,
/area/shuttle/ert)
"M" = (
/obj/structure/machinery/door/airlock/almayer/generic{
	dir = 2
	},
/turf/open/shuttle/dropship/medium_grey_single_wide_up_to_down,
/area/shuttle/ert)
"N" = (
/turf/closed/shuttle/ert{
	icon_state = "twe5"
	},
/area/shuttle/ert)
"O" = (
/turf/template_noop,
/area/template_noop)
"P" = (
/obj/structure/bed/chair/dropship/passenger,
/obj/effect/landmark/ert_spawns/distress_twe,
/turf/open/shuttle/dropship/medium_grey_single_wide_up_to_down,
/area/shuttle/ert)
"T" = (
/turf/closed/shuttle/ert{
	icon_state = "leftengine_3";
	opacity = 0
	},
/area/shuttle/ert)
"U" = (
/turf/closed/shuttle/ert{
	icon_state = "twe9"
	},
/area/shuttle/ert)
"V" = (
/turf/closed/shuttle/ert{
	icon_state = "rightengine_1";
	opacity = 0
	},
/area/shuttle/ert)
"W" = (
/obj/structure/bed/chair/dropship/passenger{
	dir = 4
	},
/obj/effect/landmark/ert_spawns/distress_twe,
/turf/open/shuttle/dropship/medium_grey_single_wide_up_to_down,
/area/shuttle/ert)
"X" = (
/turf/closed/shuttle/ert{
	icon_state = "twe20"
	},
/area/shuttle/ert)
"Y" = (
/obj/structure/surface/rack,
/obj/item/storage/backpack/rmc/frame,
/obj/item/ammo_box/magazine/misc/mre,
/turf/open/shuttle/dropship/medium_grey_single_wide_up_to_down,
/area/shuttle/ert)

(1,1,1) = {"
O
X
x
D
x
x
x
D
x
y
T
l
q
"}
(2,1,1) = {"
O
A
Y
a
W
W
W
a
t
F
x
x
o
"}
(3,1,1) = {"
X
E
L
e
e
e
e
e
K
a
a
a
M
"}
(4,1,1) = {"
z
r
h
P
P
P
P
P
h
f
f
f
G
"}
(5,1,1) = {"
b
j
s
e
e
e
e
e
p
a
a
a
M
"}
(6,1,1) = {"
O
A
g
a
H
H
H
a
t
U
N
N
i
"}
(7,1,1) = {"
O
b
N
D
N
N
N
D
N
J
k
v
V
"}
