//MAP CONVERTED BY dmm2tgm.py THIS HEADER COMMENT PREVENTS RECONVERSION, DO NOT REMOVE
"ax" = (
/turf/open/shuttle/dropship{
	icon_state = "rasputin8";
	tag = "icon-rasputin7"
	},
/area/shuttle/getty)
"aY" = (
/turf/closed/shuttle/getty/engine/upper_lower/outer/right,
/area/shuttle/getty)
"de" = (
/obj/structure/dropship_parts/midway/right/engine_upper,
/turf/template_noop,
/area/shuttle/getty)
"ec" = (
/turf/closed/shuttle/getty/body/wing/left,
/area/shuttle/getty)
"eE" = (
/obj/structure/machinery/computer/shuttle/getty,
/turf/open/floor/plating,
/area/shuttle/getty)
"eK" = (
/obj/structure/bed/chair/dropship/pilot{
	dir = 1;
	tag = "icon-pilot_chair (NORTH)"
	},
/turf/open/shuttle/dropship{
	icon_state = "rasputin15";
	tag = "icon-rasputin15"
	},
/area/shuttle/getty)
"eP" = (
/obj/structure/dropship_parts/midway/right/cap,
/turf/template_noop,
/area/shuttle/getty)
"fq" = (
/obj/structure/dropship_parts/midway/right/body_lower,
/turf/template_noop,
/area/shuttle/getty)
"gd" = (
/obj/structure/dropship_parts/midway/right/body_upper,
/turf/open/space/basic,
/area/shuttle/getty)
"hj" = (
/turf/closed/shuttle/getty/cockpit/side/left,
/area/shuttle/getty)
"hA" = (
/turf/closed/shuttle/getty/engine/upper_middle/outer/right,
/area/shuttle/getty)
"jD" = (
/turf/closed/shuttle/getty/engine/upper/inner/right,
/area/shuttle/getty)
"kk" = (
/obj/structure/dropship_parts/midway/left/body_upper,
/turf/open/space/basic,
/area/shuttle/getty)
"kU" = (
/turf/closed/shuttle/getty/cockpit/front/right,
/area/shuttle/getty)
"lQ" = (
/turf/closed/shuttle/getty/body/upper/left,
/area/shuttle/getty)
"mB" = (
/turf/open/shuttle/dropship{
	icon_state = "rasputin15";
	tag = "icon-rasputin15"
	},
/area/shuttle/getty)
"nb" = (
/turf/open/shuttle/dropship{
	icon_state = "rasputin7";
	tag = "icon-rasputin7"
	},
/area/shuttle/getty)
"nK" = (
/turf/template_noop,
/area/template_noop)
"oR" = (
/turf/closed/shuttle/getty/engine/upper_middle/inner/left,
/area/shuttle/getty)
"pN" = (
/turf/closed/shuttle/getty/body/join_to_wing,
/area/shuttle/getty)
"qw" = (
/turf/closed/shuttle/getty/body/upper/right,
/area/shuttle/getty)
"qQ" = (
/turf/open/shuttle/dropship{
	icon_state = "rasputin6";
	tag = "icon-rasputin6"
	},
/area/shuttle/getty)
"rN" = (
/obj/structure/dropship_parts/midway/left/cockpit_upper,
/turf/template_noop,
/area/shuttle/getty)
"sH" = (
/obj/structure/dropship_parts/midway/left/body_lower,
/turf/template_noop,
/area/shuttle/getty)
"tc" = (
/turf/closed/shuttle/getty/engine/upper_middle/inner/right,
/area/shuttle/getty)
"tx" = (
/turf/closed/shuttle/getty/engine/upper/inner/left,
/area/shuttle/getty)
"vy" = (
/obj/structure/machinery/door/airlock/dropship_hatch/getty,
/turf/open/shuttle/dropship{
	icon_state = "rasputin15";
	tag = "icon-rasputin15"
	},
/area/shuttle/getty)
"wr" = (
/obj/structure/dropship_parts/midway/left/lower_wing,
/turf/template_noop,
/area/shuttle/getty)
"xN" = (
/turf/closed/shuttle/getty/engine/upper_middle/outer/left,
/area/shuttle/getty)
"xZ" = (
/obj/structure/dropship_parts/midway/right/cockpit_upper,
/turf/template_noop,
/area/shuttle/getty)
"zK" = (
/obj/structure/dropship_parts/midway/right/lower_wing,
/turf/template_noop,
/area/shuttle/getty)
"Af" = (
/turf/closed/shuttle/getty/body/bottom_wing/left,
/area/shuttle/getty)
"BA" = (
/turf/closed/shuttle/getty/engine/upper_lower/outer/left,
/area/shuttle/getty)
"DW" = (
/obj/structure/machinery/door/airlock/dropship_hatch/getty{
	dir = 8
	},
/turf/open/shuttle/dropship{
	icon_state = "rasputin15";
	tag = "icon-rasputin15"
	},
/area/shuttle/getty)
"FX" = (
/turf/closed/shuttle/getty/body/bottom_wing/right,
/area/shuttle/getty)
"GU" = (
/obj/structure/machinery/computer/camera_advanced/shuttle_docker/getty,
/turf/open/floor/plating,
/area/shuttle/getty)
"Ha" = (
/turf/closed/shuttle/getty/engine/upper_lower/inner/right,
/area/shuttle/getty)
"Hd" = (
/obj/structure/dropship_parts/midway/right/wing_outer,
/turf/template_noop,
/area/shuttle/getty)
"IF" = (
/obj/structure/dropship_parts/midway/left/upper_wing,
/turf/template_noop,
/area/shuttle/getty)
"IH" = (
/obj/structure/dropship_parts/midway/right/engine_lower,
/turf/template_noop,
/area/shuttle/getty)
"II" = (
/obj/structure/dropship_parts/midway/right/wing_inner,
/turf/template_noop,
/area/shuttle/getty)
"JD" = (
/obj/structure/dropship_parts/midway/right/upper_wing,
/turf/template_noop,
/area/shuttle/getty)
"JX" = (
/turf/closed/shuttle/getty/cockpit/side/right,
/area/shuttle/getty)
"Kq" = (
/turf/open/shuttle/dropship{
	icon_state = "rasputin3";
	tag = "icon-rasputin3"
	},
/area/shuttle/getty)
"Ly" = (
/obj/structure/dropship_parts/midway/left/engine_lower,
/turf/template_noop,
/area/shuttle/getty)
"Lz" = (
/obj/structure/dropship_parts/midway/left/wing_outer,
/obj/docking_port/mobile/getty,
/turf/template_noop,
/area/shuttle/getty)
"MA" = (
/turf/closed/shuttle/getty/engine/upper_lower/inner/left,
/area/shuttle/getty)
"Nt" = (
/turf/closed/shuttle/getty/body/wing/right,
/area/shuttle/getty)
"NQ" = (
/obj/structure/bed/chair/dropship/passenger/shuttle_chair{
	dir = 4
	},
/turf/open/shuttle/dropship{
	icon_state = "rasputin15";
	tag = "icon-rasputin15"
	},
/area/shuttle/getty)
"Oc" = (
/obj/structure/machinery/door/airlock/multi_tile/almayer/getty,
/turf/open/shuttle/dropship{
	icon_state = "rasputin4";
	tag = "icon-rasputin7"
	},
/area/shuttle/getty)
"Si" = (
/turf/closed/shuttle/getty/cockpit/front/left,
/area/shuttle/getty)
"UA" = (
/obj/structure/dropship_parts/midway/left/wing_inner,
/turf/template_noop,
/area/shuttle/getty)
"UU" = (
/obj/structure/bed/chair/dropship/passenger/shuttle_chair{
	dir = 8
	},
/turf/open/shuttle/dropship{
	icon_state = "rasputin15";
	tag = "icon-rasputin15"
	},
/area/shuttle/getty)
"WQ" = (
/obj/structure/dropship_parts/midway/left/engine_upper,
/turf/template_noop,
/area/shuttle/getty)
"ZR" = (
/obj/structure/dropship_parts/midway/left/cap,
/turf/template_noop,
/area/shuttle/getty)

(1,1,1) = {"
nK
nK
IF
wr
nK
WQ
xN
BA
Ly
Lz
"}
(2,1,1) = {"
nK
ZR
kk
ec
vy
tx
oR
MA
sH
UA
"}
(3,1,1) = {"
rN
hj
lQ
NQ
mB
NQ
NQ
NQ
pN
Af
"}
(4,1,1) = {"
Si
GU
eK
qQ
Kq
Kq
Kq
Kq
Oc
nK
"}
(5,1,1) = {"
kU
eE
eK
nb
Kq
Kq
Kq
Kq
ax
nK
"}
(6,1,1) = {"
xZ
JX
qw
UU
mB
UU
UU
UU
pN
FX
"}
(7,1,1) = {"
nK
eP
gd
Nt
DW
jD
tc
Ha
fq
II
"}
(8,1,1) = {"
nK
nK
JD
zK
nK
de
hA
aY
IH
Hd
"}
