//MAP CONVERTED BY dmm2tgm.py THIS HEADER COMMENT PREVENTS RECONVERSION, DO NOT REMOVE
"a" = (
/turf/template_noop,
/area/template_noop)
"l" = (
/obj/structure/machinery/door/poddoor/almayer/locked{
	name = "\improper Umbillical Airlock"
	},
/turf/open/floor/almayer/plate,
/area/shuttle/ert/no_defenses)
"m" = (
/obj/effect/landmark/ert_spawns/umbilical,
/turf/open/floor/almayer/plate,
/area/shuttle/ert/no_defenses)
"r" = (
/obj/effect/decal/warning_stripes{
	icon_state = "W";
	dir = 1
	},
/turf/open/floor/plating/almayer,
/area/shuttle/ert/no_defenses)
"s" = (
/obj/effect/decal/warning_stripes{
	icon_state = "E";
	pixel_x = 1
	},
/obj/structure/machinery/door/poddoor/almayer/locked{
	name = "\improper Umbillical Airlock"
	},
/turf/open/floor/plating/almayer,
/area/shuttle/ert/no_defenses)
"y" = (
/obj/effect/decal/warning_stripes{
	icon_state = "E";
	pixel_x = 1
	},
/obj/effect/landmark/ert_spawns/umbilical,
/turf/open/floor/plating/almayer,
/area/shuttle/ert/no_defenses)
"A" = (
/obj/effect/decal/warning_stripes{
	icon_state = "W";
	dir = 1
	},
/obj/effect/landmark/ert_spawns/umbilical,
/turf/open/floor/plating/almayer,
/area/shuttle/ert/no_defenses)
"H" = (
/obj/effect/decal/warning_stripes{
	icon_state = "E";
	pixel_x = 1
	},
/turf/open/floor/plating/almayer,
/area/shuttle/ert/no_defenses)
"M" = (
/turf/open/floor/almayer/plate,
/area/shuttle/ert/no_defenses)
"Q" = (
/turf/closed/wall/almayer/white/hull,
/area/shuttle/ert/no_defenses)
"S" = (
/obj/docking_port/mobile/port_umbilical_cord{
	dir = 4
	},
/turf/template_noop,
/area/template_noop)
"Z" = (
/obj/effect/decal/warning_stripes{
	icon_state = "W";
	dir = 1
	},
/obj/structure/machinery/door/poddoor/almayer/locked{
	name = "\improper Umbillical Airlock"
	},
/turf/open/floor/plating/almayer,
/area/shuttle/ert/no_defenses)

(1,1,1) = {"
a
a
a
a
a
Q
"}
(2,1,1) = {"
a
a
a
a
a
Q
"}
(3,1,1) = {"
a
a
a
a
a
Q
"}
(4,1,1) = {"
a
a
a
a
a
Q
"}
(5,1,1) = {"
a
a
a
a
a
Q
"}
(6,1,1) = {"
S
a
a
a
a
Q
"}
(7,1,1) = {"
Q
Q
Q
Q
Q
Q
"}
(8,1,1) = {"
M
m
M
m
M
l
"}
(9,1,1) = {"
A
r
r
A
A
Z
"}
(10,1,1) = {"
H
y
y
H
H
s
"}
(11,1,1) = {"
m
M
m
M
m
l
"}
(12,1,1) = {"
Q
Q
Q
Q
Q
Q
"}
(13,1,1) = {"
a
a
a
a
a
Q
"}
(14,1,1) = {"
a
a
a
a
a
Q
"}
(15,1,1) = {"
a
a
a
a
a
Q
"}
(16,1,1) = {"
a
a
a
a
a
Q
"}
(17,1,1) = {"
a
a
a
a
a
Q
"}
(18,1,1) = {"
a
a
a
a
a
Q
"}
