//MAP CONVERTED BY dmm2tgm.py THIS HEADER COMMENT PREVENTS RECONVERSION, DO NOT REMOVE
"a" = (
/turf/template_noop,
/area/template_noop)
"k" = (
/obj/effect/landmark/ert_spawns/umbilical,
/obj/effect/decal/warning_stripes{
	icon_state = "W";
	dir = 1
	},
/turf/open/floor/plating/almayer,
/area/shuttle/ert)
"l" = (
/obj/structure/machinery/door/poddoor/almayer/locked{
	name = "\improper Umbillical Airlock"
	},
/turf/open/floor/almayer/plate,
/area/shuttle/ert)
"m" = (
/obj/effect/landmark/ert_spawns/umbilical,
/turf/open/floor/almayer/plate,
/area/shuttle/ert)
"r" = (
/obj/effect/decal/warning_stripes{
	icon_state = "W";
	dir = 1
	},
/turf/open/floor/plating/almayer,
/area/shuttle/ert)
"s" = (
/obj/effect/decal/warning_stripes{
	icon_state = "E";
	pixel_x = 1
	},
/obj/structure/machinery/door/poddoor/almayer/locked{
	name = "\improper Umbillical Airlock"
	},
/turf/open/floor/plating/almayer,
/area/shuttle/ert)
"y" = (
/obj/effect/decal/warning_stripes{
	icon_state = "E";
	pixel_x = 1
	},
/obj/effect/landmark/ert_spawns/umbilical,
/turf/open/floor/plating/almayer,
/area/shuttle/ert)
"A" = (
/obj/docking_port/mobile/starboard_umbilical_cord{
	dir = 4
	},
/turf/closed/wall/almayer/white,
/area/shuttle/ert)
"H" = (
/obj/effect/decal/warning_stripes{
	icon_state = "E";
	pixel_x = 1
	},
/turf/open/floor/plating/almayer,
/area/shuttle/ert)
"M" = (
/turf/open/floor/almayer/plate,
/area/shuttle/ert)
"N" = (
/obj/effect/landmark/ert_spawns/umbilical,
/obj/effect/decal/warning_stripes{
	icon_state = "E";
	pixel_x = 1
	},
/turf/open/floor/plating/almayer,
/area/shuttle/ert)
"P" = (
/obj/effect/decal/warning_stripes{
	icon_state = "W";
	dir = 1
	},
/obj/effect/landmark/ert_spawns/umbilical,
/turf/open/floor/plating/almayer,
/area/shuttle/ert)
"Q" = (
/turf/closed/wall/almayer/white,
/area/shuttle/ert)
"Z" = (
/obj/effect/decal/warning_stripes{
	icon_state = "W";
	dir = 1
	},
/obj/structure/machinery/door/poddoor/almayer/locked{
	name = "\improper Umbillical Airlock"
	},
/turf/open/floor/plating/almayer,
/area/shuttle/ert)

(1,1,1) = {"
Q
a
a
a
a
a
"}
(2,1,1) = {"
Q
a
a
a
a
a
"}
(3,1,1) = {"
Q
a
a
a
a
a
"}
(4,1,1) = {"
Q
a
a
a
a
a
"}
(5,1,1) = {"
Q
a
a
a
a
a
"}
(6,1,1) = {"
A
a
a
a
a
a
"}
(7,1,1) = {"
Q
Q
Q
Q
Q
Q
"}
(8,1,1) = {"
l
m
M
m
M
M
"}
(9,1,1) = {"
Z
r
r
P
r
k
"}
(10,1,1) = {"
s
y
H
H
N
H
"}
(11,1,1) = {"
l
m
m
M
m
m
"}
(12,1,1) = {"
Q
Q
Q
Q
Q
Q
"}
(13,1,1) = {"
Q
a
a
a
a
a
"}
(14,1,1) = {"
Q
a
a
a
a
a
"}
(15,1,1) = {"
Q
a
a
a
a
a
"}
(16,1,1) = {"
Q
a
a
a
a
a
"}
(17,1,1) = {"
Q
a
a
a
a
a
"}
(18,1,1) = {"
Q
a
a
a
a
a
"}
