"a" = (/obj/item/stack/sheet/wood,/obj/item/shard{icon_state = "medium"},/turf/open/floor/wood/wood_broken7,/area/template_noop)
"b" = (/obj/structure/window/framed/wood,/turf/open/auto_turf/sand_white/layer1,/area/template_noop)
"i" = (/turf/open/floor/plating/wood_broken6,/area/template_noop)
"k" = (/turf/closed/wall/wood,/area/template_noop)
"n" = (/obj/structure/surface/table/woodentable/poor,/turf/open/floor/plating/wood,/area/template_noop)
"p" = (/turf/open/floor/plating/wood_broken3,/area/template_noop)
"v" = (/turf/open/floor/plating/wood_broken2,/area/template_noop)
"A" = (/obj/item/shard{icon_state = "large"; pixel_x = -5; pixel_y = -6},/turf/open/floor/wood/wood_broken6,/area/template_noop)
"B" = (/obj/structure/bed/chair/wood/normal{dir = 4; pixel_y = 4; pixel_x = 2},/turf/open/floor/plating/wood,/area/template_noop)
"F" = (/obj/structure/prop/wooden_cross{pixel_y = 7},/turf/closed/wall/wood,/area/template_noop)
"H" = (/turf/open/floor/plating/wood,/area/template_noop)
"N" = (/obj/item/stack/sheet/wood,/turf/open/floor/plating/wood_broken2,/area/template_noop)
"S" = (/turf/template_noop,/area/template_noop)
"Z" = (/obj/structure/window_frame/wood,/turf/open/auto_turf/sand_white/layer1,/area/template_noop)

(1,1,1) = {"
kbZFk
kaAHk
kBnpv
kiHNk
SSSSS
"}
