//MAP CONVERTED BY dmm2tgm.py THIS HEADER COMMENT PREVENTS RECONVERSION, DO NOT REMOVE
"aa" = (
/obj/item/trash/c_tube,
/obj/effect/decal/cleanable/dirt,
/turf/open/floor/cmo,
/area/varadero/interior/library/restaraunt)
"ac" = (
/obj/structure/prop/hybrisa/misc/machinery/screens/redalert{
	light_range = 5;
	light_power = 3;
	light_color = "#FF0000";
	light_on = 1
	},
/turf/closed/wall/r_wall/unmeltable,
/area/varadero/interior/library/restaraunt)
"ad" = (
/obj/structure/window/framed/colony,
/obj/structure/pipes/standard/simple/hidden/green,
/turf/open/floor/plating/icefloor/asteroidplating,
/area/varadero/interior/library/restaraunt)
"ae" = (
/turf/open/floor/shiva/floor3,
/area/varadero/interior/library/restaraunt)
"af" = (
/obj/structure/sign/safety/galley,
/turf/closed/wall,
/area/varadero/interior/library/restaraunt)
"ag" = (
/obj/structure/window/framed/colony,
/obj/structure/machinery/door/poddoor/hybrisa/open_shutters{
	dir = 8
	},
/turf/open/floor/plating/icefloor/asteroidplating,
/area/varadero/interior/library/restaraunt)
"ah" = (
/obj/structure/pipes/standard/simple/hidden/green,
/turf/open/floor/cmo,
/area/varadero/interior/library/restaraunt)
"ai" = (
/obj/structure/catwalk{
	explo_proof = 1
	},
/obj/effect/decal/cleanable/dirt,
/turf/open/floor/plating/icefloor/asteroidplating,
/area/template_noop)
"aj" = (
/obj/structure/barricade/handrail/wire{
	dir = 4;
	layer = 4
	},
/obj/structure/catwalk{
	explo_proof = 1
	},
/obj/structure/closet/bodybag{
	icon_state = "bodybag_open";
	opened = 1
	},
/turf/open/floor/plating/icefloor/asteroidplating,
/area/template_noop)
"ak" = (
/obj/effect/decal/cleanable/dirt,
/obj/structure/pipes/standard/simple/hidden/green,
/turf/open/floor/cmo,
/area/varadero/interior/library/restaraunt)
"al" = (
/obj/effect/decal/cleanable/blood/splatter,
/turf/open/floor/wood,
/area/varadero/interior/library/restaraunt)
"am" = (
/obj/structure/bed/chair{
	icon_state = "chair_alt";
	dir = 4
	},
/obj/effect/decal/cleanable/dirt,
/turf/open/floor/asteroidwarning/east,
/area/template_noop)
"an" = (
/obj/structure/barricade/handrail/wire{
	dir = 4;
	layer = 4
	},
/obj/structure/catwalk{
	explo_proof = 1
	},
/obj/structure/closet/bodybag,
/turf/open/floor/plating/icefloor/asteroidplating,
/area/template_noop)
"ao" = (
/obj/effect/landmark/corpsespawner/new_varadero/lacn_police,
/obj/effect/decal/cleanable/blood,
/obj/effect/decal/cleanable/dirt,
/turf/open/floor/wood,
/area/varadero/interior/library/restaraunt)
"ap" = (
/obj/structure/barricade/handrail/wire{
	dir = 4;
	layer = 4
	},
/obj/structure/catwalk{
	explo_proof = 1
	},
/obj/effect/decal/cleanable/dirt,
/turf/open/floor/plating/icefloor/asteroidplating,
/area/template_noop)
"aq" = (
/obj/effect/landmark/crap_item,
/obj/structure/surface/table/woodentable/fancy,
/obj/item/trash/candle{
	pixel_y = 7
	},
/obj/effect/decal/cleanable/dirt,
/turf/open/floor/wood,
/area/varadero/interior/library/restaraunt)
"ar" = (
/obj/structure/bed/chair{
	dir = 2
	},
/obj/effect/decal/cleanable/dirt,
/turf/open/floor/asteroidwarning/east,
/area/template_noop)
"as" = (
/obj/structure/barricade/handrail/wire{
	dir = 4;
	layer = 4
	},
/obj/structure/catwalk{
	explo_proof = 1
	},
/obj/structure/machinery/portable_atmospherics/canister/empty,
/obj/effect/decal/cleanable/dirt,
/turf/open/floor/plating/icefloor/asteroidplating,
/area/template_noop)
"at" = (
/obj/effect/decal/warning_stripes/asteroid{
	icon_state = "warning_s";
	dir = 8
	},
/turf/open/floor/cmo,
/area/varadero/interior/library/restaraunt)
"au" = (
/obj/structure/sign/safety/ammunition{
	pixel_x = 14;
	pixel_y = 5
	},
/obj/structure/sign/safety/hazard{
	pixel_x = 0;
	pixel_y = 5
	},
/obj/structure/sign/safety/fire_haz{
	pixel_x = 0;
	pixel_y = -9
	},
/turf/closed/wall,
/area/template_noop)
"av" = (
/obj/effect/decal/cleanable/dirt,
/turf/open/floor/cmo,
/area/varadero/interior/library/restaraunt)
"aw" = (
/obj/effect/landmark/crap_item,
/obj/item/weapon/broken_glass{
	pixel_x = -25;
	pixel_y = -4
	},
/turf/open/floor/wood,
/area/varadero/interior/library/restaraunt)
"ax" = (
/obj/structure/closet/secure_closet/guncabinet{
	locked = 0;
	opened = 1
	},
/obj/item/weapon/gun/rifle/l42a/abr40/tactical,
/obj/item/ammo_magazine/rifle/l42a/abr40,
/obj/structure/catwalk{
	explo_proof = 1
	},
/turf/open/floor/plating/icefloor/asteroidplating,
/area/template_noop)
"ay" = (
/turf/open/floor/asteroidwarning/west,
/area/template_noop)
"az" = (
/obj/structure/fence/slim,
/turf/open/floor/asteroidfloor/north,
/area/template_noop)
"aA" = (
/obj/structure/closet/secure_closet/guncabinet{
	locked = 0;
	opened = 1
	},
/obj/structure/catwalk{
	explo_proof = 1
	},
/turf/open/floor/plating/icefloor/asteroidplating,
/area/template_noop)
"aB" = (
/obj/effect/decal/cleanable/dirt,
/turf/open/floor/asteroidwarning/west,
/area/template_noop)
"aC" = (
/obj/structure/closet/secure_closet/guncabinet{
	locked = 0;
	opened = 1
	},
/obj/structure/catwalk{
	explo_proof = 1
	},
/obj/effect/decal/cleanable/dirt,
/obj/effect/decal/cleanable/dirt,
/turf/open/floor/plating/icefloor/asteroidplating,
/area/template_noop)
"aD" = (
/obj/structure/window/framed/colony,
/obj/structure/machinery/door/poddoor/hybrisa/open_shutters,
/turf/open/floor/plating/icefloor/asteroidplating,
/area/varadero/interior/library/restaraunt)
"aE" = (
/obj/structure/fence/slim/door,
/turf/open/floor/asteroidfloor/north,
/area/template_noop)
"bl" = (
/obj/structure/surface/table/reinforced,
/obj/structure/machinery/door/window/eastright,
/obj/item/trash/waffles{
	name = "empty plate";
	pixel_y = -3
	},
/obj/item/trash/waffles{
	name = "empty plate";
	pixel_y = -1
	},
/obj/item/trash/waffles{
	name = "empty plate";
	pixel_y = 1
	},
/obj/effect/decal/cleanable/dirt,
/turf/open/floor/cmo,
/area/varadero/interior/library/restaraunt)
"cl" = (
/obj/structure/bed/chair/wood/wings{
	dir = 8;
	pixel_x = -9;
	pixel_y = 3
	},
/turf/open/floor/wood,
/area/varadero/interior/library/restaraunt)
"co" = (
/obj/structure/sink/kitchen{
	pixel_y = 22
	},
/turf/open/floor/cmo,
/area/varadero/interior/library/restaraunt)
"cy" = (
/obj/structure/machinery/door/window,
/obj/structure/machinery/vending/dinnerware,
/obj/effect/decal/cleanable/dirt,
/turf/open/floor/cmo,
/area/varadero/interior/library/restaraunt)
"dl" = (
/obj/structure/sign/safety/water,
/turf/closed/wall,
/area/varadero/interior/library/restaraunt)
"dt" = (
/obj/structure/bed/chair/wood/wings{
	dir = 8;
	pixel_x = -9;
	pixel_y = 3
	},
/obj/structure/machinery/power/apc/no_power/east,
/turf/open/floor/plating/wood_broken5,
/area/varadero/interior/library/restaraunt)
"eR" = (
/obj/effect/landmark/survivor_spawner,
/obj/effect/decal/cleanable/dirt,
/turf/open/floor/cmo,
/area/varadero/interior/library/restaraunt)
"fX" = (
/obj/structure/surface/table/reinforced,
/obj/item/reagent_container/food/condiment/hotsauce/franks{
	pixel_x = -2;
	pixel_y = 12
	},
/obj/item/reagent_container/food/condiment/coldsauce{
	pixel_x = 9;
	pixel_y = 14
	},
/obj/item/reagent_container/food/condiment/saltshaker{
	pixel_x = -4;
	pixel_y = -2
	},
/obj/item/reagent_container/food/condiment/peppermill{
	pixel_x = 6
	},
/obj/item/shard,
/obj/item/stack/rods{
	pixel_x = 7
	},
/turf/open/floor/cmo,
/area/varadero/interior/library/restaraunt)
"ga" = (
/obj/effect/decal/cleanable/blood/drip,
/obj/effect/decal/cleanable/dirt,
/turf/open/floor/wood,
/area/varadero/interior/library/restaraunt)
"gq" = (
/obj/structure/bed/chair/wood/wings{
	dir = 4;
	pixel_x = 9
	},
/obj/effect/decal/cleanable/dirt,
/turf/open/floor/wood,
/area/varadero/interior/library/restaraunt)
"ha" = (
/turf/closed/wall,
/area/varadero/interior/library/restaraunt)
"ia" = (
/obj/structure/machinery/light/small,
/obj/effect/decal/cleanable/dirt,
/turf/open/floor/wood,
/area/varadero/interior/library/restaraunt)
"ix" = (
/obj/structure/surface/table/reinforced,
/obj/item/trash/snack_bowl{
	pixel_x = -2;
	pixel_y = 2
	},
/obj/structure/machinery/door/window/eastleft,
/turf/open/floor/cmo,
/area/varadero/interior/library/restaraunt)
"kZ" = (
/obj/structure/machinery/door/airlock/almayer/medical/glass{
	name = "\improper Underground Armoury";
	dir = 1;
	req_access = null;
	req_one_access = null
	},
/turf/open/floor/asteroidfloor/north,
/area/template_noop)
"lK" = (
/obj/structure/closet/secure_closet/freezer/fridge/groceries,
/obj/effect/decal/cleanable/dirt,
/turf/open/floor/cmo,
/area/varadero/interior/library/restaraunt)
"lY" = (
/obj/effect/decal/cleanable/dirt,
/obj/structure/pipes/standard/manifold/hidden/green{
	dir = 1
	},
/turf/open/floor/cmo,
/area/varadero/interior/library/restaraunt)
"mv" = (
/obj/structure/machinery/light{
	dir = 4
	},
/turf/open/floor/wood,
/area/varadero/interior/library/restaraunt)
"ol" = (
/mob/living/simple_animal/small/mouse,
/obj/effect/decal/cleanable/dirt,
/turf/open/floor/cmo,
/area/varadero/interior/library/restaraunt)
"oW" = (
/obj/item/tool/screwdriver{
	pixel_x = -5;
	pixel_y = 5
	},
/obj/item/tool/wirecutters{
	pixel_y = -8
	},
/obj/effect/decal/cleanable/blood/oil/streak,
/turf/open/floor/cmo,
/area/varadero/interior/library/restaraunt)
"oX" = (
/turf/open/floor/cmo,
/area/varadero/interior/library/restaraunt)
"pO" = (
/obj/structure/surface/table/almayer,
/obj/structure/machinery/chem_dispenser/soda,
/obj/effect/decal/warning_stripes/asteroid{
	icon_state = "warning_c";
	dir = 4
	},
/turf/open/floor/cmo,
/area/varadero/interior/library/restaraunt)
"re" = (
/turf/closed/wall,
/area/template_noop)
"sP" = (
/obj/structure/pipes/vents/pump{
	dir = 4
	},
/obj/effect/decal/cleanable/dirt,
/turf/open/floor/cmo,
/area/varadero/interior/library/restaraunt)
"un" = (
/obj/structure/window/framed/colony,
/turf/open/floor/plating/icefloor/asteroidplating,
/area/varadero/interior/library/restaraunt)
"uH" = (
/obj/effect/decal/cleanable/blood/xeno,
/obj/item/weapon/shield/riot{
	pixel_x = 17;
	pixel_y = -8
	},
/obj/effect/decal/cleanable/dirt,
/turf/open/floor/wood,
/area/varadero/interior/library/restaraunt)
"vt" = (
/obj/structure/bed/chair{
	icon_state = "chair_alt";
	dir = 4
	},
/obj/structure/machinery/power/apc/no_power/west,
/turf/open/floor/asteroidwarning/east,
/area/template_noop)
"vS" = (
/obj/structure/machinery/storm_siren{
	pixel_x = -7;
	pixel_y = 9
	},
/obj/structure/machinery/light/small{
	dir = 1;
	pixel_x = 5
	},
/obj/effect/decal/cleanable/dirt,
/turf/open/floor/wood,
/area/varadero/interior/library/restaraunt)
"vX" = (
/obj/structure/surface/table/reinforced,
/obj/item/trash/snack_bowl{
	pixel_x = 5;
	pixel_y = -4
	},
/obj/item/shard,
/obj/item/trash/waffles{
	name = "empty plate";
	pixel_x = -2;
	pixel_y = 9
	},
/obj/effect/decal/cleanable/dirt,
/obj/structure/pipes/standard/simple/hidden/green{
	dir = 4
	},
/turf/open/floor/cmo,
/area/varadero/interior/library/restaraunt)
"xI" = (
/obj/structure/bed/chair/wood/wings{
	dir = 4;
	pixel_x = 8;
	pixel_y = 4
	},
/turf/open/floor/wood,
/area/varadero/interior/library/restaraunt)
"yT" = (
/obj/effect/decal/cleanable/dirt,
/turf/open/floor/wood,
/area/varadero/interior/library/restaraunt)
"zi" = (
/obj/structure/bed/chair/wood/wings{
	dir = 8;
	pixel_x = -9;
	pixel_y = 3
	},
/obj/structure/pipes/vents/pump{
	dir = 8
	},
/obj/structure/machinery/alarm{
	dir = 8;
	pixel_x = 24
	},
/turf/open/floor/wood/wood_broken2,
/area/varadero/interior/library/restaraunt)
"zv" = (
/obj/effect/decal/cleanable/blood/drip,
/obj/item/shard,
/obj/item/stack/rods{
	pixel_x = 7;
	pixel_y = 7
	},
/obj/item/circuitboard/airlock{
	pixel_y = 6
	},
/obj/effect/decal/cleanable/dirt,
/turf/open/floor/cmo,
/area/varadero/interior/library/restaraunt)
"Ag" = (
/obj/effect/decal/cleanable/blood/xeno,
/turf/open/floor/wood,
/area/varadero/interior/library/restaraunt)
"AG" = (
/obj/structure/surface/table/woodentable/fancy,
/obj/item/device/flashlight/lamp/green{
	pixel_y = -2
	},
/turf/open/floor/wood,
/area/varadero/interior/library/restaraunt)
"AP" = (
/obj/structure/surface/table/almayer,
/obj/structure/machinery/processor{
	pixel_x = -2;
	pixel_y = 4
	},
/obj/structure/machinery/light,
/turf/open/floor/cmo,
/area/varadero/interior/library/restaraunt)
"BJ" = (
/obj/effect/decal/cleanable/dirt,
/turf/open/floor/wood/wood_broken,
/area/varadero/interior/library/restaraunt)
"BL" = (
/obj/structure/surface/table/woodentable/fancy,
/obj/item/tool/kitchen/utensil/pfork{
	pixel_x = -9;
	pixel_y = 5
	},
/obj/item/reagent_container/food/snacks/meatballsoup,
/obj/item/tool/kitchen/utensil/pspoon{
	pixel_x = 8;
	pixel_y = 5
	},
/obj/effect/decal/cleanable/dirt,
/turf/open/floor/wood,
/area/varadero/interior/library/restaraunt)
"Ct" = (
/obj/structure/machinery/microwave{
	name = "oven";
	pixel_x = 1;
	pixel_y = 3
	},
/obj/structure/surface/table/almayer,
/obj/structure/machinery/light{
	dir = 1
	},
/turf/open/floor/cmo,
/area/varadero/interior/library/restaraunt)
"FB" = (
/obj/effect/decal/cleanable/blood/splatter,
/obj/effect/decal/cleanable/dirt,
/turf/open/floor/plating/wood_broken6,
/area/varadero/interior/library/restaraunt)
"Hb" = (
/obj/structure/closet/secure_closet/fridge/fish,
/obj/effect/decal/cleanable/blood/oil,
/obj/effect/decal/cleanable/dirt,
/turf/open/floor/cmo,
/area/varadero/interior/library/restaraunt)
"Hl" = (
/obj/structure/pipes/standard/simple/hidden/green{
	dir = 4
	},
/obj/effect/decal/cleanable/blood/drip,
/obj/structure/surface/table/woodentable/fancy,
/obj/effect/landmark/objective_landmark/close,
/obj/item/device/flashlight/lamp/green{
	pixel_x = 5;
	pixel_y = 3
	},
/obj/item/trash/candle{
	pixel_x = 2;
	pixel_y = -5
	},
/turf/open/floor/wood,
/area/varadero/interior/library/restaraunt)
"Hy" = (
/obj/structure/machinery/door/airlock/multi_tile/almayer/generic{
	name = "\improper New Varadero Gallery"
	},
/turf/open/floor/shiva/floor3,
/area/varadero/interior/library/restaraunt)
"Io" = (
/obj/item/tool/kitchen/knife{
	pixel_x = -7
	},
/obj/item/tool/kitchen/knife/butcher,
/obj/structure/surface/table/almayer,
/turf/open/floor/cmo,
/area/varadero/interior/library/restaraunt)
"Ix" = (
/obj/structure/surface/table,
/obj/item/book/manual/paperwork,
/obj/effect/decal/cleanable/dirt,
/turf/open/floor/asteroidwarning/east,
/area/template_noop)
"JM" = (
/obj/structure/bed/chair/wood/wings{
	dir = 4;
	pixel_x = 7
	},
/obj/effect/decal/cleanable/dirt,
/obj/structure/pipes/standard/simple/hidden/green{
	dir = 4
	},
/turf/open/floor/wood,
/area/varadero/interior/library/restaraunt)
"Kt" = (
/obj/structure/surface/table/reinforced,
/obj/structure/machinery/door/window/eastright,
/obj/item/trash/waffles{
	name = "empty plate";
	pixel_y = -3
	},
/obj/item/trash/waffles{
	name = "empty plate";
	pixel_x = 3;
	pixel_y = 9
	},
/obj/effect/decal/cleanable/dirt,
/turf/open/floor/cmo,
/area/varadero/interior/library/restaraunt)
"Nf" = (
/obj/structure/sign/safety/airlock{
	pixel_x = 8
	},
/turf/closed/wall/r_wall/unmeltable,
/area/varadero/interior/library/restaraunt)
"Ni" = (
/obj/structure/pipes/standard/simple/hidden/green{
	dir = 4
	},
/obj/structure/barricade/handrail{
	dir = 4
	},
/turf/open/floor/wood,
/area/varadero/interior/library/restaraunt)
"No" = (
/obj/structure/sign/safety/water{
	pixel_x = 15
	},
/turf/closed/wall,
/area/template_noop)
"Ol" = (
/obj/structure/machinery/door/window/eastright,
/obj/effect/decal/cleanable/dirt,
/turf/open/floor/cmo,
/area/varadero/interior/library/restaraunt)
"Pp" = (
/obj/structure/machinery/firealarm{
	dir = 1;
	pixel_y = -24
	},
/obj/effect/decal/cleanable/blood/drip,
/obj/structure/machinery/light/small{
	pixel_x = 5
	},
/obj/effect/decal/cleanable/dirt,
/turf/open/floor/wood,
/area/varadero/interior/library/restaraunt)
"Rf" = (
/obj/structure/bed/chair/wood/wings{
	dir = 4;
	pixel_x = 8;
	pixel_y = 2
	},
/turf/open/floor/wood,
/area/varadero/interior/library/restaraunt)
"TE" = (
/obj/structure/bed/chair/wood/wings{
	dir = 8;
	pixel_x = -8;
	pixel_y = 1
	},
/obj/structure/machinery/light/small{
	dir = 1
	},
/obj/effect/decal/cleanable/dirt,
/turf/open/floor/wood,
/area/varadero/interior/library/restaraunt)
"TN" = (
/obj/structure/barricade/handrail{
	dir = 4
	},
/obj/effect/decal/cleanable/dirt,
/turf/open/floor/wood,
/area/varadero/interior/library/restaraunt)
"Uk" = (
/obj/structure/catwalk{
	explo_proof = 1
	},
/turf/open/floor/plating/icefloor/asteroidplating,
/area/template_noop)
"Vs" = (
/obj/item/tool/kitchen/tray{
	pixel_y = 25
	},
/obj/item/tool/kitchen/rollingpin{
	pixel_x = 4
	},
/obj/structure/surface/table/almayer,
/obj/item/tool/kitchen/can_opener,
/obj/effect/decal/warning_stripes/asteroid{
	icon_state = "warning_c";
	dir = 1
	},
/turf/open/floor/cmo,
/area/varadero/interior/library/restaraunt)
"WR" = (
/obj/structure/sign/calendar{
	pixel_y = 29
	},
/obj/item/shard,
/turf/open/floor/cmo,
/area/varadero/interior/library/restaraunt)
"Xx" = (
/obj/structure/machinery/door/airlock/almayer/maint{
	name = "\improper New Varadero Kitchen";
	req_one_access = null;
	req_access_txt = "100"
	},
/turf/open/floor/plating/icefloor/asteroidplating,
/area/varadero/interior/library/restaraunt)
"ZE" = (
/obj/effect/spawner/random/toy,
/obj/effect/decal/cleanable/blood/splatter,
/obj/item/weapon/twohanded/fireaxe{
	pixel_x = -9;
	pixel_y = -16
	},
/turf/open/floor/wood,
/area/varadero/interior/library/restaraunt)

(1,1,1) = {"
ha
ag
ag
ha
Xx
dl
ag
ha
ag
Nf
"}
(2,1,1) = {"
ha
Ct
Io
Vs
at
pO
Hb
lK
AP
ac
"}
(3,1,1) = {"
ha
co
av
aa
sP
eR
oW
ol
oX
un
"}
(4,1,1) = {"
ha
WR
oX
av
lY
ak
ak
ak
ah
ad
"}
(5,1,1) = {"
ha
fX
ix
Kt
vX
bl
cy
zv
Ol
ha
"}
(6,1,1) = {"
ha
vS
TN
TN
Ni
TN
ga
ga
Pp
ha
"}
(7,1,1) = {"
aD
gq
Rf
BJ
JM
xI
Ag
ZE
yT
Hy
"}
(8,1,1) = {"
aD
BL
AG
aw
Hl
aq
ao
uH
yT
ae
"}
(9,1,1) = {"
ha
TE
cl
mv
zi
dt
FB
al
ia
af
"}
(10,1,1) = {"
ha
ha
ha
ha
ha
ha
ha
ha
ha
ha
"}
(11,1,1) = {"
az
aC
aA
ax
au
ar
Ix
am
vt
re
"}
(12,1,1) = {"
aE
aB
aB
ay
kZ
ai
Uk
ai
ai
kZ
"}
(13,1,1) = {"
re
az
az
az
No
as
ap
an
aj
re
"}
