//MAP CONVERTED BY dmm2tgm.py THIS HEADER COMMENT PREVENTS RECONVERSION, DO NOT REMOVE
"a" = (
/obj/effect/decal/warning_stripes{
	icon_state = "S"
	},
/turf/open/floor/prison/floor_plate/southwest,
/area/template_noop)
"h" = (
/turf/open/floor/prison/floor_plate/southwest,
/area/template_noop)
"i" = (
/obj/effect/decal/warning_stripes{
	icon_state = "S"
	},
/obj/structure/largecrate/supply/floodlights,
/turf/open/floor/prison/floor_plate/southwest,
/area/template_noop)
"j" = (
/obj/structure/powerloader_wreckage,
/turf/open/floor/prison/floor_plate/southwest,
/area/template_noop)
"u" = (
/obj/effect/decal/cleanable/blood/oil,
/turf/open/floor/prison/floor_plate/southwest,
/area/template_noop)
"x" = (
/obj/effect/decal/cleanable/dirt,
/turf/open/floor/prison/floor_plate/southwest,
/area/template_noop)
"D" = (
/turf/template_noop,
/area/template_noop)
"F" = (
/obj/effect/decal/warning_stripes{
	icon_state = "S"
	},
/obj/effect/decal/cleanable/blood/oil,
/turf/open/floor/prison/cell_stripe/east,
/area/template_noop)
"K" = (
/obj/effect/decal/warning_stripes{
	icon_state = "S"
	},
/turf/open/floor/prison/cell_stripe/west,
/area/template_noop)
"L" = (
/obj/structure/largecrate/random/case/small,
/turf/open/floor/prison/floor_plate/southwest,
/area/template_noop)
"O" = (
/turf/open/floor/prison/cell_stripe/east,
/area/template_noop)
"R" = (
/obj/item/fuel_cell{
	fuel_amount = 0;
	icon_state = "cell-empty";
	pixel_x = 7
	},
/obj/item/fuel_cell{
	fuel_amount = 0;
	icon_state = "cell-empty";
	pixel_x = -7;
	pixel_y = 3
	},
/turf/template_noop,
/area/template_noop)
"V" = (
/obj/effect/decal/cleanable/dirt,
/turf/template_noop,
/area/template_noop)
"Y" = (
/turf/open/floor/prison/cell_stripe/west,
/area/template_noop)
"Z" = (
/obj/structure/largecrate/random/barrel,
/turf/template_noop,
/area/template_noop)

(1,1,1) = {"
h
h
x
h
h
j
h
h
h
h
h
x
h
h
h
h
h
a
"}
(2,1,1) = {"
h
h
h
h
h
h
h
h
h
h
h
h
h
h
h
x
h
a
"}
(3,1,1) = {"
h
h
h
h
h
h
h
h
h
h
h
h
h
h
h
h
h
a
"}
(4,1,1) = {"
h
h
Y
h
h
Y
h
h
Y
h
h
Y
h
h
Y
h
h
K
"}
(5,1,1) = {"
h
h
h
h
h
h
h
h
h
h
h
h
h
h
h
h
h
i
"}
(6,1,1) = {"
h
x
O
h
h
O
h
h
O
h
h
O
h
h
O
h
h
F
"}
(7,1,1) = {"
h
h
h
h
h
h
h
h
h
h
h
h
h
h
h
h
h
a
"}
(8,1,1) = {"
h
h
h
h
h
h
h
h
h
h
h
x
h
h
h
h
h
a
"}
(9,1,1) = {"
u
h
h
h
h
h
h
h
x
h
L
u
h
h
h
h
h
a
"}
(10,1,1) = {"
V
D
D
D
R
Z
D
D
D
D
D
D
D
D
D
D
D
D
"}
