//MAP CONVERTED BY dmm2tgm.py THIS HEADER COMMENT PREVENTS RECONVERSION, DO NOT REMOVE
"aa" = (
/obj/structure/blocker/forcefield/multitile_vehicles,
/turf/open/asphalt/tile,
/area/desert_dam/exterior/valley/valley_bridge)
"af" = (
/turf/open/asphalt/cement_sunbleached/cement_sunbleached3,
/area/desert_dam/exterior/valley/valley_bridge)
"ag" = (
/turf/open/asphalt/cement_sunbleached/cement_sunbleached1,
/area/desert_dam/exterior/valley/valley_bridge)
"ah" = (
/obj/effect/decal/sand_overlay/sand1{
	dir = 8
	},
/turf/open/asphalt/tile,
/area/desert_dam/exterior/valley/valley_bridge)
"ai" = (
/turf/open/desert/dirt,
/area/desert_dam/exterior/valley/valley_bridge)
"aj" = (
/turf/closed/wall/rock/orange,
/area/desert_dam/exterior/rock)
"ao" = (
/obj/structure/blocker/forcefield/multitile_vehicles,
/turf/open/asphalt/cement_sunbleached/cement_sunbleached3,
/area/desert_dam/exterior/valley/valley_bridge)
"ap" = (
/obj/structure/blocker/forcefield/multitile_vehicles,
/turf/open/asphalt/cement_sunbleached/cement_sunbleached1,
/area/desert_dam/exterior/valley/valley_bridge)
"aq" = (
/obj/effect/decal/sand_overlay/sand1/corner1{
	dir = 4
	},
/obj/structure/blocker/forcefield/multitile_vehicles,
/turf/open/asphalt/tile,
/area/desert_dam/exterior/valley/valley_bridge)
"ar" = (
/obj/effect/decal/sand_overlay/sand1{
	dir = 1
	},
/obj/structure/blocker/forcefield/multitile_vehicles,
/turf/open/asphalt/tile,
/area/desert_dam/exterior/valley/valley_bridge)
"as" = (
/obj/effect/decal/sand_overlay/sand1/corner1{
	dir = 1
	},
/obj/structure/blocker/forcefield/multitile_vehicles,
/turf/open/asphalt/tile,
/area/desert_dam/exterior/valley/valley_bridge)
"aI" = (
/obj/structure/platform/metal/almayer/west,
/turf/template_noop,
/area/template_noop)
"aP" = (
/obj/structure/platform_decoration/metal/almayer,
/turf/template_noop,
/area/template_noop)
"aQ" = (
/obj/structure/platform/metal/almayer,
/obj/structure/platform/metal/almayer/east,
/turf/template_noop,
/area/template_noop)
"aR" = (
/obj/effect/blocker/water/toxic/Group_2,
/turf/open/asphalt/cement_sunbleached/cement_sunbleached3,
/area/template_noop)
"aS" = (
/obj/structure/platform/metal/almayer,
/obj/structure/platform/metal/almayer/west,
/turf/template_noop,
/area/template_noop)
"aT" = (
/obj/structure/platform/metal/almayer,
/turf/template_noop,
/area/template_noop)
"aV" = (
/turf/template_noop,
/area/template_noop)
"aX" = (
/obj/structure/platform/metal/almayer/east,
/turf/template_noop,
/area/template_noop)
"aY" = (
/turf/open/asphalt/tile,
/area/desert_dam/exterior/valley/valley_medical)
"aZ" = (
/turf/open/asphalt/cement_sunbleached/cement_sunbleached3,
/area/desert_dam/exterior/valley/valley_medical)
"ba" = (
/turf/open/asphalt/cement_sunbleached/cement_sunbleached1,
/area/desert_dam/exterior/valley/valley_medical)
"bb" = (
/obj/effect/decal/sand_overlay/sand1/corner1,
/turf/open/asphalt/tile,
/area/desert_dam/exterior/valley/valley_medical)
"bc" = (
/turf/open/desert/dirt/dirt2,
/area/desert_dam/exterior/river/riverside_east)
"bd" = (
/obj/structure/platform_decoration/metal/almayer/west,
/turf/open/desert/dirt/dirt2,
/area/desert_dam/exterior/river/riverside_east)
"be" = (
/obj/structure/stairs{
	dir = 4
	},
/obj/structure/platform/metal/stair_cut/platform_right,
/turf/open/asphalt/cement_sunbleached/cement_sunbleached2,
/area/desert_dam/exterior/valley/valley_medical)
"bf" = (
/turf/open/asphalt/cement_sunbleached,
/area/desert_dam/exterior/valley/valley_medical)
"bg" = (
/turf/open/asphalt/cement_sunbleached/cement_sunbleached4,
/area/desert_dam/exterior/valley/valley_medical)
"bh" = (
/obj/effect/decal/sand_overlay/sand1{
	dir = 8
	},
/turf/open/asphalt/cement_sunbleached/cement_sunbleached9,
/area/desert_dam/exterior/valley/valley_medical)
"bi" = (
/obj/structure/platform/metal/almayer,
/turf/open/desert/dirt/dirt2,
/area/desert_dam/exterior/river/riverside_east)
"bj" = (
/obj/structure/platform_decoration/metal/almayer/north,
/turf/open/desert/dirt/dirt2,
/area/desert_dam/exterior/river/riverside_east)
"bk" = (
/obj/structure/platform_decoration/metal/almayer,
/turf/open/desert/dirt/dirt2,
/area/desert_dam/exterior/river/riverside_east)
"bl" = (
/obj/structure/stairs{
	dir = 4
	},
/obj/structure/platform/metal/almayer,
/turf/open/asphalt/cement_sunbleached/cement_sunbleached14,
/area/desert_dam/exterior/valley/valley_medical)
"bm" = (
/turf/open/asphalt/cement_sunbleached/cement_sunbleached12,
/area/desert_dam/exterior/valley/valley_medical)
"bn" = (
/obj/effect/decal/sand_overlay/sand1{
	dir = 8
	},
/turf/open/asphalt/cement_sunbleached/cement_sunbleached1,
/area/desert_dam/exterior/valley/valley_medical)
"bo" = (
/obj/structure/stairs,
/obj/structure/platform/metal/almayer/west,
/turf/open/asphalt/cement_sunbleached/cement_sunbleached2,
/area/desert_dam/exterior/valley/valley_medical)
"bp" = (
/obj/structure/stairs,
/obj/structure/platform/metal/almayer/east,
/turf/open/asphalt/cement_sunbleached/cement_sunbleached9,
/area/desert_dam/exterior/valley/valley_medical)
"bq" = (
/obj/effect/blocker/water/toxic/Group_2,
/turf/open/asphalt/cement_sunbleached/cement_sunbleached1,
/area/template_noop)

(1,1,1) = {"
aa
aV
aV
aV
aV
aV
aV
aV
aV
aV
bc
bi
aY
"}
(2,1,1) = {"
aV
aV
aV
aV
aV
aV
aV
aV
aV
aV
bc
bi
aY
"}
(3,1,1) = {"
aV
aV
aV
aV
aV
aV
aV
aV
aV
aV
bc
bi
aY
"}
(4,1,1) = {"
aV
aV
aV
aV
aV
aV
aV
aV
aV
aV
bc
bi
aY
"}
(5,1,1) = {"
aV
aV
aV
aV
aV
aV
aV
aV
aV
aV
bc
bj
bo
"}
(6,1,1) = {"
aV
aV
aV
aV
aV
aV
aV
aV
aP
aX
bd
bk
bp
"}
(7,1,1) = {"
aa
aa
aX
aX
aX
aX
aX
aX
aQ
aY
be
bl
aY
"}
(8,1,1) = {"
af
ao
aR
aR
aR
aR
aR
aR
aR
aZ
bf
bm
aY
"}
(9,1,1) = {"
ag
ap
bq
bq
bq
bq
bq
bq
bq
ba
bf
bm
aY
"}
(10,1,1) = {"
ah
aq
aI
aI
aI
aI
aI
aI
aS
aY
bg
bm
aY
"}
(11,1,1) = {"
ai
ar
aV
aV
aV
aV
aV
aV
aT
aY
bg
bf
aZ
"}
(12,1,1) = {"
aj
as
aV
aV
aV
aV
aV
aV
aV
aY
bg
bf
bf
"}
(13,1,1) = {"
aj
aa
aV
aV
aV
aV
aV
aV
aV
aY
bg
bf
bf
"}
(14,1,1) = {"
aj
aa
aV
aV
aV
aV
aV
aV
aV
bb
bh
bn
bn
"}
