//MAP CONVERTED BY dmm2tgm.py THIS HEADER COMMENT PREVENTS RECONVERSION, DO NOT REMOVE
"a" = (
/obj/item/trash/raisins,
/turf/open/asphalt,
/area/desert_dam/exterior/valley/valley_labs)
"d" = (
/obj/structure/desertdam/decals/road_stop{
	dir = 8;
	icon_state = "stop_decal5"
	},
/turf/open/asphalt,
/area/desert_dam/exterior/valley/valley_labs)
"e" = (
/obj/effect/decal/cleanable/dirt,
/obj/effect/decal/cleanable/liquid_fuel,
/obj/structure/largecrate/random/barrel/green,
/turf/open/asphalt,
/area/desert_dam/exterior/valley/valley_labs)
"f" = (
/obj/structure/desertdam/decals/road_edge{
	icon_state = "road_edge_decal6"
	},
/obj/effect/decal/cleanable/blood{
	icon_state = "xgib1"
	},
/turf/open/asphalt,
/area/desert_dam/exterior/valley/valley_labs)
"g" = (
/obj/effect/decal/cleanable/blood/oil,
/turf/open/asphalt,
/area/desert_dam/exterior/valley/valley_labs)
"j" = (
/obj/effect/decal/cleanable/dirt,
/obj/item/trash/cigbutt/bcigbutt,
/turf/open/asphalt,
/area/desert_dam/exterior/valley/valley_labs)
"k" = (
/obj/effect/spawner/gibspawner/xeno,
/turf/open/asphalt,
/area/desert_dam/exterior/valley/valley_labs)
"m" = (
/obj/effect/decal/cleanable/dirt,
/obj/effect/decal/cleanable/dirt,
/turf/open/asphalt,
/area/desert_dam/exterior/valley/valley_labs)
"q" = (
/obj/structure/largecrate/random,
/turf/open/asphalt,
/area/desert_dam/exterior/valley/valley_labs)
"u" = (
/obj/effect/decal/cleanable/dirt,
/turf/open/asphalt,
/area/desert_dam/exterior/valley/valley_labs)
"v" = (
/obj/structure/desertdam/decals/road_edge{
	icon_state = "road_edge_decal7"
	},
/turf/open/asphalt,
/area/desert_dam/exterior/valley/valley_labs)
"w" = (
/turf/open/asphalt,
/area/desert_dam/exterior/valley/valley_labs)
"z" = (
/obj/structure/powerloader_wreckage,
/obj/effect/decal/cleanable/blood/oil,
/obj/effect/landmark/corpsespawner/colonist/random,
/turf/open/asphalt,
/area/desert_dam/exterior/valley/valley_labs)
"A" = (
/obj/effect/decal/cleanable/dirt,
/obj/effect/spawner/gibspawner/xeno,
/turf/open/asphalt,
/area/desert_dam/exterior/valley/valley_labs)
"B" = (
/obj/effect/decal/cleanable/blood{
	icon_state = "xgib1";
	pixel_x = 12;
	pixel_y = 16
	},
/turf/open/asphalt,
/area/desert_dam/exterior/valley/valley_labs)
"I" = (
/obj/structure/desertdam/decals/road_edge{
	icon_state = "road_edge_decal4"
	},
/obj/effect/decal/cleanable/dirt,
/obj/item/trash/popcorn,
/turf/open/asphalt,
/area/desert_dam/exterior/valley/valley_labs)
"M" = (
/obj/structure/desertdam/decals/road_edge{
	icon_state = "road_edge_decal4"
	},
/obj/item/trash/kepler,
/obj/effect/decal/cleanable/dirt,
/obj/item/trash/chunk,
/turf/open/asphalt,
/area/desert_dam/exterior/valley/valley_labs)
"N" = (
/obj/structure/desertdam/decals/road_edge{
	icon_state = "road_edge_decal4"
	},
/turf/open/asphalt,
/area/desert_dam/exterior/valley/valley_labs)
"P" = (
/obj/structure/desertdam/decals/road_edge{
	icon_state = "road_edge_decal4"
	},
/obj/effect/decal/cleanable/dirt,
/turf/open/asphalt,
/area/desert_dam/exterior/valley/valley_labs)
"Q" = (
/obj/item/trash/eat,
/turf/open/asphalt,
/area/desert_dam/exterior/valley/valley_labs)
"R" = (
/obj/structure/desertdam/decals/road_edge{
	icon_state = "road_edge_decal4"
	},
/obj/item/trash/hotdog,
/turf/open/asphalt,
/area/desert_dam/exterior/valley/valley_labs)
"S" = (
/obj/effect/decal/cleanable/blood,
/turf/open/asphalt,
/area/desert_dam/exterior/valley/valley_labs)
"V" = (
/obj/effect/decal/cleanable/dirt,
/obj/effect/decal/cleanable/dirt,
/obj/item/trash/barcardine,
/turf/open/asphalt,
/area/desert_dam/exterior/valley/valley_labs)
"X" = (
/obj/effect/decal/cleanable/blood{
	icon_state = "xgib3";
	pixel_x = 17
	},
/turf/open/asphalt,
/area/desert_dam/exterior/valley/valley_labs)
"Z" = (
/obj/structure/desertdam/decals/road_edge{
	icon_state = "road_edge_decal4"
	},
/obj/structure/largecrate/random/barrel/blue,
/turf/open/asphalt,
/area/desert_dam/exterior/valley/valley_labs)

(1,1,1) = {"
N
d
d
f
v
d
d
"}
(2,1,1) = {"
Z
u
w
A
w
B
k
"}
(3,1,1) = {"
R
S
z
w
w
u
w
"}
(4,1,1) = {"
P
V
m
w
A
w
w
"}
(5,1,1) = {"
M
j
e
g
w
X
w
"}
(6,1,1) = {"
I
u
a
u
q
w
Q
"}
