//MAP CONVERTED BY dmm2tgm.py THIS HEADER COMMENT PREVENTS RECONVERSION, DO NOT REMOVE
"an" = (
/obj/effect/decal/cleanable/dirt,
/obj/item/ammo_casing,
/obj/item/ammo_casing,
/obj/item/ammo_casing,
/turf/open/floor/prison/blue/west,
/area/desert_dam/building/administration/hallway)
"ay" = (
/obj/structure/disposalpipe/segment,
/obj/structure/pipes/standard/simple/hidden/green,
/obj/effect/decal/cleanable/dirt,
/obj/effect/decal/cleanable/blood/drip{
	pixel_x = 5;
	pixel_y = 5
	},
/turf/open/floor/prison/bright_clean2,
/area/desert_dam/building/administration/hallway)
"ct" = (
/obj/structure/flora/pottedplant{
	desc = "It is made of Fiberbush(tm). It contains asbestos. Studies say that greenery calms the mind due to some sort evolved mechanism in the brain. This plant is not calming.";
	icon_state = "pottedplant_21";
	layer = 3.1;
	name = "synthethic potted plant";
	pixel_y = 5
	},
/turf/open/floor/prison/bluecorner,
/area/desert_dam/building/administration/hallway)
"cD" = (
/obj/item/stack/sheet/wood,
/turf/open/floor/plating/platingdmg3,
/area/desert_dam/building/administration/hallway)
"dC" = (
/obj/item/trash/cigbutt,
/obj/item/trash/eat,
/turf/open/floor/prison/bright_clean2,
/area/desert_dam/building/administration/lobby)
"dE" = (
/obj/structure/disposalpipe/junction,
/obj/structure/pipes/standard/simple/hidden/green{
	dir = 10
	},
/turf/open/floor/prison/bright_clean2,
/area/desert_dam/building/administration/hallway)
"ef" = (
/obj/effect/decal/cleanable/blood{
	icon_state = "gib6"
	},
/obj/item/ammo_casing,
/obj/item/ammo_casing,
/obj/item/ammo_casing,
/turf/open/floor/prison/bright_clean2,
/area/desert_dam/building/administration/lobby)
"fS" = (
/turf/closed/wall/r_wall,
/area/desert_dam/building/administration/lobby)
"il" = (
/obj/effect/landmark/corpsespawner/security/liaison,
/obj/effect/decal/cleanable/blood{
	layer = 3
	},
/turf/open/floor/darkred2/north,
/area/desert_dam/building/administration/lobby)
"ir" = (
/obj/effect/decal/cleanable/dirt,
/obj/effect/decal/cleanable/dirt,
/obj/item/ammo_casing,
/obj/item/ammo_casing,
/turf/open/floor/plating,
/area/desert_dam/building/administration/hallway)
"iv" = (
/turf/open/floor/prison/bluecorner/north,
/area/desert_dam/building/administration/hallway)
"iz" = (
/obj/structure/surface/table/almayer,
/obj/item/folder/white,
/turf/open/floor/prison/blue/east,
/area/desert_dam/building/administration/hallway)
"iO" = (
/obj/structure/bed/chair{
	dir = 1
	},
/obj/effect/decal/hybrisa/trash{
	pixel_y = 22;
	pixel_x = 12
	},
/turf/open/floor/prison/blue,
/area/desert_dam/building/administration/hallway)
"jf" = (
/obj/effect/decal/cleanable/dirt,
/turf/open/floor/prison/bright_clean2,
/area/desert_dam/building/administration/hallway)
"ji" = (
/obj/structure/pipes/vents/pump{
	dir = 4
	},
/obj/effect/decal/cleanable/blood{
	layer = 3
	},
/turf/open/floor/prison/bright_clean2,
/area/desert_dam/building/administration/lobby)
"kK" = (
/obj/structure/disposalpipe/junction,
/obj/structure/pipes/standard/manifold/hidden/green,
/turf/open/floor/prison/bright_clean2,
/area/desert_dam/building/administration/hallway)
"lr" = (
/obj/effect/decal/cleanable/blood{
	layer = 3
	},
/turf/open/floor/darkred2/west,
/area/desert_dam/building/administration/lobby)
"lH" = (
/turf/closed/wall/r_wall,
/area/desert_dam/building/administration/hallway)
"mF" = (
/obj/effect/decal/cleanable/dirt,
/obj/item/ammo_casing,
/obj/item/ammo_casing,
/obj/item/ammo_casing,
/turf/open/floor/prison/bright_clean2,
/area/desert_dam/building/administration/hallway)
"mX" = (
/obj/structure/machinery/power/apc/no_power/west,
/obj/effect/decal/cleanable/blood,
/turf/open/floor/prison/blue/west,
/area/desert_dam/building/administration/hallway)
"nb" = (
/obj/structure/pipes/standard/simple/hidden/green{
	dir = 4
	},
/obj/structure/disposalpipe/segment{
	dir = 4
	},
/obj/effect/decal/cleanable/dirt,
/turf/open/floor/prison/bright_clean2,
/area/desert_dam/building/administration/hallway)
"nw" = (
/obj/structure/window/framed/colony/reinforced,
/turf/open/floor/plating,
/area/desert_dam/building/administration/hallway)
"nF" = (
/obj/effect/decal/cleanable/dirt,
/obj/item/ammo_casing,
/obj/effect/decal/cleanable/blood/drip{
	pixel_x = 2;
	pixel_y = 15
	},
/turf/open/floor/prison/bluecorner/west,
/area/desert_dam/building/administration/hallway)
"nP" = (
/obj/effect/decal/cleanable/dirt,
/obj/effect/decal/cleanable/blood,
/obj/item/ammo_magazine/smg/p90,
/turf/open/floor/prison/bright_clean2,
/area/desert_dam/building/administration/hallway)
"oO" = (
/obj/structure/surface/table/almayer,
/turf/open/floor/prison/blue/east,
/area/desert_dam/building/administration/hallway)
"rg" = (
/obj/structure/window_frame/colony/reinforced,
/obj/item/shard,
/turf/open/floor/plating,
/area/desert_dam/building/administration/hallway)
"rM" = (
/obj/effect/decal/cleanable/dirt,
/obj/effect/landmark/corpsespawner/wygoon,
/obj/effect/decal/cleanable/blood,
/turf/open/floor/prison/bright_clean2,
/area/desert_dam/building/administration/hallway)
"ti" = (
/obj/structure/filingcabinet{
	density = 0;
	pixel_x = -8;
	pixel_y = 20
	},
/obj/structure/filingcabinet{
	density = 0;
	pixel_x = 8;
	pixel_y = 20
	},
/obj/effect/landmark/objective_landmark/close,
/turf/open/floor/darkred2/north,
/area/desert_dam/building/administration/lobby)
"tp" = (
/obj/effect/decal/cleanable/dirt,
/obj/effect/decal/cleanable/dirt,
/obj/item/ammo_casing,
/obj/item/ammo_casing,
/obj/item/ammo_casing,
/obj/item/ammo_casing,
/obj/effect/decal/cleanable/blood/drip{
	pixel_x = 2;
	pixel_y = 15
	},
/turf/open/floor/prison/bright_clean2,
/area/desert_dam/building/administration/hallway)
"tD" = (
/obj/structure/disposalpipe/segment,
/obj/structure/pipes/standard/simple/hidden/green,
/obj/effect/decal/cleanable/dirt,
/obj/item/ammo_casing,
/obj/item/ammo_casing,
/obj/item/ammo_casing,
/obj/effect/decal/cleanable/blood/drip{
	pixel_x = 2;
	pixel_y = -6
	},
/turf/open/floor/prison/bright_clean2,
/area/desert_dam/building/administration/hallway)
"tK" = (
/obj/structure/bed/chair{
	dir = 8
	},
/turf/open/floor/prison/blue/east,
/area/desert_dam/building/administration/hallway)
"vA" = (
/obj/structure/disposalpipe/segment,
/obj/structure/pipes/standard/simple/hidden/green,
/obj/effect/decal/cleanable/dirt,
/obj/item/ammo_casing,
/obj/item/ammo_casing,
/obj/effect/decal/cleanable/blood,
/turf/open/floor/plating/platingdmg2,
/area/desert_dam/building/administration/hallway)
"we" = (
/obj/effect/decal/cleanable/blood/drip,
/turf/open/floor/darkredcorners2/east,
/area/desert_dam/building/administration/lobby)
"wM" = (
/obj/structure/surface/rack,
/obj/item/ammo_magazine/smg/p90{
	pixel_y = -4
	},
/obj/item/ammo_magazine/smg/p90,
/obj/item/ammo_magazine/smg/p90{
	pixel_y = 4
	},
/turf/open/floor/darkred2,
/area/desert_dam/building/administration/lobby)
"wP" = (
/obj/structure/disposalpipe/segment{
	dir = 4;
	icon_state = "pipe-c"
	},
/obj/structure/pipes/standard/simple/hidden/green{
	dir = 4
	},
/turf/open/floor/prison/bright_clean2,
/area/desert_dam/building/administration/hallway)
"wT" = (
/obj/structure/barricade/wooden,
/turf/open/floor/plating,
/area/desert_dam/building/administration/hallway)
"xa" = (
/obj/item/ammo_magazine/smg/p90,
/turf/open/floor/dark2,
/area/desert_dam/building/administration/hallway)
"xe" = (
/obj/structure/disposalpipe/segment{
	dir = 8;
	icon_state = "pipe-c"
	},
/obj/structure/pipes/standard/simple/hidden/green,
/obj/structure/pipes/standard/simple/hidden/green,
/turf/open/floor/plating,
/area/desert_dam/building/administration/hallway)
"xW" = (
/obj/structure/surface/table/almayer,
/obj/item/tool/stamp{
	pixel_x = 8
	},
/obj/item/tool/lighter/random,
/turf/open/floor/darkred2/southwest,
/area/desert_dam/building/administration/lobby)
"zQ" = (
/obj/effect/decal/cleanable/dirt,
/obj/effect/decal/cleanable/dirt,
/turf/open/floor/prison/blue,
/area/desert_dam/building/administration/hallway)
"AB" = (
/obj/structure/disposalpipe/segment{
	dir = 4;
	icon_state = "pipe-c"
	},
/obj/structure/pipes/standard/simple/hidden/green{
	dir = 4
	},
/turf/open/floor/prison/bright_clean2,
/area/desert_dam/building/administration/lobby)
"Bq" = (
/obj/effect/decal/cleanable/dirt,
/turf/open/floor/prison/blue,
/area/desert_dam/building/administration/hallway)
"Bw" = (
/obj/structure/disposalpipe/junction,
/obj/structure/pipes/standard/manifold/hidden/green{
	dir = 4
	},
/obj/effect/decal/cleanable/dirt,
/obj/item/stack/sheet/wood,
/turf/open/floor/prison/bright_clean2,
/area/desert_dam/building/administration/hallway)
"EO" = (
/obj/structure/pipes/standard/simple/hidden/green{
	dir = 4
	},
/obj/structure/disposalpipe/segment{
	dir = 4
	},
/obj/item/shard,
/turf/open/floor/prison/bright_clean2,
/area/desert_dam/building/administration/hallway)
"EY" = (
/obj/structure/disposalpipe/segment{
	dir = 8;
	icon_state = "pipe-c"
	},
/obj/effect/decal/cleanable/dirt,
/obj/effect/decal/cleanable/dirt,
/turf/open/floor/prison/bright_clean2,
/area/desert_dam/building/administration/hallway)
"FH" = (
/obj/effect/decal/cleanable/dirt,
/obj/effect/decal/cleanable/blood/drip{
	pixel_x = 2;
	pixel_y = 15
	},
/turf/open/floor/prison/bluecorner/east,
/area/desert_dam/building/administration/hallway)
"Hl" = (
/turf/open/floor/prison/blue/west,
/area/desert_dam/building/administration/hallway)
"Hy" = (
/obj/item/weapon/twohanded/folded_metal_chair,
/turf/open/floor/prison/blue/east,
/area/desert_dam/building/administration/hallway)
"HC" = (
/obj/structure/machinery/power/apc/no_power/north,
/obj/structure/closet/secure_closet/security,
/obj/effect/landmark/objective_landmark/medium,
/turf/open/floor/darkred2/northeast,
/area/desert_dam/building/administration/lobby)
"Ka" = (
/obj/structure/machinery/light,
/obj/structure/surface/table/almayer,
/obj/item/storage/donut_box{
	pixel_y = 5
	},
/turf/open/floor/darkred2,
/area/desert_dam/building/administration/lobby)
"Lb" = (
/obj/structure/pipes/standard/simple/hidden/green{
	dir = 4
	},
/obj/structure/disposalpipe/segment{
	dir = 4
	},
/obj/item/ammo_casing,
/obj/item/ammo_casing,
/obj/item/ammo_casing,
/obj/item/ammo_casing,
/obj/effect/decal/cleanable/blood,
/turf/open/floor/platingdmg1,
/area/desert_dam/building/administration/hallway)
"LS" = (
/obj/structure/disposalpipe/segment{
	dir = 1;
	icon_state = "pipe-c"
	},
/obj/effect/decal/cleanable/dirt,
/obj/effect/decal/cleanable/dirt,
/turf/open/floor/prison/bright_clean2,
/area/desert_dam/building/administration/hallway)
"ND" = (
/obj/structure/machinery/computer/cameras{
	name = "Security Cameras - Operations";
	network = list("chigusa_1")
	},
/obj/structure/surface/table/almayer,
/turf/open/floor/darkred2/northwest,
/area/desert_dam/building/administration/lobby)
"OJ" = (
/obj/structure/machinery/light{
	dir = 4
	},
/obj/structure/barricade/wooden,
/turf/open/floor/prison/blue/east,
/area/desert_dam/building/administration/hallway)
"Qd" = (
/obj/effect/decal/cleanable/blood{
	layer = 3
	},
/turf/open/floor/prison/bright_clean2,
/area/desert_dam/building/administration/lobby)
"SV" = (
/obj/structure/bed/chair/office/light{
	dir = 8;
	pixel_x = -4
	},
/turf/open/floor/darkred2/west,
/area/desert_dam/building/administration/lobby)
"Tz" = (
/obj/structure/disposalpipe/segment,
/obj/structure/pipes/standard/simple/hidden/green,
/obj/structure/pipes/standard/simple/hidden/green,
/obj/effect/decal/cleanable/dirt,
/obj/effect/decal/cleanable/blood,
/turf/open/floor/prison/bright_clean2,
/area/desert_dam/building/administration/hallway)
"Uq" = (
/obj/structure/disposalpipe/segment,
/obj/structure/pipes/standard/simple/hidden/green,
/obj/effect/decal/cleanable/dirt,
/obj/item/weapon/gun/smg/p90,
/turf/open/floor/prison/bright_clean2,
/area/desert_dam/building/administration/hallway)
"UI" = (
/obj/structure/surface/table/almayer,
/obj/item/storage/briefcase,
/turf/open/floor/prison/blue,
/area/desert_dam/building/administration/hallway)
"WT" = (
/obj/structure/pipes/vents/pump{
	dir = 4
	},
/obj/effect/decal/cleanable/blood/drip{
	pixel_x = 4;
	pixel_y = -9
	},
/turf/open/floor/plating,
/area/desert_dam/building/administration/hallway)
"WW" = (
/obj/structure/disposalpipe/segment{
	dir = 4;
	icon_state = "pipe-c"
	},
/obj/effect/decal/cleanable/dirt,
/obj/item/prop/alien/hugger,
/obj/effect/decal/cleanable/blood/xeno,
/turf/open/floor/prison/bright_clean2,
/area/desert_dam/building/administration/hallway)
"Xz" = (
/turf/open/floor/plating,
/area/desert_dam/building/administration/hallway)
"XE" = (
/obj/structure/pipes/standard/simple/hidden/green{
	dir = 4
	},
/obj/structure/disposalpipe/segment{
	dir = 4
	},
/turf/open/floor/prison/bright_clean2,
/area/desert_dam/building/administration/hallway)
"XF" = (
/obj/structure/pipes/standard/simple/hidden/green{
	dir = 4
	},
/obj/structure/disposalpipe/segment{
	dir = 4
	},
/obj/item/stack/rods,
/obj/item/stack/sheet/metal{
	pixel_x = 4;
	pixel_y = 3
	},
/turf/open/floor/plating,
/area/desert_dam/building/administration/hallway)
"XJ" = (
/obj/effect/decal/cleanable/dirt,
/obj/effect/decal/cleanable/dirt,
/turf/open/floor/prison/bright_clean2,
/area/desert_dam/building/administration/hallway)
"ZA" = (
/obj/structure/machinery/disposal,
/obj/structure/disposalpipe/trunk{
	dir = 1
	},
/turf/open/floor/darkred2,
/area/desert_dam/building/administration/lobby)
"ZL" = (
/obj/structure/disposalpipe/segment,
/obj/structure/pipes/standard/manifold/hidden/green{
	dir = 4
	},
/obj/effect/decal/cleanable/dirt,
/turf/open/floor/prison/bright_clean2,
/area/desert_dam/building/administration/hallway)

(1,1,1) = {"
nb
jf
iO
lH
ND
SV
lr
xW
fS
"}
(2,1,1) = {"
nb
jf
UI
lH
ti
Qd
dC
Ka
fS
"}
(3,1,1) = {"
kK
LS
Bq
nw
il
ef
ji
wM
fS
"}
(4,1,1) = {"
wP
EY
Bq
lH
HC
we
AB
ZA
fS
"}
(5,1,1) = {"
nb
XJ
zQ
lH
lH
rg
XF
nw
lH
"}
(6,1,1) = {"
nb
nP
nF
mX
an
FH
EO
wT
Hl
"}
(7,1,1) = {"
XE
rM
WT
tp
ir
mF
Lb
cD
WW
"}
(8,1,1) = {"
dE
Uq
ZL
tD
vA
ay
Bw
Tz
xe
"}
(9,1,1) = {"
xa
ct
iz
tK
Hy
oO
Xz
OJ
iv
"}
