//MAP CONVERTED BY dmm2tgm.py THIS HEADER COMMENT PREVENTS RECONVERSION, DO NOT REMOVE
"a" = (
/turf/open/floor/greengrid,
/area/desert_dam/interior/dam_interior/smes_main)
"b" = (
/obj/item/tool/warning_cone{
	pixel_y = 15;
	pixel_x = -9
	},
/turf/open/floor/prison/darkyellow2/west,
/area/desert_dam/interior/dam_interior/smes_main)
"c" = (
/obj/effect/decal/cleanable/dirt,
/obj/item/stack/sheet/metal/medium_stack,
/turf/open/floor/prison/bright_clean/southwest,
/area/desert_dam/interior/dam_interior/smes_main)
"d" = (
/obj/effect/decal/cleanable/dirt,
/obj/effect/decal/cleanable/dirt,
/turf/open/floor/greengrid,
/area/desert_dam/interior/dam_interior/smes_main)
"f" = (
/obj/structure/window/framed/hangar,
/turf/open/floor/plating,
/area/desert_dam/interior/dam_interior/smes_main)
"j" = (
/turf/closed/wall/hangar{
	name = "reinforced metal wall"
	},
/area/desert_dam/interior/dam_interior/smes_main)
"p" = (
/obj/structure/disposalpipe/segment,
/turf/open/floor/prison/bright_clean/southwest,
/area/desert_dam/interior/dam_interior/smes_main)
"w" = (
/obj/structure/machinery/light{
	dir = 1
	},
/obj/structure/largecrate/random/case/double,
/turf/open/floor/prison/darkyellow2/northeast,
/area/desert_dam/interior/dam_interior/smes_main)
"z" = (
/turf/open/floor/prison/bright_clean/southwest,
/area/desert_dam/interior/dam_interior/smes_main)
"B" = (
/obj/structure/machinery/disposal,
/obj/structure/disposalpipe/trunk{
	dir = 4
	},
/obj/structure/machinery/light{
	dir = 1
	},
/turf/open/floor/prison/darkyellow2/northwest,
/area/desert_dam/interior/dam_interior/smes_main)
"C" = (
/turf/open/floor/prison/darkyellow2/east,
/area/desert_dam/interior/dam_interior/smes_main)
"E" = (
/turf/open/floor/prison/darkyellow2/west,
/area/desert_dam/interior/dam_interior/smes_main)
"H" = (
/obj/structure/reagent_dispensers/fueltank,
/turf/open/floor/prison/darkyellow2/north,
/area/desert_dam/interior/dam_interior/smes_main)
"K" = (
/obj/effect/decal/cleanable/dirt,
/turf/open/floor/greengrid,
/area/desert_dam/interior/dam_interior/smes_main)
"P" = (
/obj/effect/decal/cleanable/dirt,
/turf/open/floor/prison/bright_clean/southwest,
/area/desert_dam/interior/dam_interior/smes_main)
"R" = (
/obj/structure/surface/table,
/obj/item/stack/cable_coil/random{
	pixel_y = 7
	},
/obj/item/stack/sheet/metal/med_large_stack,
/turf/open/floor/prison/darkyellow2/north,
/area/desert_dam/interior/dam_interior/smes_main)
"U" = (
/obj/structure/disposalpipe/segment{
	dir = 2;
	icon_state = "pipe-c"
	},
/obj/effect/landmark/objective_landmark/close,
/obj/structure/closet/secure_closet/engineering_personal,
/turf/open/floor/prison/darkyellow2/north,
/area/desert_dam/interior/dam_interior/smes_main)
"V" = (
/obj/structure/surface/table,
/obj/item/stack/rods{
	pixel_y = 5
	},
/turf/open/floor/prison/darkyellow2/north,
/area/desert_dam/interior/dam_interior/smes_main)
"W" = (
/obj/structure/closet/crate,
/obj/item/stack/sheet/mineral/phoron/medium_stack,
/turf/open/floor/prison/darkyellow2/north,
/area/desert_dam/interior/dam_interior/smes_main)
"Y" = (
/obj/structure/surface/rack,
/obj/effect/spawner/random/toolbox{
	layer = 4;
	pixel_y = 13
	},
/obj/effect/spawner/random/powercell{
	pixel_x = -1;
	pixel_y = -1
	},
/turf/open/floor/prison/darkyellow2/north,
/area/desert_dam/interior/dam_interior/smes_main)

(1,1,1) = {"
j
j
j
j
"}
(2,1,1) = {"
j
B
b
E
"}
(3,1,1) = {"
f
U
p
p
"}
(4,1,1) = {"
f
V
P
a
"}
(5,1,1) = {"
f
H
P
K
"}
(6,1,1) = {"
f
Y
P
K
"}
(7,1,1) = {"
f
W
c
d
"}
(8,1,1) = {"
f
R
z
z
"}
(9,1,1) = {"
j
w
C
C
"}
(10,1,1) = {"
j
j
f
f
"}
