//MAP CONVERTED BY dmm2tgm.py THIS HEADER COMMENT PREVENTS RECONVERSION, DO NOT REMOVE
"a" = (
/turf/closed/wall/r_wall/prison_unmeltable,
/area/prison/maintenance/staff_research)
"b" = (
/turf/closed/wall/r_wall/prison_unmeltable,
/area/prison/hangar_storage/main)
"c" = (
/obj/structure/window/framed/prison/reinforced/hull,
/turf/open/floor/plating,
/area/prison/hangar_storage/main)
"d" = (
/turf/closed/wall/r_wall/prison,
/area/prison/hangar_storage/main)
"e" = (
/obj/structure/surface/rack,
/turf/open/floor/prison{
	tag = "icon-darkyellowfull2 (EAST)";
	icon_state = "darkyellowfull2";
	dir = 4
	},
/area/prison/hangar_storage/main)
"f" = (
/turf/open/floor/prison{
	dir = 9;
	icon_state = "darkyellow2"
	},
/area/prison/hangar_storage/main)
"g" = (
/turf/open/floor/prison{
	dir = 1;
	icon_state = "darkyellow2"
	},
/area/prison/hangar_storage/main)
"h" = (
/obj/structure/machinery/light{
	dir = 1
	},
/turf/open/floor/prison{
	dir = 1;
	icon_state = "darkyellow2"
	},
/area/prison/hangar_storage/main)
"i" = (
/obj/structure/cable{
	d2 = 2;
	icon_state = "0-2";
	pixel_y = 0
	},
/obj/structure/machinery/power/apc{
	dir = 1;
	pixel_y = 24;
	start_charge = 0
	},
/turf/open/floor/prison{
	dir = 5;
	icon_state = "darkyellow2"
	},
/area/prison/hangar_storage/main)
"j" = (
/obj/structure/surface/rack,
/obj/item/storage/box/nade_box/tear_gas,
/turf/open/floor/prison{
	tag = "icon-darkyellowfull2 (EAST)";
	icon_state = "darkyellowfull2";
	dir = 4
	},
/area/prison/hangar_storage/main)
"k" = (
/turf/open/floor/prison{
	dir = 8;
	icon_state = "darkyellow2"
	},
/area/prison/hangar_storage/main)
"l" = (
/obj/item/storage/box/explosive_mines,
/turf/open/floor/prison{
	dir = 1;
	icon_state = "darkyellow2"
	},
/area/prison/hangar_storage/main)
"m" = (
/turf/open/floor/prison{
	tag = "icon-floor_marked (SOUTHWEST)";
	icon_state = "floor_marked";
	dir = 10
	},
/area/prison/hangar_storage/main)
"n" = (
/obj/structure/cable{
	d1 = 1;
	d2 = 2;
	icon_state = "1-2"
	},
/turf/open/floor/prison{
	dir = 4;
	icon_state = "darkyellow2"
	},
/area/prison/hangar_storage/main)
"o" = (
/obj/structure/pipes/vents/pump/on,
/turf/open/floor/prison{
	dir = 8;
	icon_state = "darkyellow2"
	},
/area/prison/hangar_storage/main)
"p" = (
/turf/open/floor/prison{
	tag = "icon-floor (SOUTHWEST)";
	icon_state = "floor";
	dir = 10
	},
/area/prison/hangar_storage/main)
"q" = (
/obj/structure/cable{
	d1 = 1;
	d2 = 2;
	icon_state = "1-2"
	},
/obj/structure/pipes/vents/pump/on,
/turf/open/floor/prison{
	dir = 4;
	icon_state = "darkyellow2"
	},
/area/prison/hangar_storage/main)
"r" = (
/obj/structure/pipes/standard/simple/hidden/supply,
/turf/open/floor/prison{
	dir = 8;
	icon_state = "darkyellow2"
	},
/area/prison/hangar_storage/main)
"s" = (
/obj/structure/cable{
	d1 = 1;
	d2 = 2;
	icon_state = "1-2"
	},
/obj/structure/pipes/standard/simple/hidden/supply,
/turf/open/floor/prison{
	dir = 4;
	icon_state = "darkyellow2"
	},
/area/prison/hangar_storage/main)
"t" = (
/obj/structure/pipes/vents/scrubber{
	dir = 4
	},
/turf/open/floor/prison{
	tag = "icon-darkyellowfull2 (EAST)";
	icon_state = "darkyellowfull2";
	dir = 4
	},
/area/prison/hangar_storage/main)
"u" = (
/obj/structure/largecrate/supply/supplies/metal,
/turf/open/floor/prison{
	dir = 1;
	icon_state = "darkyellow2"
	},
/area/prison/hangar_storage/main)
"v" = (
/obj/effect/landmark/corpsespawner/prison_security,
/turf/open/floor/prison{
	dir = 1;
	icon_state = "darkyellow2"
	},
/area/prison/hangar_storage/main)
"w" = (
/turf/open/floor/prison{
	icon_state = "darkyellow2"
	},
/area/prison/hangar_storage/main)
"x" = (
/obj/effect/decal/cleanable/blood/gibs/xeno/limb,
/turf/open/floor/prison{
	dir = 8;
	icon_state = "darkyellow2"
	},
/area/prison/hangar_storage/main)
"y" = (
/obj/structure/pipes/vents/scrubber{
	dir = 8
	},
/turf/open/floor/prison{
	tag = "icon-darkyellowfull2 (EAST)";
	icon_state = "darkyellowfull2";
	dir = 4
	},
/area/prison/hangar_storage/main)
"z" = (
/obj/structure/machinery/door/airlock/multi_tile/almayer/generic{
	name = "Main Hangar Storage"
	},
/turf/open/floor/prison{
	tag = "icon-darkyellowfull2 (EAST)";
	icon_state = "darkyellowfull2";
	dir = 4
	},
/area/prison/hangar_storage/main)
"A" = (
/obj/structure/pipes/standard/simple/hidden/supply,
/obj/structure/pipes/standard/simple/hidden/scrubbers,
/turf/open/floor/prison{
	tag = "icon-darkyellowfull2 (EAST)";
	icon_state = "darkyellowfull2";
	dir = 4
	},
/area/prison/hangar_storage/main)
"B" = (
/obj/structure/window/framed/prison/reinforced,
/turf/open/floor/plating,
/area/prison/hangar_storage/main)
"C" = (
/obj/structure/cable{
	d1 = 1;
	d2 = 2;
	icon_state = "1-2"
	},
/obj/structure/pipes/standard/simple/hidden/supply,
/obj/structure/pipes/standard/simple/hidden/scrubbers,
/turf/open/floor/prison{
	tag = "icon-darkyellowfull2 (EAST)";
	icon_state = "darkyellowfull2";
	dir = 4
	},
/area/prison/hangar_storage/main)
"D" = (
/obj/effect/landmark/corpsespawner/prison_security,
/obj/item/weapon/gun/rifle/m16,
/obj/item/storage/belt/medical/full,
/turf/open/floor/prison{
	tag = "icon-floor_marked (SOUTHWEST)";
	icon_state = "floor_marked";
	dir = 10
	},
/area/prison/hangar_storage/main)
"E" = (
/obj/item/device/defibrillator,
/turf/open/floor/prison{
	tag = "icon-floor_marked (SOUTHWEST)";
	icon_state = "floor_marked";
	dir = 10
	},
/area/prison/hangar_storage/main)
"F" = (
/obj/item/storage/box/explosive_mines,
/turf/open/floor/prison{
	tag = "icon-floor_marked (SOUTHWEST)";
	icon_state = "floor_marked";
	dir = 10
	},
/area/prison/hangar_storage/main)
"G" = (
/obj/structure/surface/rack,
/obj/item/weapon/gun/launcher/grenade/m81,
/obj/item/storage/box/handcuffs,
/obj/item/storage/box/handcuffs,
/turf/open/floor/prison{
	tag = "icon-darkyellowfull2 (EAST)";
	icon_state = "darkyellowfull2";
	dir = 4
	},
/area/prison/hangar_storage/main)
"H" = (
/obj/effect/decal/cleanable/blood/gibs/xeno,
/turf/open/floor/prison{
	tag = "icon-floor_marked (SOUTHWEST)";
	icon_state = "floor_marked";
	dir = 10
	},
/area/prison/hangar_storage/main)
"I" = (
/obj/item/stack/medical/ointment,
/turf/open/floor/prison{
	tag = "icon-floor_marked (SOUTHWEST)";
	icon_state = "floor_marked";
	dir = 10
	},
/area/prison/hangar_storage/main)
"J" = (
/obj/structure/cable{
	d1 = 1;
	d2 = 2;
	icon_state = "1-2"
	},
/obj/item/storage/firstaid,
/turf/open/floor/prison{
	dir = 4;
	icon_state = "darkyellow2"
	},
/area/prison/hangar_storage/main)
"K" = (
/obj/effect/decal/cleanable/blood/gibs/xeno,
/turf/open/floor/prison{
	tag = "icon-floor (SOUTHWEST)";
	icon_state = "floor";
	dir = 10
	},
/area/prison/hangar_storage/main)
"L" = (
/obj/effect/decal/cleanable/blood/gibs/xeno/body,
/turf/open/floor/prison{
	tag = "icon-floor (SOUTHWEST)";
	icon_state = "floor";
	dir = 10
	},
/area/prison/hangar_storage/main)
"M" = (
/obj/effect/landmark/corpsespawner/prison_security,
/obj/item/weapon/gun/rifle/m16,
/obj/item/storage/belt/medical/full,
/turf/open/floor/prison{
	tag = "icon-floor (SOUTHWEST)";
	icon_state = "floor";
	dir = 10
	},
/area/prison/hangar_storage/main)
"N" = (
/obj/structure/pipes/standard/simple/hidden/supply,
/obj/structure/machinery/defenses/sentry/premade/dumb,
/turf/open/floor/prison{
	dir = 8;
	icon_state = "darkyellow2"
	},
/area/prison/hangar_storage/main)
"O" = (
/obj/structure/machinery/defenses/sentry/premade/dumb,
/turf/open/floor/prison{
	tag = "icon-floor_marked (SOUTHWEST)";
	icon_state = "floor_marked";
	dir = 10
	},
/area/prison/hangar_storage/main)
"P" = (
/obj/structure/cable{
	d1 = 1;
	d2 = 2;
	icon_state = "1-2"
	},
/obj/structure/pipes/standard/simple/hidden/supply,
/obj/structure/machinery/defenses/sentry/premade/dumb,
/turf/open/floor/prison{
	dir = 4;
	icon_state = "darkyellow2"
	},
/area/prison/hangar_storage/main)
"Q" = (
/obj/structure/pipes/standard/simple/hidden/supply{
	dir = 5;
	icon_state = "intact-supply";
	tag = "icon-intact-supply (EAST)"
	},
/obj/structure/pipes/standard/simple/hidden/scrubbers{
	tag = "icon-intact-scrubbers (EAST)";
	icon_state = "intact-scrubbers";
	dir = 4
	},
/obj/structure/barricade/metal/wired,
/turf/open/floor/prison{
	dir = 10;
	icon_state = "darkyellow2"
	},
/area/prison/hangar_storage/main)
"R" = (
/obj/structure/pipes/standard/simple/hidden/supply{
	dir = 10;
	icon_state = "intact-supply";
	tag = "icon-intact-supply (EAST)"
	},
/obj/structure/pipes/standard/simple/hidden/scrubbers{
	dir = 10
	},
/obj/structure/barricade/metal/wired,
/turf/open/floor/prison{
	icon_state = "darkyellow2"
	},
/area/prison/hangar_storage/main)
"S" = (
/obj/structure/barricade/metal/wired,
/turf/open/floor/prison{
	icon_state = "darkyellow2"
	},
/area/prison/hangar_storage/main)
"T" = (
/obj/structure/cable{
	d1 = 1;
	d2 = 2;
	icon_state = "1-2"
	},
/obj/structure/pipes/standard/simple/hidden/supply,
/obj/structure/pipes/standard/simple/hidden/scrubbers{
	dir = 6
	},
/obj/structure/barricade/metal/wired,
/turf/open/floor/prison{
	dir = 6;
	icon_state = "darkyellow2"
	},
/area/prison/hangar_storage/main)

(1,1,1) = {"
a
d
d
d
d
d
d
d
d
"}
(2,1,1) = {"
b
j
j
G
e
e
e
t
d
"}
(3,1,1) = {"
b
f
x
k
o
N
r
Q
z
"}
(4,1,1) = {"
b
l
m
H
p
m
m
R
A
"}
(5,1,1) = {"
c
u
D
m
K
m
m
w
d
"}
(6,1,1) = {"
b
h
m
I
p
m
m
w
d
"}
(7,1,1) = {"
b
g
m
m
p
O
m
S
B
"}
(8,1,1) = {"
b
v
E
m
m
m
m
w
d
"}
(9,1,1) = {"
b
h
F
m
p
m
m
w
d
"}
(10,1,1) = {"
c
u
m
m
L
m
m
w
d
"}
(11,1,1) = {"
b
g
m
m
M
m
m
S
z
"}
(12,1,1) = {"
b
i
n
J
q
P
s
T
C
"}
(13,1,1) = {"
b
j
j
G
e
e
e
y
d
"}
(14,1,1) = {"
b
b
b
b
b
b
b
b
b
"}
