"a" = (/turf/closed/wall/r_wall/prison_unmeltable,/area/prison/maintenance/staff_research)
"b" = (/turf/closed/wall/r_wall/prison_unmeltable,/area/prison/hangar_storage/main)
"c" = (/obj/structure/window/framed/prison/reinforced/hull,/turf/open/floor/plating,/area/prison/hangar_storage/main)
"d" = (/turf/closed/wall/r_wall/prison,/area/prison/hangar_storage/main)
"e" = (/turf/open/floor/prison{tag = "icon-darkyellowfull2 (EAST)"; icon_state = "darkyellowfull2"; dir = 4},/area/prison/hangar_storage/main)
"f" = (/turf/open/floor/prison{dir = 9; icon_state = "darkyellow2"},/area/prison/hangar_storage/main)
"g" = (/turf/open/floor/prison{dir = 1; icon_state = "darkyellow2"},/area/prison/hangar_storage/main)
"h" = (/obj/machinery/light{dir = 1},/turf/open/floor/prison{dir = 1; icon_state = "darkyellow2"},/area/prison/hangar_storage/main)
"i" = (/obj/structure/cable{d2 = 2; icon_state = "0-2"; pixel_y = 0},/obj/machinery/power/apc{dir = 1; pixel_y = 24; start_charge = 0},/turf/open/floor/prison{dir = 5; icon_state = "darkyellow2"},/area/prison/hangar_storage/main)
"j" = (/turf/open/floor/prison{dir = 8; icon_state = "darkyellow2"},/area/prison/hangar_storage/main)
"k" = (/turf/open/floor/prison{tag = "icon-floor_marked (SOUTHWEST)"; icon_state = "floor_marked"; dir = 10},/area/prison/hangar_storage/main)
"l" = (/obj/structure/cable{d1 = 1; d2 = 2; icon_state = "1-2"},/turf/open/floor/prison{dir = 4; icon_state = "darkyellow2"},/area/prison/hangar_storage/main)
"m" = (/obj/machinery/atmospherics/unary/vent_pump{on = 1},/turf/open/floor/prison{dir = 8; icon_state = "darkyellow2"},/area/prison/hangar_storage/main)
"n" = (/turf/open/floor/prison{tag = "icon-floor (SOUTHWEST)"; icon_state = "floor"; dir = 10},/area/prison/hangar_storage/main)
"o" = (/obj/effect/landmark{name = "crap_item"},/turf/open/floor/prison{dir = 8; icon_state = "darkyellow2"},/area/prison/hangar_storage/main)
"p" = (/obj/machinery/atmospherics/pipe/simple/hidden/supply,/turf/open/floor/prison{dir = 8; icon_state = "darkyellow2"},/area/prison/hangar_storage/main)
"q" = (/obj/structure/cable{d1 = 1; d2 = 2; icon_state = "1-2"},/obj/machinery/atmospherics/pipe/simple/hidden/supply,/turf/open/floor/prison{dir = 4; icon_state = "darkyellow2"},/area/prison/hangar_storage/main)
"r" = (/obj/machinery/atmospherics/unary/vent_scrubber{dir = 4},/turf/open/floor/prison{tag = "icon-darkyellowfull2 (EAST)"; icon_state = "darkyellowfull2"; dir = 4},/area/prison/hangar_storage/main)
"s" = (/obj/effect/landmark{name = "crap_item"},/turf/open/floor/prison{tag = "icon-floor_marked (SOUTHWEST)"; icon_state = "floor_marked"; dir = 10},/area/prison/hangar_storage/main)
"t" = (/obj/structure/cable{d1 = 1; d2 = 2; icon_state = "1-2"},/obj/machinery/atmospherics/unary/vent_pump{on = 1},/obj/effect/landmark/corpsespawner/prison_security,/turf/open/floor/prison{dir = 4; icon_state = "darkyellow2"},/area/prison/hangar_storage/main)
"u" = (/turf/open/floor/prison{icon_state = "darkyellow2"},/area/prison/hangar_storage/main)
"v" = (/obj/effect/landmark/corpsespawner/prison_security,/turf/open/floor/prison{tag = "icon-floor_marked (SOUTHWEST)"; icon_state = "floor_marked"; dir = 10},/area/prison/hangar_storage/main)
"w" = (/obj/machinery/atmospherics/unary/vent_scrubber{dir = 8},/turf/open/floor/prison{tag = "icon-darkyellowfull2 (EAST)"; icon_state = "darkyellowfull2"; dir = 4},/area/prison/hangar_storage/main)
"x" = (/obj/machinery/door/airlock/multi_tile/almayer/generic{name = "Main Hangar Storage"},/turf/open/floor/prison{tag = "icon-darkyellowfull2 (EAST)"; icon_state = "darkyellowfull2"; dir = 4},/area/prison/hangar_storage/main)
"y" = (/obj/machinery/atmospherics/pipe/simple/hidden/supply,/obj/machinery/atmospherics/pipe/simple/hidden/scrubbers,/turf/open/floor/prison{tag = "icon-darkyellowfull2 (EAST)"; icon_state = "darkyellowfull2"; dir = 4},/area/prison/hangar_storage/main)
"z" = (/obj/structure/window_frame/prison/reinforced,/obj/item/shard,/turf/open/floor/plating,/area/prison/hangar_storage/main)
"A" = (/obj/structure/cable{d1 = 1; d2 = 2; icon_state = "1-2"},/obj/machinery/atmospherics/pipe/simple/hidden/supply,/obj/machinery/atmospherics/pipe/simple/hidden/scrubbers,/turf/open/floor/prison{tag = "icon-darkyellowfull2 (EAST)"; icon_state = "darkyellowfull2"; dir = 4},/area/prison/hangar_storage/main)
"B" = (/obj/machinery/atmospherics/pipe/simple/hidden/supply{dir = 5; icon_state = "intact-supply"; tag = "icon-intact-supply (EAST)"},/obj/machinery/atmospherics/pipe/simple/hidden/scrubbers{tag = "icon-intact-scrubbers (EAST)"; icon_state = "intact-scrubbers"; dir = 4},/obj/item/stack/sheet/metal,/obj/effect/landmark/corpsespawner/prisoner,/turf/open/floor/prison{dir = 10; icon_state = "darkyellow2"},/area/prison/hangar_storage/main)
"C" = (/obj/machinery/atmospherics/pipe/simple/hidden/supply{dir = 10; icon_state = "intact-supply"; tag = "icon-intact-supply (EAST)"},/obj/machinery/atmospherics/pipe/simple/hidden/scrubbers{dir = 10},/obj/structure/barricade/metal,/turf/open/floor/prison{icon_state = "darkyellow2"},/area/prison/hangar_storage/main)
"D" = (/obj/item/stack/sheet/metal,/turf/open/floor/prison{icon_state = "darkyellow2"},/area/prison/hangar_storage/main)
"E" = (/obj/structure/cable{d1 = 1; d2 = 2; icon_state = "1-2"},/obj/machinery/atmospherics/pipe/simple/hidden/supply,/obj/machinery/atmospherics/pipe/simple/hidden/scrubbers{dir = 6},/obj/structure/barricade/metal,/turf/open/floor/prison{dir = 6; icon_state = "darkyellow2"},/area/prison/hangar_storage/main)

(1,1,1) = {"
abbbcbbbbcbbbb
defgghgghggieb
deokkkkkkskleb
dejkkkkkkkkleb
demnnnnknnnteb
depkkkkkkkkqeb
depvkkkskksqeb
drBCuuuuuuDEwb
ddxyddzdddxAdb
"}
