"a" = (/turf/closed/wall/r_wall/prison_unmeltable,/area/prison/residential/central)
"b" = (/turf/closed/wall/r_wall/prison_unmeltable,/area/prison/maintenance/residential/nw)
"c" = (/turf/closed/wall/prison,/area/prison/maintenance/residential/nw)
"d" = (/obj/machinery/door/airlock/almayer/maint{dir = 2; req_one_access_txt = "0"},/obj/machinery/atmospherics/pipe/simple/hidden/scrubbers,/obj/machinery/atmospherics/pipe/simple/hidden/supply,/turf/open/floor/plating,/area/prison/maintenance/residential/nw)
"e" = (/turf/open/floor/plating,/area/prison/residential/central)
"f" = (/obj/effect/decal/warning_stripes{tag = "icon-W"; icon_state = "W"},/turf/open/floor/plating,/area/prison/residential/central)
"g" = (/obj/machinery/light{dir = 1},/turf/open/floor/plating,/area/prison/residential/central)
"h" = (/obj/machinery/atmospherics/unary/vent_pump{dir = 4; on = 1},/turf/open/floor/plating,/area/prison/residential/central)
"i" = (/obj/machinery/atmospherics/pipe/simple/hidden/scrubbers{tag = "icon-intact-scrubbers (NORTHEAST)"; icon_state = "intact-scrubbers"; dir = 5},/obj/machinery/atmospherics/pipe/simple/hidden/supply{dir = 9; icon_state = "intact-supply"; tag = "icon-intact-supply (EAST)"},/turf/open/floor/plating,/area/prison/residential/central)
"j" = (/obj/machinery/atmospherics/unary/vent_scrubber{dir = 8},/turf/open/floor/prison,/area/prison/residential/central)
"k" = (/turf/open/floor/prison,/area/prison/residential/central)
"l" = (/turf/closed/wall/prison,/area/prison/residential/central)
"m" = (/obj/effect/decal/warning_stripes{tag = "icon-SE-out"; icon_state = "SE-out"},/obj/effect/decal/warning_stripes{tag = "icon-W"; icon_state = "W"},/turf/open/floor/plating,/area/prison/residential/central)
"n" = (/obj/effect/decal/warning_stripes{tag = "icon-S"; icon_state = "S"},/turf/open/floor/plating,/area/prison/residential/central)
"o" = (/obj/effect/decal/warning_stripes{tag = "icon-S"; icon_state = "S"},/obj/effect/landmark{name = "xeno_spawn"; pixel_x = -1},/turf/open/floor/plating,/area/prison/residential/central)
"p" = (/obj/effect/decal/warning_stripes{tag = "icon-SW-out"; icon_state = "SW-out"},/obj/effect/landmark{name = "xeno_spawn"; pixel_x = -1},/turf/open/floor/plating,/area/prison/residential/central)
"q" = (/obj/effect/decal/warning_stripes{tag = "icon-SE-out"; icon_state = "SE-out"},/obj/effect/decal/warning_stripes{icon_state = "E"; tag = "icon-E"},/obj/effect/decal/warning_stripes{tag = "icon-W"; icon_state = "W"},/turf/open/floor/plating,/area/prison/residential/central)
"r" = (/obj/effect/landmark{name = "xeno_spawn"; pixel_x = -1},/turf/open/floor/plating,/area/prison/residential/central)
"s" = (/obj/effect/decal/warning_stripes{tag = "icon-SW-out"; icon_state = "SW-out"},/obj/effect/decal/warning_stripes{tag = "icon-W"; icon_state = "W"},/obj/effect/landmark{name = "xeno_spawn"; pixel_x = -1},/turf/open/floor/plating,/area/prison/residential/central)
"t" = (/obj/machinery/light{dir = 4},/turf/open/floor/prison,/area/prison/residential/central)
"u" = (/obj/machinery/door/poddoor/four_tile_ver{name = "Civilian Residences Hangar Door"; unacidable = 1},/turf/open/floor/plating,/area/prison/residential/central)
"v" = (/obj/effect/decal/warning_stripes{icon_state = "E"; tag = "icon-E"},/obj/effect/decal/warning_stripes{tag = "icon-W"; icon_state = "W"},/turf/open/floor/plating,/area/prison/residential/central)
"w" = (/obj/effect/decal/warning_stripes{tag = "icon-W"; icon_state = "W"},/obj/effect/landmark{name = "xeno_spawn"; pixel_x = -1},/turf/open/floor/plating,/area/prison/residential/central)
"x" = (/obj/effect/alien/weeds/node,/turf/open/floor/prison,/area/prison/residential/central)
"y" = (/obj/structure/window/framed/prison/reinforced,/turf/open/floor/plating,/area/prison/residential/central)
"z" = (/obj/effect/alien/weeds/node,/turf/open/floor/plating,/area/prison/residential/central)
"A" = (/obj/effect/landmark{name = "good_item"},/obj/effect/landmark{name = "xeno_spawn"; pixel_x = -1},/turf/open/floor/plating,/area/prison/residential/central)
"B" = (/obj/effect/landmark{name = "crap_item"},/obj/effect/landmark{name = "xeno_spawn"; pixel_x = -1},/turf/open/floor/plating,/area/prison/residential/central)
"C" = (/obj/machinery/door/airlock/multi_tile/almayer/generic{dir = 2; name = "Civilian Residences Hangar"},/turf/open/floor/prison,/area/prison/residential/central)
"D" = (/obj/effect/decal/warning_stripes{icon_state = "NE-out"; tag = "icon-NE-out"},/obj/effect/decal/warning_stripes{tag = "icon-W"; icon_state = "W"},/turf/open/floor/plating,/area/prison/residential/central)
"E" = (/obj/effect/decal/warning_stripes{tag = "icon-N"; icon_state = "N"},/turf/open/floor/plating,/area/prison/residential/central)
"F" = (/obj/effect/decal/warning_stripes{tag = "icon-NW-out"; icon_state = "NW-out"},/turf/open/floor/plating,/area/prison/residential/central)
"G" = (/obj/machinery/light,/turf/open/floor/plating,/area/prison/residential/central)
"H" = (/obj/machinery/atmospherics/pipe/simple/hidden/supply{dir = 10; icon_state = "intact-supply"; tag = "icon-intact-supply (EAST)"},/obj/machinery/atmospherics/pipe/simple/hidden/scrubbers{dir = 6},/turf/open/floor/plating,/area/prison/residential/central)
"I" = (/turf/closed/wall/r_wall/prison_unmeltable,/area/prison/maintenance/residential/sw)
"J" = (/turf/closed/wall/prison,/area/prison/maintenance/residential/sw)
"K" = (/obj/machinery/door/airlock/almayer/maint{dir = 2; req_one_access_txt = "0"},/obj/machinery/atmospherics/pipe/simple/hidden/supply,/obj/machinery/atmospherics/pipe/simple/hidden/scrubbers,/turf/open/floor/plating,/area/prison/maintenance/residential/sw)
"L" = (/obj/machinery/atmospherics/pipe/simple/hidden/scrubbers,/obj/machinery/atmospherics/pipe/simple/hidden/supply,/turf/open/floor/plating,/area/prison/residential/central)
"M" = (/obj/structure/window/framed/prison/reinforced/hull,/turf/open/floor/plating,/area/prison/residential/central)

(1,1,1) = {"
aaaaaaaaaaabcdbaa
efeeeegeeeeeeLkkM
efeeeeeeeeeeeLkka
efeeeeeeeeeehijkl
umnnnoooooooopkkl
eqeeerrrrrrrrsktl
uveeerrrrrrrrwxky
eveeerrrrrrrrwkky
eveezrrrrrrrrwkky
eveeerrrrrrrrwkkl
uveeeArrrrrrBwkkk
eveeerrrrrrrrwkkC
eveeerrrrrrrrwxky
eveeerrrrrrrrwkky
uveeerrrrrrrrwkkk
eveeerrrrrrrrwkkC
eveezrrrrrrrrwkkl
eveeerrrrrrrrwkky
uveeerrrrrrrrwxky
eveeerrrrrrrrwkky
eveeerrrrrrrrwktl
eDEEEEEEEEEEEFkkl
ufeeeeeeeeeeeekkl
efeeeeeeeeeeeekka
ufeeeeGeeeeehHjkM
aaaaaaaaaaaIJKIaa
"}
