//MAP CONVERTED BY dmm2tgm.py THIS HEADER COMMENT PREVENTS RECONVERSION, DO NOT REMOVE
"a" = (
/turf/open/space,
/area/space)
"b" = (
/turf/closed/wall/r_wall/prison_unmeltable,
/area/prison/maintenance/residential/nw)
"c" = (
/turf/open/floor/plating,
/area/prison/maintenance/residential/nw)
"d" = (
/obj/structure/pipes/vents/pump/on,
/turf/open/floor/plating,
/area/prison/maintenance/residential/nw)
"e" = (
/obj/structure/pipes/standard/manifold/hidden/supply{
	dir = 8
	},
/obj/structure/pipes/standard/simple/hidden/scrubbers{
	dir = 6
	},
/obj/structure/cable{
	d1 = 2;
	d2 = 4;
	icon_state = "2-4"
	},
/turf/open/floor/plating,
/area/prison/maintenance/residential/nw)
"f" = (
/turf/open/floor/prison{
	icon_state = "rampbottom"
	},
/area/prison/maintenance/residential/nw)
"g" = (
/obj/structure/pipes/standard/simple/hidden/scrubbers,
/obj/structure/pipes/standard/simple/hidden/supply,
/obj/structure/cable{
	d1 = 1;
	d2 = 2;
	icon_state = "1-2"
	},
/turf/open/floor/prison{
	icon_state = "rampbottom"
	},
/area/prison/maintenance/residential/nw)
"h" = (
/obj/structure/pipes/standard/simple/hidden/scrubbers,
/obj/structure/pipes/standard/simple/hidden/supply,
/obj/structure/cable{
	d1 = 1;
	d2 = 2;
	icon_state = "1-2"
	},
/turf/open/floor/plating,
/area/prison/maintenance/residential/nw)
"i" = (
/obj/effect/alien/weeds/node,
/turf/open/floor/plating,
/area/prison/maintenance/residential/nw)
"j" = (
/turf/closed/wall/r_wall/prison_unmeltable,
/area/prison/residential/central)
"k" = (
/turf/closed/wall/prison,
/area/prison/maintenance/residential/nw)
"l" = (
/obj/structure/machinery/door/airlock/almayer/maint{
	dir = 2;
	req_one_access = null
	},
/obj/structure/pipes/standard/simple/hidden/scrubbers,
/obj/structure/pipes/standard/simple/hidden/supply,
/obj/structure/cable{
	d1 = 1;
	d2 = 2;
	icon_state = "1-2"
	},
/turf/open/floor/plating,
/area/prison/maintenance/residential/nw)

(1,1,1) = {"
a
a
a
a
a
a
a
j
"}
(2,1,1) = {"
a
a
a
a
a
a
a
j
"}
(3,1,1) = {"
a
a
a
a
a
a
a
j
"}
(4,1,1) = {"
a
a
a
a
a
a
a
j
"}
(5,1,1) = {"
a
a
a
a
a
a
a
j
"}
(6,1,1) = {"
a
a
a
a
a
a
a
j
"}
(7,1,1) = {"
b
b
b
b
b
b
b
b
"}
(8,1,1) = {"
b
c
c
f
c
i
c
k
"}
(9,1,1) = {"
b
d
e
g
h
h
h
l
"}
