//MAP CONVERTED BY dmm2tgm.py THIS HEADER COMMENT PREVENTS RECONVERSION, DO NOT REMOVE
"a" = (
/turf/open/space,
/area/space)
"b" = (
/turf/closed/wall/r_wall/prison_unmeltable,
/area/prison/maintenance/residential/access/north)
"c" = (
/turf/open/space,
/area/prison/maintenance/residential/access/north)
"d" = (
/turf/closed/wall/prison,
/area/prison/maintenance/residential/access/north)
"e" = (
/obj/structure/pipes/standard/cap/hidden{
	icon_state = "cap";
	dir = 8
	},
/obj/structure/pipes/standard/cap/hidden{
	icon_state = "cap";
	dir = 8
	},
/turf/closed/wall/r_wall/prison_unmeltable,
/area/prison/maintenance/residential/access/north)
"f" = (
/obj/structure/pipes/standard/cap/hidden{
	icon_state = "cap";
	dir = 4
	},
/obj/structure/pipes/standard/cap/hidden{
	icon_state = "cap";
	dir = 4
	},
/turf/closed/wall/r_wall/prison_unmeltable,
/area/prison/maintenance/residential/access/north)
"g" = (
/obj/structure/window/framed/prison/reinforced/hull,
/turf/open/floor/plating,
/area/prison/maintenance/residential/access/north)
"h" = (
/turf/closed/wall/r_wall/prison_unmeltable,
/area/prison/cellblock/highsec/north/south)

(1,1,1) = {"
b
b
e
b
b
g
b
"}
(2,1,1) = {"
c
c
c
c
c
a
a
"}
(3,1,1) = {"
c
c
c
c
c
a
a
"}
(4,1,1) = {"
c
c
c
c
c
a
a
"}
(5,1,1) = {"
c
c
c
c
c
a
a
"}
(6,1,1) = {"
c
c
c
c
c
a
a
"}
(7,1,1) = {"
c
c
c
c
c
a
a
"}
(8,1,1) = {"
c
c
c
c
c
a
a
"}
(9,1,1) = {"
c
c
c
c
c
a
a
"}
(10,1,1) = {"
c
c
c
c
c
a
a
"}
(11,1,1) = {"
c
c
c
c
c
a
a
"}
(12,1,1) = {"
c
c
c
c
c
a
a
"}
(13,1,1) = {"
c
c
c
c
c
a
a
"}
(14,1,1) = {"
c
c
c
c
c
a
a
"}
(15,1,1) = {"
c
c
c
c
c
a
a
"}
(16,1,1) = {"
c
c
c
c
c
a
a
"}
(17,1,1) = {"
c
c
c
c
c
a
a
"}
(18,1,1) = {"
c
c
c
c
c
a
a
"}
(19,1,1) = {"
b
d
f
b
b
h
h
"}
