"avN" = (/turf/closed/wall/prison,/area/prison/residential/north)
"axE" = (/obj/machinery/door/airlock/almayer/generic{dir = 2; name = "Bedroom"},/turf/open/floor/wood,/area/prison/residential/north)
"avl" = (/turf/closed/wall/r_wall/prison_unmeltable,/area/prison/residential/north)
"aab" = (/turf/open/space,/area/space)
"axI" = (/turf/closed/wall/r_wall/prison_unmeltable,/area/prison/maintenance/residential/access/north)
"axJ" = (/turf/closed/wall/prison,/area/prison/maintenance/residential/access/north)
"ayi" = (/obj/machinery/atmospherics/pipe/simple/hidden/scrubbers{tag = "icon-intact-scrubbers (EAST)"; icon_state = "intact-scrubbers"; dir = 4},/turf/open/floor/wood,/area/prison/residential/north)
"ayo" = (/obj/machinery/atmospherics/unary/vent_scrubber{dir = 8},/turf/open/floor/wood,/area/prison/residential/north)
"avm" = (/obj/structure/window/framed/prison/reinforced/hull,/turf/open/floor/plating,/area/prison/residential/north)
"ayp" = (/obj/structure/window/framed/prison/reinforced/hull,/turf/open/floor/plating,/area/prison/maintenance/residential/access/north)
"ayq" = (/obj/structure/table/reinforced,/obj/item/device/flashlight/lamp{on = 0},/turf/open/floor/prison{tag = "icon-darkredfull2 (SOUTHWEST)"; icon_state = "darkredfull2"; dir = 10},/area/prison/maintenance/residential/access/north)
"ayr" = (/obj/machinery/light/small{dir = 1},/turf/open/floor/prison{dir = 9; icon_state = "darkred2"},/area/prison/maintenance/residential/access/north)
"ays" = (/turf/open/floor/prison{dir = 5; icon_state = "darkred2"},/area/prison/maintenance/residential/access/north)
"ayt" = (/obj/machinery/door/airlock/almayer/security/glass{name = "Security Booth"},/turf/open/floor/prison{tag = "icon-darkredfull2 (SOUTHWEST)"; icon_state = "darkredfull2"; dir = 10},/area/prison/maintenance/residential/access/north)
"azk" = (/obj/structure/bed/chair/comfy{dir = 4},/turf/open/floor/carpet,/area/prison/residential/north)
"azg" = (/turf/open/floor/carpet,/area/prison/residential/north)
"axb" = (/turf/open/floor/wood,/area/prison/residential/north)
"azm" = (/obj/structure/table/reinforced,/obj/machinery/computer/security{network = list("PRISON")},/turf/open/floor/prison{tag = "icon-darkredfull2 (SOUTHWEST)"; icon_state = "darkredfull2"; dir = 10},/area/prison/maintenance/residential/access/north)
"azn" = (/obj/structure/bed/chair/office/dark{dir = 8},/turf/open/floor/prison{dir = 10; icon_state = "darkred2"},/area/prison/maintenance/residential/access/north)
"azo" = (/turf/open/floor/prison{dir = 6; icon_state = "darkred2"},/area/prison/maintenance/residential/access/north)
"azp" = (/obj/structure/window/framed/prison/reinforced,/turf/open/floor/plating,/area/prison/maintenance/residential/access/north)
"axa" = (/obj/structure/bookcase,/turf/open/floor/wood,/area/prison/residential/north)
"azX" = (/turf/open/floor/plating,/area/prison/maintenance/residential/access/north)
"azY" = (/obj/effect/decal/warning_stripes{icon_state = "E"; tag = "icon-E"},/turf/open/floor/plating,/area/prison/maintenance/residential/access/north)
"avP" = (/obj/machinery/door/poddoor/almayer{density = 0; dir = 4; icon_state = "pdoor0"; name = "Civilian Residences Emergency Access"; opacity = 0},/turf/open/floor/plating,/area/prison/maintenance/residential/access/north)
"aAa" = (/obj/effect/decal/warning_stripes{tag = "icon-W"; icon_state = "W"},/turf/open/floor/plating,/area/prison/maintenance/residential/access/north)
"aAb" = (/obj/machinery/light{dir = 1},/turf/open/floor/plating,/area/prison/maintenance/residential/access/north)
"awT" = (/obj/machinery/alarm/almayer{dir = 1},/turf/open/floor/plating,/area/prison/maintenance/residential/access/north)
"aAc" = (/obj/machinery/power/apc{dir = 1; pixel_y = 24; start_charge = 0},/obj/structure/cable{d2 = 2; icon_state = "0-2"; pixel_y = 0},/turf/open/floor/plating,/area/prison/maintenance/residential/access/north)
"aAQ" = (/obj/machinery/atmospherics/pipe/simple/hidden/supply{dir = 6; icon_state = "intact-supply"; tag = "icon-intact-supply (EAST)"},/obj/machinery/atmospherics/pipe/simple/hidden/scrubbers{dir = 6},/obj/structure/cable{d1 = 2; d2 = 4; icon_state = "2-4"},/turf/open/floor/plating,/area/prison/maintenance/residential/access/north)
"aBa" = (/obj/machinery/atmospherics/pipe/simple/hidden/supply{tag = "icon-intact-supply (EAST)"; icon_state = "intact-supply"; dir = 4},/obj/machinery/atmospherics/pipe/simple/hidden/scrubbers{tag = "icon-intact-scrubbers (EAST)"; icon_state = "intact-scrubbers"; dir = 4},/obj/structure/cable{d1 = 4; d2 = 8; icon_state = "4-8"; pixel_x = 0},/turf/open/floor/plating,/area/prison/maintenance/residential/access/north)
"aAS" = (/obj/effect/decal/warning_stripes{icon_state = "E"; tag = "icon-E"},/obj/machinery/atmospherics/pipe/simple/hidden/supply{tag = "icon-intact-supply (EAST)"; icon_state = "intact-supply"; dir = 4},/obj/machinery/atmospherics/pipe/simple/hidden/scrubbers{tag = "icon-intact-scrubbers (EAST)"; icon_state = "intact-scrubbers"; dir = 4},/obj/structure/cable{d1 = 4; d2 = 8; icon_state = "4-8"; pixel_x = 0},/turf/open/floor/plating,/area/prison/maintenance/residential/access/north)
"ayl" = (/obj/machinery/atmospherics/pipe/simple/hidden/supply{tag = "icon-intact-supply (EAST)"; icon_state = "intact-supply"; dir = 4},/obj/machinery/atmospherics/pipe/simple/hidden/scrubbers{tag = "icon-intact-scrubbers (EAST)"; icon_state = "intact-scrubbers"; dir = 4},/obj/structure/cable{d1 = 4; d2 = 8; icon_state = "4-8"; pixel_x = 0},/obj/machinery/door/poddoor/almayer{density = 0; dir = 4; icon_state = "pdoor0"; name = "Civilian Residences Emergency Access"; opacity = 0},/turf/open/floor/plating,/area/prison/maintenance/residential/access/north)
"aAU" = (/obj/effect/decal/warning_stripes{tag = "icon-W"; icon_state = "W"},/obj/machinery/atmospherics/pipe/simple/hidden/supply{tag = "icon-intact-supply (EAST)"; icon_state = "intact-supply"; dir = 4},/obj/machinery/atmospherics/pipe/simple/hidden/scrubbers{tag = "icon-intact-scrubbers (EAST)"; icon_state = "intact-scrubbers"; dir = 4},/obj/structure/cable{d1 = 4; d2 = 8; icon_state = "4-8"; pixel_x = 0},/turf/open/floor/plating,/area/prison/maintenance/residential/access/north)
"aAV" = (/obj/machinery/atmospherics/pipe/simple/hidden/scrubbers{tag = "icon-intact-scrubbers (EAST)"; icon_state = "intact-scrubbers"; dir = 4},/obj/machinery/atmospherics/pipe/manifold/hidden/supply{dir = 1},/obj/structure/cable{d1 = 4; d2 = 8; icon_state = "4-8"; pixel_x = 0},/turf/open/floor/plating,/area/prison/maintenance/residential/access/north)
"aAW" = (/obj/machinery/atmospherics/pipe/simple/hidden/supply{tag = "icon-intact-supply (EAST)"; icon_state = "intact-supply"; dir = 4},/obj/machinery/atmospherics/pipe/manifold/hidden/scrubbers{dir = 1},/obj/structure/cable{d1 = 4; d2 = 8; icon_state = "4-8"; pixel_x = 0},/turf/open/floor/plating,/area/prison/maintenance/residential/access/north)
"aAX" = (/obj/machinery/atmospherics/pipe/simple/hidden/supply{tag = "icon-intact-supply (EAST)"; icon_state = "intact-supply"; dir = 4},/obj/machinery/atmospherics/pipe/simple/hidden/scrubbers{tag = "icon-intact-scrubbers (EAST)"; icon_state = "intact-scrubbers"; dir = 4},/obj/structure/cable{d1 = 1; d2 = 4; icon_state = "1-4"},/obj/structure/cable{d1 = 4; d2 = 8; icon_state = "4-8"; pixel_x = 0},/turf/open/floor/plating,/area/prison/maintenance/residential/access/north)
"aBb" = (/obj/machinery/atmospherics/pipe/simple/hidden/supply{tag = "icon-intact-supply (EAST)"; icon_state = "intact-supply"; dir = 4},/obj/machinery/atmospherics/pipe/simple/hidden/scrubbers{tag = "icon-intact-scrubbers (EAST)"; icon_state = "intact-scrubbers"; dir = 4},/obj/structure/cable{d1 = 4; d2 = 8; icon_state = "4-8"; pixel_x = 0},/obj/machinery/door/airlock/almayer/maint{name = "North Civilian Residences Access"},/turf/open/floor/plating,/area/prison/maintenance/residential/access/north)
"aCc" = (/obj/machinery/atmospherics/pipe/simple/hidden/supply,/obj/machinery/atmospherics/pipe/simple/hidden/scrubbers,/obj/effect/landmark{name = "hunter_primary"},/obj/structure/cable{d1 = 1; d2 = 2; icon_state = "1-2"},/turf/open/floor/plating,/area/prison/maintenance/residential/access/north)
"aCd" = (/obj/machinery/atmospherics/unary/vent_pump{dir = 1; on = 1},/turf/open/floor/plating,/area/prison/maintenance/residential/access/north)
"aCe" = (/obj/machinery/atmospherics/unary/vent_scrubber{dir = 1},/turf/open/floor/plating,/area/prison/maintenance/residential/access/north)
"aCf" = (/obj/machinery/door/airlock/almayer/maint{name = "North Civilian Residences Access"},/turf/open/floor/plating,/area/prison/maintenance/residential/access/north)
"aEI" = (/obj/machinery/atmospherics/pipe/simple/hidden/supply{tag = "icon-intact-supply (EAST)"; icon_state = "intact-supply"; dir = 4},/obj/machinery/atmospherics/pipe/simple/hidden/scrubbers{tag = "icon-intact-scrubbers (EAST)"; icon_state = "intact-scrubbers"; dir = 4},/obj/machinery/door/airlock/almayer/maint{name = "North Civilian Residences Access"},/obj/structure/cable{d1 = 4; d2 = 8; icon_state = "4-8"; pixel_x = 0},/turf/open/floor/plating,/area/prison/maintenance/residential/access/north)
"aEK" = (/obj/machinery/atmospherics/pipe/simple/hidden/supply{dir = 9; icon_state = "intact-supply"; tag = "icon-intact-supply (EAST)"},/obj/machinery/atmospherics/pipe/simple/hidden/scrubbers{dir = 9},/obj/structure/cable{d1 = 1; d2 = 8; icon_state = "1-8"; tag = ""},/turf/open/floor/plating,/area/prison/maintenance/residential/access/north)
"aDN" = (/obj/effect/decal/warning_stripes{icon_state = "NE-out"; tag = "icon-NE-out"},/turf/open/floor/plating,/area/prison/maintenance/residential/access/north)
"acL" = (/obj/structure/lattice,/turf/open/space,/area/space)
"aEN" = (/turf/closed/wall/r_wall/prison_unmeltable,/area/prison/cellblock/highsec/north/south)
"aEO" = (/obj/structure/bed,/turf/open/floor/prison{tag = "icon-floor_plate (SOUTHWEST)"; icon_state = "floor_plate"; dir = 10},/area/prison/cellblock/highsec/north/south)
"aEP" = (/obj/machinery/light/small{dir = 1},/turf/open/floor/plating/plating_catwalk/prison,/area/prison/cellblock/highsec/north/south)
"aEQ" = (/turf/open/floor/prison{tag = "icon-cell_stripe (EAST)"; icon_state = "cell_stripe"; dir = 4},/area/prison/cellblock/highsec/north/south)
"aIs" = (/obj/machinery/door/airlock/prison{density = 0; icon_state = "door_open"; opacity = 0},/turf/open/floor/prison{icon_state = "redfull"},/area/prison/cellblock/highsec/north/south)
"aGa" = (/obj/structure/sink{dir = 8; icon_state = "sink"; pixel_x = -12; tag = "icon-sink (WEST)"},/turf/open/floor/prison{tag = "icon-floor_plate (SOUTHWEST)"; icon_state = "floor_plate"; dir = 10},/area/prison/cellblock/highsec/north/south)
"aGb" = (/turf/open/floor/prison{tag = "icon-floor_plate (SOUTHWEST)"; icon_state = "floor_plate"; dir = 10},/area/prison/cellblock/highsec/north/south)
"aGc" = (/obj/structure/toilet{dir = 8; pixel_x = -4},/turf/open/floor/prison{tag = "icon-cell_stripe (EAST)"; icon_state = "cell_stripe"; dir = 4},/area/prison/cellblock/highsec/north/south)
"aEV" = (/obj/structure/window/framed/prison/cell,/turf/open/floor/plating,/area/prison/cellblock/highsec/north/south)
(1,1,1) = {"
avNaxEavNavlaabaabaabaabaabaabaabaabaabaabaabaabaabaabaabaabaabaabaabaabaabaabaxIaxJaxJaxJaxJ
ayiayiayoavmaabaabaabaabaabaabaabaabaabaabaabaabaabaabaabaabaabaabaabaabaabaabaypayqayraysayt
azkazgaxbaxIaxIaxIaxIaxIaxIaxIaypaypaypaxIaypaypaypaxIaypaypaypaxIaypaypaypaxIaxIazmaznazoazp
azkazgaxaaxJazXazXazXazYavPaAaazXazXazXazXazXazXazXaAbazXazXazXawTazXazXazXaAcaxJazpazpazpaxJ
axJaxJaxJaxJazXaAQaBaaASaylaAUaBaaBaaBaaAVaBaaBaaBaaBaaBaaBaaBaaAWaBaaBaaBaaAXaBaaBaaBaaBaaBb
axJazXazXazXazXaCcazXazYavPaAaazXazXazXaCdazXazXazXazXazXazXazXaCeazXazXazXazXazXazXazXazXaCf
aEIaBaaBaaBaaBaaEKazXaDNaxIaxIaypaypaypaxIaypaypaypaxIaypaypaypaxIaypaypaypaxIaxIaxJaxJaxJaxJ
aCfazXazXazXazXazXazXazXaypaabaabaabaabaabaabaabaabaabaabaabaabaabaabaabaabacLaENaEOaEPaEQaIs
axJaxJaxJaxJaxJaxJaxJaxIaxIacLacLacLacLacLacLacLacLacLacLacLacLacLacLacLacLacLaENaGaaGbaGcaEV
"}

