"a" = (/obj/machinery/atmospherics/pipe/simple/hidden/scrubbers,/obj/machinery/atmospherics/pipe/simple/hidden/supply,/obj/structure/cable{d1 = 1; d2 = 2; icon_state = "1-2"},/turf/open/floor/prison{dir = 1; icon_state = "rampbottom"},/area/prison/maintenance/hangar_barracks)
"b" = (/turf/closed/wall/r_wall/prison_unmeltable,/area/prison/maintenance/hangar_barracks)
"c" = (/obj/structure/cable{d1 = 1; d2 = 8; icon_state = "1-8"},/obj/machinery/atmospherics/pipe/simple/hidden/supply,/obj/machinery/atmospherics/pipe/simple/hidden/scrubbers,/turf/open/floor/plating,/area/prison/maintenance/hangar_barracks)
"d" = (/obj/machinery/light/small{dir = 4},/obj/machinery/atmospherics/pipe/simple/hidden/scrubbers,/obj/machinery/atmospherics/pipe/simple/hidden/supply,/obj/structure/cable{d1 = 1; d2 = 2; icon_state = "1-2"},/turf/open/floor/plating,/area/prison/maintenance/hangar_barracks)
"e" = (/turf/closed/wall/r_wall/prison_unmeltable,/area/prison/security/checkpoint/hangar)
"f" = (/turf/open/space,/area/space)
"h" = (/turf/closed/wall/r_wall/prison_unmeltable,/area/prison/toilet/security)
"q" = (/obj/structure/largecrate/random,/obj/machinery/atmospherics/pipe/simple/hidden/scrubbers{dir = 9},/obj/machinery/atmospherics/pipe/simple/hidden/supply{dir = 9; icon_state = "intact-supply"; tag = "icon-intact-supply (EAST)"},/turf/open/floor/plating,/area/prison/maintenance/hangar_barracks)
"w" = (/obj/structure/largecrate/random,/turf/open/floor/plating,/area/prison/maintenance/hangar_barracks)
"z" = (/turf/closed/wall/prison,/area/prison/maintenance/hangar_barracks)
"E" = (/obj/machinery/disposal,/obj/machinery/light{dir = 1},/obj/structure/disposalpipe/trunk,/turf/open/floor/prison{dir = 5; icon_state = "darkred2"},/area/prison/security)
"J" = (/obj/structure/disposalpipe/segment,/turf/open/floor/prison{dir = 4; icon_state = "darkred2"},/area/prison/security)

(1,1,1) = {"
abeeeeee
dbffffff
cbffffff
qbffffff
wbffffff
zbffffff
Ebffffff
Jhhhhhhh
"}
