//MAP CONVERTED BY dmm2tgm.py THIS HEADER COMMENT PREVENTS RECONVERSION, DO NOT REMOVE
"aaa" = (
/obj/structure/pipes/standard/simple/hidden/scrubbers{
	tag = "icon-intact-scrubbers (NORTHEAST)";
	icon_state = "intact-scrubbers";
	dir = 5
	},
/obj/structure/pipes/standard/manifold/hidden/supply,
/obj/structure/cable{
	d1 = 1;
	d2 = 4;
	icon_state = "1-4"
	},
/turf/open/floor/prison,
/turf/open/floor/plating/plating_catwalk/prison,
/area/prison/security/monitoring/highsec)
"aab" = (
/turf/open/space,
/area/space)
"aac" = (
/obj/structure/pipes/standard/simple/hidden/supply{
	tag = "icon-intact-supply (EAST)";
	icon_state = "intact-supply";
	dir = 4
	},
/obj/structure/pipes/standard/simple/hidden/scrubbers{
	tag = "icon-intact-scrubbers (EAST)";
	icon_state = "intact-scrubbers";
	dir = 4
	},
/obj/structure/cable{
	d1 = 4;
	d2 = 8;
	icon_state = "4-8";
	pixel_x = 0
	},
/turf/open/floor/prison,
/turf/open/floor/plating/plating_catwalk/prison,
/area/prison/security/monitoring/highsec)
"aad" = (
/obj/structure/lattice,
/obj/structure/grille,
/turf/open/space,
/area/space)
"aae" = (
/obj/structure/monorail,
/turf/open/space,
/area/space)
"acL" = (
/obj/structure/lattice,
/turf/open/space,
/area/space)
"aWz" = (
/turf/closed/wall/r_wall/prison_unmeltable,
/area/prison/security/monitoring/highsec)
"aYX" = (
/obj/structure/window/framed/prison/reinforced/hull,
/turf/open/floor/plating,
/area/prison/security/monitoring/highsec)
"blU" = (
/obj/structure/pipes/standard/simple/hidden/supply{
	dir = 6;
	icon_state = "intact-supply";
	tag = "icon-intact-supply (EAST)"
	},
/turf/open/floor/prison{
	dir = 8;
	icon_state = "red"
	},
/area/prison/security/monitoring/highsec)
"bmZ" = (
/obj/structure/pipes/vents/pump{
	dir = 1 
	},
/turf/open/floor/prison{
	dir = 10;
	icon_state = "red"
	},
/area/prison/security/monitoring/highsec)
"bqb" = (
/turf/closed/wall/prison,
/area/prison/monorail/west)
"bqc" = (
/obj/structure/machinery/door/airlock/multi_tile/almayer/generic{
	name = "Monorail Station West"
	},
/turf/open/floor/prison{
	dir = 9;
	icon_state = "greenfull"
	},
/area/prison/monorail/west)
"bqd" = (
/obj/structure/pipes/standard/simple/hidden/supply,
/obj/structure/pipes/standard/simple/hidden/scrubbers,
/obj/structure/cable{
	d1 = 1;
	d2 = 2;
	icon_state = "1-2"
	},
/turf/open/floor/prison{
	dir = 9;
	icon_state = "greenfull"
	},
/area/prison/monorail/west)
"bqF" = (
/obj/structure/flora/pottedplant,
/turf/open/floor/prison{
	dir = 9;
	icon_state = "greenfull"
	},
/area/prison/monorail/west)
"bqG" = (
/turf/open/floor/prison{
	dir = 9;
	icon_state = "green"
	},
/area/prison/monorail/west)
"bqH" = (
/obj/structure/pipes/standard/simple/hidden/supply,
/obj/structure/pipes/standard/simple/hidden/scrubbers,
/obj/structure/cable{
	d1 = 1;
	d2 = 2;
	icon_state = "1-2"
	},
/turf/open/floor/prison{
	dir = 5;
	icon_state = "green"
	},
/area/prison/monorail/west)
"bqI" = (
/obj/structure/machinery/vending/snack,
/turf/open/floor/prison{
	dir = 9;
	icon_state = "greenfull"
	},
/area/prison/monorail/west)
"bqK" = (
/turf/open/floor/prison{
	icon_state = "red"
	},
/area/prison/security/monitoring/highsec)
"bry" = (
/turf/open/floor/prison{
	dir = 8;
	icon_state = "green"
	},
/area/prison/monorail/west)
"brz" = (
/obj/structure/pipes/standard/simple/hidden/supply,
/obj/structure/pipes/standard/simple/hidden/scrubbers,
/obj/structure/cable{
	d1 = 1;
	d2 = 2;
	icon_state = "1-2"
	},
/turf/open/floor/prison{
	dir = 4;
	icon_state = "green"
	},
/area/prison/monorail/west)
"brA" = (
/obj/structure/machinery/vending/cola,
/turf/open/floor/prison{
	dir = 9;
	icon_state = "greenfull"
	},
/area/prison/monorail/west)
"bsk" = (
/obj/structure/bed/chair/comfy{
	dir = 4
	},
/turf/open/floor/prison{
	dir = 9;
	icon_state = "greenfull"
	},
/area/prison/monorail/west)
"bsl" = (
/turf/open/floor/prison{
	dir = 9;
	icon_state = "greenfull"
	},
/area/prison/monorail/west)
"bsm" = (
/turf/closed/wall/r_wall/prison_unmeltable,
/area/prison/monorail/west)
"bta" = (
/obj/structure/bed/chair/comfy{
	dir = 4
	},
/obj/structure/machinery/light{
	icon_state = "tube1";
	dir = 8
	},
/turf/open/floor/prison{
	dir = 9;
	icon_state = "greenfull"
	},
/area/prison/monorail/west)
"btb" = (
/turf/open/floor/prison{
	tag = "icon-cell_stripe (EAST)";
	icon_state = "cell_stripe";
	dir = 4
	},
/area/prison/monorail/west)
"btc" = (
/obj/structure/window/framed/prison/reinforced/hull,
/turf/open/floor/plating,
/area/prison/monorail/west)
"btd" = (
/obj/structure/monorail,
/obj/structure/lattice,
/turf/open/space,
/area/space)
"buD" = (
/obj/structure/machinery/door/airlock/almayer/generic,
/obj/structure/machinery/door/poddoor/shutters/transit,
/turf/open/floor/prison,
/area/prison/monorail/west)
"bvt" = (
/obj/structure/pipes/standard/manifold/hidden/supply{
	dir = 8
	},
/obj/structure/pipes/standard/simple/hidden/scrubbers,
/obj/structure/cable{
	d1 = 1;
	d2 = 2;
	icon_state = "1-2"
	},
/turf/open/floor/prison{
	dir = 4;
	icon_state = "green"
	},
/area/prison/monorail/west)
"bvu" = (
/obj/structure/pipes/vents/pump{
	dir = 8 
	},
/turf/open/floor/prison{
	tag = "icon-cell_stripe (EAST)";
	icon_state = "cell_stripe";
	dir = 4
	},
/area/prison/monorail/west)
"bxN" = (
/turf/closed/wall/r_wall/prison_unmeltable,
/area/prison/maintenance/residential/se)
"bxQ" = (
/obj/effect/alien/weeds/node,
/turf/open/floor/prison{
	dir = 8;
	icon_state = "green"
	},
/area/prison/monorail/west)
"byt" = (
/obj/structure/machinery/door/airlock/almayer/maint,
/obj/structure/pipes/standard/simple/hidden/supply{
	tag = "icon-intact-supply (EAST)";
	icon_state = "intact-supply";
	dir = 4
	},
/obj/structure/pipes/standard/simple/hidden/scrubbers{
	tag = "icon-intact-scrubbers (EAST)";
	icon_state = "intact-scrubbers";
	dir = 4
	},
/obj/structure/cable{
	d1 = 4;
	d2 = 8;
	icon_state = "4-8";
	pixel_x = 0
	},
/turf/open/floor/plating,
/area/prison/maintenance/residential/se)
"byu" = (
/obj/structure/pipes/standard/simple/hidden/supply{
	tag = "icon-intact-supply (EAST)";
	icon_state = "intact-supply";
	dir = 4
	},
/obj/structure/pipes/standard/simple/hidden/scrubbers{
	tag = "icon-intact-scrubbers (EAST)";
	icon_state = "intact-scrubbers";
	dir = 4
	},
/obj/structure/cable{
	d1 = 4;
	d2 = 8;
	icon_state = "4-8";
	pixel_x = 0
	},
/obj/structure/cable{
	d1 = 2;
	d2 = 4;
	icon_state = "2-4"
	},
/turf/open/floor/prison{
	dir = 9;
	icon_state = "greenfull"
	},
/area/prison/monorail/west)
"byv" = (
/obj/structure/pipes/standard/simple/hidden/supply{
	tag = "icon-intact-supply (EAST)";
	icon_state = "intact-supply";
	dir = 4
	},
/obj/structure/pipes/standard/simple/hidden/scrubbers{
	tag = "icon-intact-scrubbers (EAST)";
	icon_state = "intact-scrubbers";
	dir = 4
	},
/obj/structure/cable{
	d1 = 4;
	d2 = 8;
	icon_state = "4-8";
	pixel_x = 0
	},
/turf/open/floor/prison{
	dir = 8;
	icon_state = "green"
	},
/area/prison/monorail/west)
"byw" = (
/obj/structure/pipes/standard/simple/hidden/supply{
	dir = 9;
	icon_state = "intact-supply";
	tag = "icon-intact-supply (EAST)"
	},
/obj/structure/pipes/standard/manifold/hidden/scrubbers{
	dir = 4
	},
/obj/structure/cable{
	d1 = 1;
	d2 = 8;
	icon_state = "1-8"
	},
/turf/open/floor/prison{
	dir = 4;
	icon_state = "green"
	},
/area/prison/monorail/west)
"bzv" = (
/turf/closed/wall/prison,
/area/prison/maintenance/residential/se)
"bzw" = (
/obj/structure/cable{
	d1 = 1;
	d2 = 2;
	icon_state = "1-2"
	},
/turf/open/floor/prison{
	dir = 9;
	icon_state = "greenfull"
	},
/area/prison/monorail/west)
"bzx" = (
/obj/structure/pipes/standard/simple/hidden/scrubbers{
	tag = "icon-intact-scrubbers (NORTHEAST)";
	icon_state = "intact-scrubbers";
	dir = 5
	},
/turf/open/floor/prison{
	dir = 4;
	icon_state = "green"
	},
/area/prison/monorail/west)
"bzy" = (
/obj/structure/pipes/vents/scrubber{
	dir = 8
	},
/turf/open/floor/prison{
	tag = "icon-cell_stripe (EAST)";
	icon_state = "cell_stripe";
	dir = 4
	},
/area/prison/monorail/west)
"bAV" = (
/obj/structure/cable,
/obj/structure/machinery/power/apc{
	dir = 8;
	pixel_x = -24;
	start_charge = 0
	},
/turf/open/floor/prison{
	dir = 9;
	icon_state = "greenfull"
	},
/area/prison/monorail/west)
"bAW" = (
/turf/open/floor/prison{
	dir = 4;
	icon_state = "green"
	},
/area/prison/monorail/west)
"bDC" = (
/turf/open/floor/prison{
	dir = 10;
	icon_state = "green"
	},
/area/prison/monorail/west)
"bDD" = (
/turf/open/floor/prison{
	dir = 6;
	icon_state = "green"
	},
/area/prison/monorail/west)
"bHd" = (
/obj/structure/lattice,
/obj/structure/lattice,
/turf/open/space,
/area/space)

(1,1,1) = {"
bqb
bqb
bqb
bqb
bqb
bqb
bqb
bqb
bsm
bsm
bxN
byt
bzv
bxN
bsm
bsm
bsm
aab
aab
aab
aab
"}
(2,1,1) = {"
bqb
bqF
bsk
bsk
bta
bsk
bsk
bsk
bsk
bsk
bta
byu
bzw
bAV
bsl
bsl
bsm
aab
aab
aab
aab
"}
(3,1,1) = {"
bqc
bqG
bry
bxQ
bry
bry
bry
bry
bry
bry
bxQ
byv
bry
bry
bry
bDC
btc
aab
aab
aab
aab
"}
(4,1,1) = {"
bqd
bqH
brz
brz
brz
brz
brz
bvt
brz
brz
brz
byw
bzx
bAW
bAW
bDD
btc
aab
aab
aab
aab
"}
(5,1,1) = {"
bqb
bqI
brA
bsl
btb
btb
btb
bvu
btb
btb
btb
btb
bzy
btb
btb
btb
bsm
aab
aab
aab
aab
"}
(6,1,1) = {"
aWz
aWz
aWz
bsm
btc
btc
btc
buD
btc
btc
btc
btc
btc
btc
buD
btc
bsm
aab
aab
aab
aab
"}
(7,1,1) = {"
blU
bmZ
aWz
aad
aab
aab
aab
aab
aab
aab
aab
aab
aab
aab
aab
aab
acL
aab
aab
aab
aab
"}
(8,1,1) = {"
aaa
bqK
aWz
aad
acL
acL
acL
acL
acL
acL
acL
acL
acL
acL
acL
acL
acL
acL
acL
acL
acL
"}
(9,1,1) = {"
aac
bqK
aWz
aad
btd
btd
btd
btd
btd
btd
btd
btd
btd
btd
btd
aae
aae
aae
btd
btd
btd
"}
(10,1,1) = {"
aac
bqK
aWz
aad
acL
acL
acL
acL
acL
acL
acL
acL
acL
acL
acL
acL
acL
acL
bHd
acL
acL
"}
(11,1,1) = {"
aac
bqK
aWz
aad
aab
aab
aab
aab
aab
aab
aab
aab
aab
aab
aab
aab
aab
aab
acL
aab
aab
"}
(12,1,1) = {"
aac
bqK
aYX
acL
aab
aab
aab
aab
aab
aab
aab
aab
aab
aab
aab
aab
aab
aab
acL
aab
aab
"}
