//MAP CONVERTED BY dmm2tgm.py THIS HEADER COMMENT PREVENTS RECONVERSION, DO NOT REMOVE
"ag" = (
/obj/structure/flora/pottedplant{
	icon_state = "pottedplant_10"
	},
/turf/open/floor/plating/platingdmg3,
/area/lv624/lazarus/medbay)
"bS" = (
/obj/effect/landmark/corpsespawner/doctor,
/obj/effect/decal/cleanable/blood,
/obj/item/weapon/gun/pistol/holdout,
/turf/open/floor/whiteblue/east,
/area/lv624/lazarus/medbay)
"cN" = (
/obj/structure/window_frame/colony,
/obj/item/shard,
/turf/open/floor/white,
/area/lv624/lazarus/medbay)
"dc" = (
/obj/effect/decal/cleanable/blood/drip,
/turf/open/floor/plating/platingdmg3,
/area/lv624/lazarus/medbay)
"fR" = (
/obj/structure/machinery/medical_pod/bodyscanner,
/obj/item/device/radio/intercom{
	freerange = 1;
	frequency = 1469;
	name = "General Listening Channel";
	pixel_y = 28
	},
/turf/open/floor/whitebluefull,
/area/lv624/lazarus/medbay)
"gs" = (
/turf/open/floor/whitebluecorner/east,
/area/lv624/lazarus/medbay)
"gK" = (
/obj/structure/machinery/door/airlock/multi_tile/almayer/medidoor/colony{
	dir = 2;
	name = "\improper Medical Bay"
	},
/turf/open/floor/white,
/area/lv624/lazarus/medbay)
"hE" = (
/obj/item/storage/firstaid,
/turf/open/floor/white,
/area/lv624/lazarus/medbay)
"ia" = (
/turf/open/floor/whiteblue/north,
/area/lv624/lazarus/medbay)
"iV" = (
/obj/structure/girder,
/turf/open/floor/platingdmg1,
/area/lv624/lazarus/medbay)
"jC" = (
/obj/item/storage/firstaid/toxin,
/obj/structure/barricade/wooden,
/turf/open/floor/white,
/area/lv624/lazarus/medbay)
"jY" = (
/obj/structure/flora/jungle/planttop1,
/turf/open/gm/grass/grass1,
/area/lv624/ground/jungle/north_jungle)
"kg" = (
/obj/structure/flora/jungle/plantbot1,
/turf/open/gm/grass/grass1,
/area/lv624/ground/colony/south_medbay_road)
"kl" = (
/obj/effect/landmark/crap_item,
/turf/open/floor/white,
/area/lv624/lazarus/medbay)
"kD" = (
/obj/structure/flora/jungle/planttop1,
/turf/open/gm/grass/grass1,
/area/lv624/ground/colony/south_medbay_road)
"nv" = (
/obj/structure/closet/wardrobe,
/obj/structure/machinery/light{
	dir = 8
	},
/obj/effect/landmark/objective_landmark/science,
/turf/open/floor/plating/platingdmg3,
/area/lv624/lazarus/medbay)
"nG" = (
/obj/structure/fence,
/turf/open/gm/dirtgrassborder/north,
/area/lv624/ground/colony/south_medbay_road)
"og" = (
/turf/open/gm/dirt,
/area/lv624/ground/colony/south_medbay_road)
"on" = (
/obj/structure/barricade/wooden,
/turf/open/floor/damaged3/west,
/area/lv624/lazarus/medbay)
"oE" = (
/obj/item/stack/sheet/metal,
/turf/open/floor/plating/platingdmg3,
/area/lv624/lazarus/medbay)
"pd" = (
/obj/structure/flora/pottedplant{
	icon_state = "pottedplant_10"
	},
/turf/open/floor/whitebluefull,
/area/lv624/lazarus/medbay)
"pJ" = (
/obj/item/reagent_container/hypospray,
/turf/open/floor/white,
/area/lv624/lazarus/medbay)
"qk" = (
/obj/structure/surface/table,
/obj/item/reagent_container/spray,
/obj/effect/landmark/item_pool_spawner/survivor_ammo/buckshot,
/turf/open/floor/plating/platingdmg3,
/area/lv624/lazarus/medbay)
"qO" = (
/turf/open/floor/white,
/area/lv624/lazarus/medbay)
"qR" = (
/obj/structure/filingcabinet,
/obj/structure/machinery/light,
/obj/effect/landmark/objective_landmark/science,
/turf/open/floor/damaged5/west,
/area/lv624/lazarus/medbay)
"rV" = (
/turf/open/floor/platingdmg1,
/area/lv624/lazarus/medbay)
"rZ" = (
/obj/structure/flora/bush/ausbushes/var3/fernybush,
/turf/open/gm/grass/grass1,
/area/lv624/ground/jungle/north_west_jungle)
"se" = (
/obj/structure/flora/bush/ausbushes/genericbush,
/turf/open/gm/grass/grass1,
/area/lv624/ground/jungle/north_west_jungle)
"sx" = (
/turf/open/floor/plating/platingdmg3,
/area/lv624/lazarus/medbay)
"tO" = (
/obj/item/stack/medical/ointment,
/obj/structure/machinery/light{
	dir = 1
	},
/turf/open/floor/plating/platingdmg3,
/area/lv624/lazarus/medbay)
"uM" = (
/obj/effect/landmark/objective_landmark/close,
/turf/open/floor/white,
/area/lv624/lazarus/medbay)
"vG" = (
/obj/structure/surface/table,
/obj/item/stack/medical/bruise_pack{
	pixel_x = 3;
	pixel_y = 3
	},
/turf/open/floor/plating/platingdmg3,
/area/lv624/lazarus/medbay)
"xe" = (
/obj/structure/fence,
/turf/open/gm/dirtgrassborder/west,
/area/lv624/ground/colony/south_medbay_road)
"xM" = (
/turf/open/gm/dirtgrassborder/north,
/area/lv624/ground/colony/south_medbay_road)
"xN" = (
/obj/structure/machinery/power/apc/directional/no_power/north,
/turf/open/floor/white,
/area/lv624/lazarus/medbay)
"ya" = (
/obj/effect/decal/cleanable/blood,
/obj/effect/landmark/corpsespawner/doctor,
/turf/open/floor/plating/platingdmg3,
/area/lv624/lazarus/medbay)
"yb" = (
/obj/structure/surface/table,
/obj/effect/landmark/item_pool_spawner/survivor_ammo/buckshot,
/turf/open/floor/plating/platingdmg3,
/area/lv624/lazarus/medbay)
"ym" = (
/obj/structure/flora/jungle/plantbot1,
/turf/open/gm/grass/grass1,
/area/lv624/ground/jungle/north_jungle)
"yU" = (
/obj/structure/girder,
/turf/closed/wall,
/area/lv624/lazarus/medbay)
"zd" = (
/obj/structure/machinery/medical_pod/sleeper,
/turf/open/floor/whitebluefull,
/area/lv624/lazarus/medbay)
"zj" = (
/obj/effect/landmark/crap_item,
/turf/open/gm/dirt,
/area/lv624/ground/colony/south_medbay_road)
"zS" = (
/obj/structure/flora/bush/ausbushes/lavendergrass,
/turf/open/gm/grass/grass1,
/area/lv624/ground/jungle/north_west_jungle)
"Au" = (
/obj/item/device/radio/intercom{
	freerange = 1;
	frequency = 1469;
	name = "General Listening Channel";
	pixel_y = 28
	},
/turf/open/floor/platingdmg1,
/area/lv624/lazarus/medbay)
"AR" = (
/obj/structure/surface/table,
/obj/item/paper_bin{
	pixel_y = 4
	},
/obj/item/tool/pen,
/turf/open/floor/plating/platingdmg3,
/area/lv624/lazarus/medbay)
"Be" = (
/obj/structure/fence,
/turf/open/gm/dirtgrassborder/grassdirt_corner/north_west,
/area/lv624/ground/colony/south_medbay_road)
"Bn" = (
/turf/open/gm/grass/grass1,
/area/lv624/ground/colony/south_medbay_road)
"Bq" = (
/obj/structure/surface/table,
/turf/open/floor/plating/platingdmg3,
/area/lv624/lazarus/medbay)
"Bt" = (
/obj/structure/girder,
/turf/open/floor/plating/platingdmg3,
/area/lv624/lazarus/medbay)
"Bu" = (
/obj/structure/machinery/cm_vending/sorted/medical/no_access,
/turf/open/floor/whitebluefull,
/area/lv624/lazarus/medbay)
"BB" = (
/obj/effect/decal/cleanable/blood/drip,
/turf/open/floor/platingdmg1,
/area/lv624/lazarus/medbay)
"BO" = (
/obj/effect/landmark/objective_landmark/medium,
/turf/open/floor/white,
/area/lv624/lazarus/medbay)
"CH" = (
/obj/item/reagent_container/food/drinks/cans/waterbottle{
	pixel_x = 2
	},
/turf/open/floor/white,
/area/lv624/lazarus/medbay)
"DC" = (
/obj/effect/landmark/crap_item,
/obj/structure/barricade/wooden,
/turf/open/floor/white,
/area/lv624/lazarus/medbay)
"ET" = (
/obj/structure/surface/table,
/obj/item/storage/box/masks{
	pixel_x = -4
	},
/obj/item/storage/box/syringes{
	pixel_x = 5;
	pixel_y = 4
	},
/turf/open/floor/white,
/area/lv624/lazarus/medbay)
"Fh" = (
/obj/effect/decal/cleanable/blood/drip,
/turf/open/floor/plating/panelscorched,
/area/lv624/lazarus/medbay)
"Fk" = (
/turf/closed/wall,
/area/lv624/lazarus/medbay)
"Fl" = (
/obj/structure/machinery/light{
	dir = 1
	},
/turf/open/floor/platingdmg1,
/area/lv624/lazarus/medbay)
"Ha" = (
/obj/structure/flora/bush/ausbushes/var3/fernybush,
/turf/open/gm/grass/grass1,
/area/lv624/ground/jungle/north_jungle)
"HE" = (
/obj/structure/machinery/light,
/turf/open/floor/plating/platingdmg3,
/area/lv624/lazarus/medbay)
"Ia" = (
/obj/structure/window_frame/colony,
/turf/open/floor/plating/platingdmg3,
/area/lv624/lazarus/medbay)
"IS" = (
/obj/structure/machinery/door/airlock/multi_tile/almayer/medidoor/colony,
/turf/open/floor/white,
/area/lv624/lazarus/medbay)
"JE" = (
/turf/open/gm/grass/grass1,
/area/lv624/ground/jungle/north_west_jungle)
"Km" = (
/obj/structure/flora/bush/ausbushes/reedbush,
/turf/open/gm/grass/grass1,
/area/lv624/ground/jungle/north_west_jungle)
"KC" = (
/obj/effect/decal/cleanable/blood,
/turf/open/floor/damaged5/west,
/area/lv624/lazarus/medbay)
"KX" = (
/obj/structure/machinery/bioprinter,
/turf/open/floor/whitebluefull,
/area/lv624/lazarus/medbay)
"Ma" = (
/obj/structure/machinery/light{
	dir = 1
	},
/turf/open/floor/whiteblue/northeast,
/area/lv624/lazarus/medbay)
"Ms" = (
/obj/structure/barricade/wooden,
/turf/open/floor/white,
/area/lv624/lazarus/medbay)
"MD" = (
/turf/open/floor/whitebluefull,
/area/lv624/lazarus/medbay)
"Nk" = (
/obj/item/tool/kitchen/utensil/fork,
/turf/open/floor/platingdmg1,
/area/lv624/lazarus/medbay)
"NA" = (
/obj/effect/landmark/corpsespawner/doctor,
/obj/effect/decal/cleanable/blood,
/turf/open/floor/white,
/area/lv624/lazarus/medbay)
"NH" = (
/obj/structure/surface/table,
/obj/structure/machinery/light{
	dir = 4
	},
/obj/structure/transmitter/colony_net/rotary{
	phone_category = "Lazarus Landing";
	phone_id = "Medbay"
	},
/turf/open/floor/plating/platingdmg3,
/area/lv624/lazarus/medbay)
"OU" = (
/obj/structure/window_frame/colony,
/obj/item/shard,
/turf/open/floor/plating/platingdmg3,
/area/lv624/lazarus/medbay)
"Pd" = (
/obj/item/trash/cigbutt,
/turf/open/gm/dirt,
/area/lv624/ground/colony/south_medbay_road)
"Pe" = (
/turf/open/floor/damaged5/west,
/area/lv624/lazarus/medbay)
"Qd" = (
/turf/open/floor,
/area/lv624/lazarus/medbay)
"Qk" = (
/obj/structure/machinery/optable,
/obj/item/tank/anesthetic,
/turf/open/floor/whitebluefull,
/area/lv624/lazarus/medbay)
"Rl" = (
/obj/effect/landmark/crap_item,
/turf/open/floor/plating/panelscorched,
/area/lv624/lazarus/medbay)
"RA" = (
/obj/structure/machinery/body_scanconsole,
/turf/open/floor/whitebluefull,
/area/lv624/lazarus/medbay)
"RG" = (
/obj/structure/machinery/iv_drip,
/obj/structure/barricade/wooden,
/turf/open/floor/whiteblue/southeast,
/area/lv624/lazarus/medbay)
"St" = (
/obj/effect/landmark/crap_item,
/obj/effect/decal/cleanable/blood,
/turf/open/floor/damaged5/west,
/area/lv624/lazarus/medbay)
"SX" = (
/turf/open/floor/plating/panelscorched,
/area/lv624/lazarus/medbay)
"Tr" = (
/obj/structure/surface/table,
/obj/item/stack/medical/bruise_pack{
	pixel_x = 3;
	pixel_y = 3
	},
/obj/item/clothing/mask/surgical,
/obj/structure/machinery/light{
	dir = 1
	},
/obj/item/storage/belt/medical/full,
/obj/effect/landmark/objective_landmark/medium,
/turf/open/floor/white,
/area/lv624/lazarus/medbay)
"Um" = (
/turf/open/floor/damaged3/west,
/area/lv624/lazarus/medbay)
"Ve" = (
/obj/structure/surface/table/reinforced,
/obj/item/storage/surgical_tray,
/obj/item/reagent_container/spray/cleaner{
	desc = "Someone has crossed out the Space from Space Cleaner and written in Surgery. 'Do not remove under punishment of death!!!' is scrawled on the back.";
	name = "Surgery Cleaner"
	},
/turf/open/floor/whitebluefull,
/area/lv624/lazarus/medbay)
"Vt" = (
/obj/item/clothing/under/colonist,
/obj/effect/decal/cleanable/blood/drip,
/turf/open/floor/platingdmg1,
/area/lv624/lazarus/medbay)
"Vz" = (
/obj/structure/surface/table,
/obj/item/clothing/glasses/hud/health,
/obj/effect/landmark/crap_item,
/obj/item/reagent_container/spray/cleaner,
/turf/open/floor/white,
/area/lv624/lazarus/medbay)
"WM" = (
/obj/item/stack/sheet/metal,
/obj/effect/decal/cleanable/blood/drip,
/turf/open/floor/plating/platingdmg3,
/area/lv624/lazarus/medbay)
"Xp" = (
/obj/item/stack/sheet/metal,
/obj/effect/decal/cleanable/blood,
/obj/effect/landmark/corpsespawner/engineer,
/turf/open/floor/plating/platingdmg3,
/area/lv624/lazarus/medbay)
"Xr" = (
/obj/item/device/radio/intercom{
	freerange = 1;
	frequency = 1469;
	name = "General Listening Channel";
	pixel_y = 28
	},
/turf/open/floor/plating/platingdmg3,
/area/lv624/lazarus/medbay)
"XA" = (
/turf/open/gm/grass/grass1,
/area/lv624/ground/jungle/north_jungle)
"XJ" = (
/turf/closed/wall/r_wall,
/area/lv624/lazarus/medbay)
"Yg" = (
/obj/effect/landmark/crap_item,
/turf/open/floor/plating/platingdmg3,
/area/lv624/lazarus/medbay)
"Yv" = (
/obj/structure/machinery/sleep_console,
/obj/structure/extinguisher_cabinet{
	pixel_y = 30
	},
/turf/open/floor/whitebluefull,
/area/lv624/lazarus/medbay)
"ZR" = (
/obj/structure/bed/chair/office/dark{
	dir = 4
	},
/turf/open/floor/damaged5/west,
/area/lv624/lazarus/medbay)

(1,1,1) = {"
XA
XA
XA
XA
XA
XA
XA
XA
XA
JE
JE
zS
JE
JE
Km
JE
JE
"}
(2,1,1) = {"
XA
XA
XA
XA
XA
XA
XA
XA
XA
XA
JE
JE
JE
JE
JE
JE
JE
"}
(3,1,1) = {"
XA
XA
XA
Ha
XA
XJ
OU
OU
WM
oE
Fk
JE
JE
rZ
JE
JE
se
"}
(4,1,1) = {"
XA
XA
XJ
XJ
XJ
XJ
ag
oE
Xp
ag
Fk
cN
cN
Fk
Be
xe
xe
"}
(5,1,1) = {"
XA
XA
XJ
Vz
ET
Fk
Fk
Xr
rV
rV
nv
qk
yb
Ia
xM
og
og
"}
(6,1,1) = {"
XA
XA
XJ
Tr
qO
jC
iV
tO
rV
sx
Vt
dc
sx
sx
xM
og
og
"}
(7,1,1) = {"
XA
XJ
XJ
xN
BO
DC
IS
sx
Yg
ya
sx
sx
HE
Fk
Bt
og
og
"}
(8,1,1) = {"
XA
XJ
zd
qO
pJ
Ms
qO
qO
qO
rV
Nk
sx
Rl
SX
cN
og
og
"}
(9,1,1) = {"
XA
XJ
Yv
qO
qO
Bu
Fk
ia
Pe
MD
Pe
NA
Fh
Fh
IS
og
og
"}
(10,1,1) = {"
XA
XJ
fR
qO
qO
KX
yU
rV
rV
MD
BB
Um
SX
Pe
qO
og
Pd
"}
(11,1,1) = {"
XA
XJ
RA
gs
kl
Ms
IS
rV
qO
hE
NA
CH
SX
Pe
cN
og
og
"}
(12,1,1) = {"
XA
XJ
XJ
ia
uM
on
qO
KC
qO
Um
Pe
Pe
qR
yU
SX
og
og
"}
(13,1,1) = {"
XA
XA
XJ
Ma
bS
RG
Bt
Fl
Pe
Pe
St
ZR
Bq
oE
xM
og
og
"}
(14,1,1) = {"
XA
XA
XJ
Ve
Qk
Fk
Fk
Au
Pe
Pe
NH
vG
AR
Ia
xM
og
og
"}
(15,1,1) = {"
XA
XA
XJ
XJ
XJ
XJ
Pe
rV
rV
pd
Bt
OU
OU
Fk
nG
og
og
"}
(16,1,1) = {"
XA
XA
XA
XA
XA
XJ
XJ
qO
gK
XJ
XJ
Bn
Bn
Bn
nG
og
og
"}
(17,1,1) = {"
XA
XA
jY
ym
XA
XA
XJ
Qd
Qd
XJ
Bn
kD
kg
Bn
nG
og
zj
"}
