//MAP CONVERTED BY dmm2tgm.py THIS HEADER COMMENT PREVENTS RECONVERSION, DO NOT REMOVE
"ae" = (
/turf/closed/wall/r_wall,
/area/lv624/lazarus/medbay)
"af" = (
/turf/closed/wall,
/area/lv624/lazarus/medbay)
"ai" = (
/obj/structure/machinery/medical_pod/sleeper,
/turf/open/floor{
	icon_state = "whitebluefull"
	},
/area/lv624/lazarus/medbay)
"aj" = (
/obj/structure/machinery/sleep_console,
/obj/structure/extinguisher_cabinet{
	pixel_y = 30
	},
/turf/open/floor{
	icon_state = "whitebluefull"
	},
/area/lv624/lazarus/medbay)
"an" = (
/obj/structure/surface/table,
/obj/item/clothing/glasses/hud/health,
/obj/effect/landmark/crap_item,
/obj/item/reagent_container/spray/cleaner,
/turf/open/floor{
	icon_state = "whitebluefull"
	},
/area/lv624/lazarus/medbay)
"ao" = (
/obj/structure/surface/table,
/obj/item/stack/medical/bruise_pack{
	pixel_x = 3;
	pixel_y = 3
	},
/obj/item/clothing/mask/surgical,
/obj/structure/machinery/light{
	dir = 1
	},
/obj/item/storage/belt/medical/full,
/obj/effect/landmark/objective_landmark/close,
/turf/open/floor{
	dir = 1;
	icon_state = "whiteblue"
	},
/area/lv624/lazarus/medbay)
"ap" = (
/obj/structure/machinery/medical_pod/bodyscanner,
/obj/item/device/radio/intercom{
	freerange = 1;
	frequency = 1469;
	name = "General Listening Channel";
	pixel_y = 28
	},
/turf/open/floor{
	icon_state = "whitebluefull"
	},
/area/lv624/lazarus/medbay)
"aq" = (
/turf/open/floor{
	icon_state = "white"
	},
/area/lv624/lazarus/medbay)
"ar" = (
/turf/open/floor{
	dir = 1;
	icon_state = "whiteblue"
	},
/area/lv624/lazarus/medbay)
"as" = (
/obj/structure/machinery/light{
	dir = 1
	},
/obj/effect/decal/cleanable/blood,
/obj/item/storage/surgical_tray,
/turf/open/floor{
	dir = 5;
	icon_state = "whiteblue"
	},
/area/lv624/lazarus/medbay)
"at" = (
/obj/structure/surface/table/reinforced,
/obj/effect/landmark/objective_landmark/medium,
/turf/open/floor{
	icon_state = "whitebluefull"
	},
/area/lv624/lazarus/medbay)
"au" = (
/turf/open/auto_turf/snow/layer2,
/area/lv624/ground/jungle/north_jungle)
"av" = (
/turf/open/floor{
	dir = 8;
	icon_state = "whiteblue"
	},
/area/lv624/lazarus/medbay)
"aw" = (
/obj/item/reagent_container/hypospray,
/turf/open/floor{
	icon_state = "white"
	},
/area/lv624/lazarus/medbay)
"az" = (
/obj/effect/landmark/crap_item,
/turf/open/floor{
	icon_state = "white"
	},
/area/lv624/lazarus/medbay)
"aA" = (
/obj/effect/decal/cleanable/blood/drip,
/turf/open/floor{
	icon_state = "white"
	},
/area/lv624/lazarus/medbay)
"aB" = (
/obj/item/reagent_container/spray/cleaner{
	desc = "Someone has crossed out the Space from Space Cleaner and written in Surgery. 'Do not remove under punishment of death!!!' is scrawled on the back.";
	name = "Surgery Cleaner"
	},
/turf/open/floor{
	dir = 4;
	icon_state = "whiteblue"
	},
/area/lv624/lazarus/medbay)
"aC" = (
/obj/structure/machinery/optable,
/obj/item/tank/anesthetic,
/obj/effect/decal/cleanable/blood,
/obj/effect/landmark/corpsespawner/scientist,
/turf/open/floor{
	icon_state = "whitebluefull"
	},
/area/lv624/lazarus/medbay)
"aI" = (
/obj/structure/machinery/cm_vending/sorted/medical/no_access,
/turf/open/floor{
	icon_state = "whitebluefull"
	},
/area/lv624/lazarus/medbay)
"aJ" = (
/obj/structure/machinery/bioprinter,
/turf/open/floor{
	icon_state = "whitebluefull"
	},
/area/lv624/lazarus/medbay)
"aO" = (
/obj/structure/bed,
/obj/item/bedsheet/medical,
/turf/open/floor{
	icon_state = "whitebluefull"
	},
/area/lv624/lazarus/medbay)
"aP" = (
/obj/item/device/radio/intercom{
	freerange = 1;
	frequency = 1469;
	name = "General Listening Channel";
	pixel_y = 28
	},
/turf/open/floor{
	dir = 1;
	icon_state = "whiteblue"
	},
/area/lv624/lazarus/medbay)
"aU" = (
/obj/structure/machinery/light{
	dir = 1
	},
/turf/open/floor{
	dir = 1;
	icon_state = "whiteblue"
	},
/area/lv624/lazarus/medbay)
"aX" = (
/turf/open/floor,
/area/lv624/lazarus/medbay)
"aY" = (
/obj/item/clothing/under/colonist,
/turf/open/floor{
	icon_state = "white"
	},
/area/lv624/lazarus/medbay)
"bb" = (
/obj/structure/machinery/vending/coffee,
/turf/open/floor{
	dir = 1;
	icon_state = "whiteblue"
	},
/area/lv624/lazarus/medbay)
"bc" = (
/obj/structure/machinery/door/airlock/multi_tile/almayer/medidoor/colony{
	dir = 2;
	name = "\improper Medical Bay"
	},
/turf/open/floor{
	icon_state = "white"
	},
/area/lv624/lazarus/medbay)
"bg" = (
/turf/open/floor{
	icon_state = "whitebluecorner"
	},
/area/lv624/lazarus/medbay)
"bi" = (
/obj/effect/decal/cleanable/blood/drip,
/turf/open/floor{
	dir = 1;
	icon_state = "whitebluecorner"
	},
/area/lv624/lazarus/medbay)
"bk" = (
/obj/structure/machinery/vending/snack,
/turf/open/floor{
	dir = 1;
	icon_state = "whiteblue"
	},
/area/lv624/lazarus/medbay)
"bo" = (
/obj/structure/window_frame/colony,
/turf/open/floor{
	icon_state = "white"
	},
/area/lv624/lazarus/medbay)
"bp" = (
/obj/structure/machinery/cm_vending/sorted/medical/blood,
/obj/structure/machinery/light,
/turf/open/floor{
	icon_state = "whiteblue"
	},
/area/lv624/lazarus/medbay)
"bq" = (
/obj/structure/bed,
/obj/effect/decal/cleanable/blood,
/obj/effect/landmark/corpsespawner/engineer,
/turf/open/floor{
	icon_state = "whitebluefull"
	},
/area/lv624/lazarus/medbay)
"bs" = (
/obj/item/tool/kitchen/utensil/fork,
/turf/open/floor{
	icon_state = "white"
	},
/area/lv624/lazarus/medbay)
"bu" = (
/obj/item/tool/crowbar,
/turf/open/floor{
	dir = 1;
	icon_state = "whiteblue"
	},
/area/lv624/lazarus/medbay)
"bx" = (
/obj/item/trash/plate,
/turf/open/floor{
	icon_state = "white"
	},
/area/lv624/lazarus/medbay)
"by" = (
/obj/effect/landmark/corpsespawner/doctor,
/obj/effect/decal/cleanable/blood,
/turf/open/floor{
	icon_state = "white"
	},
/area/lv624/lazarus/medbay)
"bA" = (
/obj/structure/surface/table,
/obj/item/paper_bin{
	pixel_y = 4
	},
/obj/item/tool/pen,
/turf/open/floor{
	icon_state = "white"
	},
/area/lv624/lazarus/medbay)
"bB" = (
/obj/effect/landmark/crap_item,
/turf/open/floor{
	dir = 8;
	icon_state = "whitebluecorner"
	},
/area/lv624/lazarus/medbay)
"bI" = (
/obj/item/trash/cigbutt,
/turf/open/auto_turf/snow/layer0,
/area/lv624/ground/colony/south_medbay_road)
"bK" = (
/obj/effect/landmark/crap_item,
/turf/open/auto_turf/snow/layer0,
/area/lv624/ground/colony/south_medbay_road)
"bN" = (
/obj/effect/decal/cleanable/blood/xeno,
/turf/open/floor{
	dir = 10;
	icon_state = "whiteblue"
	},
/area/lv624/lazarus/medbay)
"io" = (
/obj/item/stack/medical/ointment,
/obj/structure/machinery/light{
	dir = 1
	},
/turf/open/floor{
	dir = 1;
	icon_state = "whiteblue"
	},
/area/lv624/lazarus/medbay)
"mA" = (
/obj/structure/window/framed/colony,
/turf/open/floor{
	icon_state = "white"
	},
/area/lv624/lazarus/medbay)
"pc" = (
/obj/structure/bed/chair/office/dark{
	dir = 4
	},
/turf/open/floor{
	icon_state = "white"
	},
/area/lv624/lazarus/medbay)
"qr" = (
/obj/structure/surface/table,
/obj/item/reagent_container/spray,
/obj/effect/landmark/item_pool_spawner/survivor_ammo/buckshot,
/turf/open/floor{
	dir = 8;
	icon_state = "whiteblue"
	},
/area/lv624/lazarus/medbay)
"qC" = (
/turf/open/floor{
	dir = 4;
	icon_state = "whitebluecorner"
	},
/area/lv624/lazarus/medbay)
"qP" = (
/obj/structure/machinery/power/apc{
	dir = 1;
	name = "Medbay APC";
	pixel_y = 30;
	start_charge = 0
	},
/obj/effect/landmark/corpsespawner/colonist/random/burst,
/obj/effect/decal/cleanable/blood,
/turf/open/floor{
	dir = 1;
	icon_state = "whiteblue"
	},
/area/lv624/lazarus/medbay)
"tr" = (
/obj/item/storage/firstaid/toxin,
/turf/open/floor{
	dir = 10;
	icon_state = "whiteblue"
	},
/area/lv624/lazarus/medbay)
"us" = (
/obj/structure/filingcabinet,
/obj/structure/machinery/light,
/obj/effect/landmark/objective_landmark/science,
/turf/open/floor{
	icon_state = "whiteblue"
	},
/area/lv624/lazarus/medbay)
"uD" = (
/obj/item/storage/firstaid,
/turf/open/floor{
	icon_state = "white"
	},
/area/lv624/lazarus/medbay)
"vC" = (
/obj/item/frame/table,
/obj/effect/decal/cleanable/blood/xeno,
/turf/open/floor{
	icon_state = "whitebluefull"
	},
/area/lv624/lazarus/medbay)
"wz" = (
/obj/structure/fence,
/turf/open/auto_turf/snow/layer0,
/area/lv624/ground/colony/south_medbay_road)
"yd" = (
/turf/open/floor{
	dir = 6;
	icon_state = "whiteblue"
	},
/area/lv624/lazarus/medbay)
"zF" = (
/obj/structure/machinery/cm_vending/sorted/medical/no_access,
/turf/open/floor{
	icon_state = "whiteblue"
	},
/area/lv624/lazarus/medbay)
"AO" = (
/obj/effect/decal/cleanable/blood/xeno,
/turf/open/floor{
	icon_state = "white"
	},
/area/lv624/lazarus/medbay)
"CZ" = (
/obj/item/bedsheet/medical,
/obj/effect/landmark/objective_landmark/medium,
/turf/open/floor{
	icon_state = "white"
	},
/area/lv624/lazarus/medbay)
"DR" = (
/obj/structure/surface/table,
/obj/item/stack/medical/bruise_pack{
	pixel_x = 3;
	pixel_y = 3
	},
/turf/open/floor{
	dir = 4;
	icon_state = "whiteblue"
	},
/area/lv624/lazarus/medbay)
"En" = (
/obj/structure/surface/table,
/obj/item/storage/box/masks{
	pixel_x = -4
	},
/obj/item/storage/box/syringes{
	pixel_x = 5;
	pixel_y = 4
	},
/turf/open/floor{
	icon_state = "whitebluefull"
	},
/area/lv624/lazarus/medbay)
"ES" = (
/turf/open/auto_turf/snow/layer0,
/area/lv624/ground/colony/south_medbay_road)
"Gu" = (
/obj/structure/closet/wardrobe,
/obj/structure/machinery/light{
	dir = 8
	},
/turf/open/floor{
	dir = 8;
	icon_state = "whiteblue"
	},
/area/lv624/lazarus/medbay)
"JK" = (
/obj/structure/surface/table,
/obj/item/reagent_container/food/drinks/cans/waterbottle,
/obj/item/tool/kitchen/utensil/knife{
	pixel_x = 8;
	pixel_y = 6
	},
/turf/open/floor{
	icon_state = "whitebluefull"
	},
/area/lv624/lazarus/medbay)
"Le" = (
/obj/structure/machinery/iv_drip,
/turf/open/floor{
	dir = 6;
	icon_state = "whiteblue"
	},
/area/lv624/lazarus/medbay)
"LQ" = (
/turf/open/auto_turf/snow/layer2,
/area/lv624/ground/jungle/north_west_jungle)
"Pe" = (
/turf/open/auto_turf/snow/layer2,
/area/lv624/ground/colony/south_medbay_road)
"Pi" = (
/obj/structure/surface/table,
/obj/structure/machinery/light{
	dir = 4
	},
/obj/structure/transmitter/colony_net/rotary{
	phone_category = "Lazarus Landing";
	phone_id = "Medbay"
	},
/turf/open/floor{
	icon_state = "white"
	},
/area/lv624/lazarus/medbay)
"Qu" = (
/obj/structure/machinery/body_scanconsole,
/turf/open/floor{
	icon_state = "whitebluefull"
	},
/area/lv624/lazarus/medbay)
"QG" = (
/obj/item/reagent_container/food/drinks/cans/waterbottle{
	pixel_x = 2
	},
/turf/open/floor{
	icon_state = "white"
	},
/area/lv624/lazarus/medbay)
"QQ" = (
/obj/structure/surface/table,
/obj/effect/landmark/item_pool_spawner/survivor_ammo/buckshot,
/turf/open/floor{
	dir = 8;
	icon_state = "whiteblue"
	},
/area/lv624/lazarus/medbay)
"TK" = (
/obj/structure/machinery/door/airlock/multi_tile/almayer/medidoor/colony,
/turf/open/floor{
	icon_state = "white"
	},
/area/lv624/lazarus/medbay)
"Vq" = (
/obj/structure/surface/table,
/obj/effect/landmark/objective_landmark/science,
/turf/open/floor{
	icon_state = "whiteblue"
	},
/area/lv624/lazarus/medbay)
"VI" = (
/obj/structure/flora/pottedplant{
	icon_state = "pottedplant_10"
	},
/turf/open/floor{
	icon_state = "whitebluefull"
	},
/area/lv624/lazarus/medbay)
"YV" = (
/turf/open/floor{
	dir = 8;
	icon_state = "whitebluecorner"
	},
/area/lv624/lazarus/medbay)

(1,1,1) = {"
au
au
au
au
au
au
au
au
au
LQ
LQ
LQ
LQ
LQ
LQ
LQ
LQ
"}
(2,1,1) = {"
au
au
au
au
au
au
au
au
au
au
LQ
LQ
LQ
LQ
LQ
LQ
LQ
"}
(3,1,1) = {"
au
au
au
au
au
ae
mA
mA
bo
mA
af
LQ
LQ
LQ
LQ
LQ
LQ
"}
(4,1,1) = {"
au
au
ae
ae
ae
ae
VI
aO
bq
VI
af
mA
mA
af
wz
wz
wz
"}
(5,1,1) = {"
au
au
ae
an
En
af
af
aP
CZ
YV
Gu
qr
QQ
mA
ES
ES
ES
"}
(6,1,1) = {"
au
au
ae
ao
av
tr
af
io
aq
aq
aY
aq
zF
mA
ES
ES
ES
"}
(7,1,1) = {"
au
ae
ae
qP
aq
az
TK
aq
az
aq
aq
aq
bp
af
af
ES
ES
"}
(8,1,1) = {"
au
ae
ai
bi
aw
aq
aq
aq
aq
aq
bs
bx
bB
bN
bo
ES
ES
"}
(9,1,1) = {"
au
ae
aj
aA
aA
aI
af
bb
aq
vC
bu
by
aq
aq
TK
ES
ES
"}
(10,1,1) = {"
au
ae
ap
aq
aq
aJ
af
bk
aq
JK
ar
aq
aq
aq
aq
ES
bI
"}
(11,1,1) = {"
au
ae
Qu
qC
az
aq
TK
aq
aq
uD
aq
QG
bg
yd
mA
ES
ES
"}
(12,1,1) = {"
au
ae
ae
ar
aA
AO
aq
aq
aq
aq
aq
aq
us
af
af
ES
ES
"}
(13,1,1) = {"
au
au
ae
as
aB
Le
af
aU
aq
aq
az
pc
Vq
mA
ES
ES
ES
"}
(14,1,1) = {"
au
au
ae
at
aC
af
af
aP
aq
bg
Pi
DR
bA
mA
ES
ES
ES
"}
(15,1,1) = {"
au
au
ae
ae
ae
ae
VI
aq
aq
VI
af
mA
mA
af
wz
ES
ES
"}
(16,1,1) = {"
au
au
au
au
au
ae
ae
aq
bc
ae
ae
Pe
Pe
Pe
wz
ES
ES
"}
(17,1,1) = {"
au
au
au
au
au
au
ae
aX
aX
ae
Pe
Pe
Pe
Pe
wz
ES
bK
"}
