//MAP CONVERTED BY dmm2tgm.py THIS HEADER COMMENT PREVENTS RECONVERSION, DO NOT REMOVE
"a" = (
/turf/closed/wall/almayer/outer,
/area/tyrargo/oob)
"g" = (
/turf/open/floor/almayer_hull/outerhull_dir/west,
/area/tyrargo/oob)
"z" = (
/turf/open/floor/almayer_hull/outerhull_dir/north,
/area/tyrargo/oob)
"A" = (
/turf/open/floor/almayer_hull/outerhull_dir/northeast,
/area/tyrargo/oob)
"D" = (
/turf/open/floor/almayer_hull/outerhull_dir/east,
/area/tyrargo/oob)
"N" = (
/turf/open/floor/almayer_hull/outerhull_dir/southwest,
/area/tyrargo/oob)
"R" = (
/turf/open/floor/almayer_hull/outerhull_dir/northwest,
/area/tyrargo/oob)
"S" = (
/turf/open/floor/almayer_hull,
/area/tyrargo/oob)
"U" = (
/turf/open/floor/almayer_hull/outerhull_dir/southeast,
/area/tyrargo/oob)
"X" = (
/turf/open/floor/almayer_hull/outerhull_dir,
/area/tyrargo/oob)
"Z" = (
/turf/template_noop,
/area/template_noop)

(1,1,1) = {"
Z
Z
Z
a
a
a
a
Z
Z
Z
Z
Z
Z
Z
Z
Z
Z
Z
Z
Z
Z
Z
Z
Z
Z
Z
Z
Z
Z
Z
Z
Z
Z
Z
Z
"}
(2,1,1) = {"
a
a
a
a
R
N
a
a
a
a
a
a
Z
Z
Z
Z
Z
Z
Z
Z
Z
Z
Z
Z
Z
Z
Z
Z
Z
Z
Z
Z
Z
Z
Z
"}
(3,1,1) = {"
a
R
g
g
S
S
g
g
g
g
N
a
a
Z
Z
Z
Z
Z
Z
Z
Z
Z
Z
Z
Z
Z
Z
Z
Z
Z
Z
Z
Z
Z
Z
"}
(4,1,1) = {"
a
z
S
S
S
S
S
S
S
S
S
N
a
Z
Z
Z
Z
Z
Z
Z
a
a
a
a
a
a
a
a
a
a
a
a
Z
Z
Z
"}
(5,1,1) = {"
a
z
S
S
S
S
S
S
S
S
S
X
a
Z
Z
Z
Z
Z
Z
a
a
R
g
g
g
g
g
g
g
g
N
a
a
a
a
"}
(6,1,1) = {"
a
z
S
S
S
S
S
S
S
S
S
X
a
a
Z
Z
Z
Z
Z
a
R
S
S
S
S
S
S
S
S
S
S
g
g
N
a
"}
(7,1,1) = {"
a
z
S
S
S
S
S
S
S
S
S
X
a
a
a
a
a
a
a
a
z
S
S
S
S
S
S
S
S
S
S
S
S
X
a
"}
(8,1,1) = {"
a
z
S
S
S
S
S
S
S
S
S
S
g
g
g
g
g
g
g
g
S
S
S
S
S
S
S
S
S
S
S
S
S
X
a
"}
(9,1,1) = {"
a
z
S
S
S
S
S
S
S
S
S
S
S
S
S
S
S
S
S
S
S
S
S
S
S
S
S
S
S
S
S
S
S
X
a
"}
(10,1,1) = {"
a
z
S
S
S
S
S
S
S
S
S
S
S
S
S
S
S
S
S
S
S
S
S
S
S
S
S
S
S
S
S
S
S
X
a
"}
(11,1,1) = {"
a
z
S
S
S
S
S
S
S
S
S
S
S
S
S
S
S
S
S
S
S
S
S
S
S
S
S
S
S
S
S
S
S
X
a
"}
(12,1,1) = {"
a
z
S
S
S
S
S
S
S
S
S
S
D
D
D
D
D
D
D
D
S
S
S
S
S
S
S
S
S
S
S
S
S
X
a
"}
(13,1,1) = {"
a
z
S
S
S
S
S
S
S
S
S
X
a
a
a
a
a
a
a
a
z
S
S
S
S
S
S
S
S
S
S
S
S
X
a
"}
(14,1,1) = {"
a
z
S
S
S
S
S
S
S
S
S
X
a
a
Z
Z
Z
Z
Z
a
A
S
S
S
S
S
S
S
S
S
S
D
D
U
a
"}
(15,1,1) = {"
a
z
S
S
S
S
S
S
S
S
S
X
a
Z
Z
Z
Z
Z
Z
a
a
A
D
D
D
D
D
D
D
D
U
a
a
a
a
"}
(16,1,1) = {"
a
z
S
S
S
S
S
S
S
S
S
U
a
Z
Z
Z
Z
Z
Z
Z
a
a
a
a
a
a
a
a
a
a
a
a
Z
Z
Z
"}
(17,1,1) = {"
a
A
D
D
S
S
D
D
D
D
U
a
a
Z
Z
Z
Z
Z
Z
Z
Z
Z
Z
Z
Z
Z
Z
Z
Z
Z
Z
Z
Z
Z
Z
"}
(18,1,1) = {"
a
a
a
a
A
U
a
a
a
a
a
a
Z
Z
Z
Z
Z
Z
Z
Z
Z
Z
Z
Z
Z
Z
Z
Z
Z
Z
Z
Z
Z
Z
Z
"}
(19,1,1) = {"
Z
Z
Z
a
a
a
a
Z
Z
Z
Z
Z
Z
Z
Z
Z
Z
Z
Z
Z
Z
Z
Z
Z
Z
Z
Z
Z
Z
Z
Z
Z
Z
Z
Z
"}
