//MAP CONVERTED BY dmm2tgm.py THIS HEADER COMMENT PREVENTS RECONVERSION, DO NOT REMOVE
"g" = (
/turf/open/floor/almayer_hull/outerhull_dir/west,
/area/tyrargo/outdoors/outskirts/central)
"z" = (
/turf/open/floor/almayer_hull/outerhull_dir/north,
/area/tyrargo/outdoors/outskirts/central)
"A" = (
/turf/open/floor/almayer_hull/outerhull_dir/northeast,
/area/tyrargo/outdoors/outskirts/central)
"D" = (
/turf/open/floor/almayer_hull/outerhull_dir/east,
/area/tyrargo/outdoors/outskirts/central)
"N" = (
/turf/open/floor/almayer_hull/outerhull_dir/southwest,
/area/tyrargo/outdoors/outskirts/central)
"R" = (
/turf/open/floor/almayer_hull/outerhull_dir/northwest,
/area/tyrargo/outdoors/outskirts/central)
"S" = (
/turf/open/floor/almayer_hull,
/area/tyrargo/outdoors/outskirts/central)
"U" = (
/turf/open/floor/almayer_hull/outerhull_dir/southeast,
/area/tyrargo/outdoors/outskirts/central)
"X" = (
/turf/open/floor/almayer_hull/outerhull_dir,
/area/tyrargo/outdoors/outskirts/central)
"Z" = (
/turf/template_noop,
/area/template_noop)

(1,1,1) = {"
Z
Z
Z
Z
Z
Z
Z
Z
Z
Z
Z
Z
Z
Z
Z
Z
Z
Z
Z
Z
Z
Z
Z
Z
Z
Z
Z
Z
Z
Z
Z
Z
Z
Z
Z
"}
(2,1,1) = {"
Z
Z
Z
Z
R
N
Z
Z
Z
Z
Z
Z
Z
Z
Z
Z
Z
Z
Z
Z
Z
Z
Z
Z
Z
Z
Z
Z
Z
Z
Z
Z
Z
Z
Z
"}
(3,1,1) = {"
Z
g
g
g
S
S
g
g
g
g
N
Z
Z
Z
Z
Z
Z
Z
Z
Z
Z
Z
Z
Z
Z
Z
Z
Z
Z
Z
Z
Z
Z
Z
Z
"}
(4,1,1) = {"
Z
S
S
S
S
S
S
S
S
S
S
N
Z
Z
Z
Z
Z
Z
Z
Z
Z
Z
Z
Z
Z
Z
Z
Z
Z
Z
Z
Z
Z
Z
Z
"}
(5,1,1) = {"
Z
Z
Z
S
S
S
S
S
S
S
S
X
Z
Z
Z
Z
Z
Z
Z
Z
Z
R
g
g
g
g
g
g
g
g
N
Z
Z
Z
Z
"}
(6,1,1) = {"
Z
Z
Z
S
S
S
S
S
S
S
S
X
Z
Z
Z
Z
Z
Z
Z
Z
R
S
S
S
S
S
S
S
S
S
S
g
g
N
Z
"}
(7,1,1) = {"
Z
Z
S
S
S
S
S
S
S
S
S
X
Z
Z
Z
Z
Z
Z
Z
Z
z
S
S
S
S
S
S
S
S
S
S
S
S
X
Z
"}
(8,1,1) = {"
Z
S
S
S
S
S
S
S
S
S
S
S
g
g
g
g
g
g
g
g
S
S
S
S
S
S
S
S
S
S
S
S
S
X
Z
"}
(9,1,1) = {"
Z
Z
S
Z
S
S
S
S
S
S
S
S
S
S
S
S
S
S
S
S
S
S
S
S
S
S
S
S
S
S
S
S
S
X
Z
"}
(10,1,1) = {"
Z
Z
Z
Z
S
S
S
S
S
S
S
S
S
S
S
S
S
S
S
S
S
S
S
S
S
S
S
S
S
S
S
S
S
X
Z
"}
(11,1,1) = {"
Z
Z
S
S
S
S
S
S
S
S
S
S
S
S
S
S
S
S
S
S
S
S
S
S
S
S
S
S
S
S
S
S
S
X
Z
"}
(12,1,1) = {"
Z
S
S
S
S
S
S
S
S
S
S
S
D
D
D
D
D
D
D
D
S
S
S
S
S
S
S
S
S
S
S
S
S
X
Z
"}
(13,1,1) = {"
Z
Z
S
S
S
S
S
S
S
S
S
X
Z
Z
Z
Z
Z
Z
Z
Z
z
S
S
S
S
S
S
S
S
S
S
S
S
X
Z
"}
(14,1,1) = {"
Z
Z
Z
S
S
S
S
S
S
S
S
X
Z
Z
Z
Z
Z
Z
Z
Z
A
S
S
S
S
S
S
S
S
S
S
D
D
U
Z
"}
(15,1,1) = {"
Z
Z
S
S
S
S
S
S
S
S
S
X
Z
Z
Z
Z
Z
Z
Z
Z
Z
A
D
D
D
D
D
D
D
D
U
Z
Z
Z
Z
"}
(16,1,1) = {"
Z
Z
Z
S
S
S
S
S
S
S
S
U
Z
Z
Z
Z
Z
Z
Z
Z
Z
Z
Z
Z
Z
Z
Z
Z
Z
Z
Z
Z
Z
Z
Z
"}
(17,1,1) = {"
Z
Z
D
D
S
S
D
D
D
D
U
Z
Z
Z
Z
Z
Z
Z
Z
Z
Z
Z
Z
Z
Z
Z
Z
Z
Z
Z
Z
Z
Z
Z
Z
"}
(18,1,1) = {"
Z
Z
Z
Z
A
U
Z
Z
Z
Z
Z
Z
Z
Z
Z
Z
Z
Z
Z
Z
Z
Z
Z
Z
Z
Z
Z
Z
Z
Z
Z
Z
Z
Z
Z
"}
(19,1,1) = {"
Z
Z
Z
Z
Z
Z
Z
Z
Z
Z
Z
Z
Z
Z
Z
Z
Z
Z
Z
Z
Z
Z
Z
Z
Z
Z
Z
Z
Z
Z
Z
Z
Z
Z
Z
"}
