//MAP CONVERTED BY dmm2tgm.py THIS HEADER COMMENT PREVENTS RECONVERSION, DO NOT REMOVE
"a" = (
/obj/effect/decal/cleanable/dirt,
/obj/item/ammo_casing/bullet,
/turf/open/floor/corsat/red,
/area/tyrargo/underground/bunker/south)
"c" = (
/obj/effect/decal/cleanable/dirt,
/turf/open/floor/corsat/plate,
/area/tyrargo/underground/bunker/south)
"f" = (
/obj/structure/closet/crate/ammo{
	name = "soft-point munitions crate";
	desc = "Crate filled with soft-point ammo. Typically used when fighting onboard space stations, or when there's nothing better to use.";
	opened = 1
	},
/obj/effect/landmark/ammo_spawn/m41a_random_spawn{
	spawn_chance = 20
	},
/obj/effect/landmark/ammo_spawn/m41a_random_spawn{
	spawn_chance = 20
	},
/obj/effect/landmark/ammo_spawn/m41a_random_spawn{
	spawn_chance = 20
	},
/obj/effect/landmark/ammo_spawn/m41a_random_spawn{
	spawn_chance = 60
	},
/obj/effect/landmark/ammo_spawn/m41a_ext_random_spawn{
	spawn_chance = 20
	},
/obj/effect/landmark/ammo_spawn/m4ra_random_spawn{
	spawn_chance = 20
	},
/obj/effect/landmark/ammo_spawn/m4ra_random_spawn{
	spawn_chance = 20
	},
/obj/effect/landmark/ammo_spawn/m4ra_random_spawn{
	spawn_chance = 40
	},
/obj/effect/landmark/ammo_spawn/m4ra_random_spawn{
	spawn_chance = 40
	},
/obj/effect/landmark/ammo_spawn/m4ra_ext_random_spawn{
	spawn_chance = 20
	},
/turf/open/floor/corsat/plate,
/area/tyrargo/underground/bunker/south)
"g" = (
/turf/closed/wall/r_wall/bunker/floodgate{
	desc = "A huge chunk of reinforced metal used to separate rooms. This one appears to be specially reinforced.";
	name = "bunker superdense wall"
	},
/area/tyrargo/underground/bunker/south)
"l" = (
/obj/effect/decal/cleanable/dirt,
/obj/item/ammo_casing/bullet,
/obj/item/ammo_casing/bullet,
/turf/open/floor/corsat/plate,
/area/tyrargo/underground/bunker/south)
"o" = (
/turf/open/auto_turf/hybrisa_auto_turf/layer2,
/area/tyrargo/underground/bunker/south)
"p" = (
/turf/open/floor/corsat/red/east,
/area/tyrargo/underground/bunker/south)
"s" = (
/obj/effect/decal/cleanable/dirt,
/obj/item/ammo_casing/bullet,
/obj/item/ammo_casing/bullet,
/obj/item/ammo_casing/bullet,
/turf/open/floor/corsat/squares,
/area/tyrargo/underground/bunker/south)
"t" = (
/turf/closed/wall/r_wall/bunker,
/area/tyrargo/underground/bunker/south)
"v" = (
/obj/structure/machinery/light/small{
	dir = 8
	},
/obj/structure/prop/hybrisa/boulders/wide_boulderdark/wide_boulder1,
/turf/open/auto_turf/hybrisa_auto_turf/layer2,
/area/tyrargo/underground/bunker/south)
"w" = (
/obj/structure/machinery/light/small{
	dir = 1
	},
/turf/open/floor/corsat/box,
/area/tyrargo/underground/bunker/south)
"x" = (
/obj/effect/decal/cleanable/dirt,
/obj/item/ammo_casing/bullet,
/turf/open/floor/corsat/plate,
/area/tyrargo/underground/bunker/south)
"y" = (
/turf/open/floor/corsat/red,
/area/tyrargo/underground/bunker/south)
"z" = (
/turf/open/floor/corsat/red/southeast,
/area/tyrargo/underground/bunker/south)
"A" = (
/obj/structure/prop/hybrisa/boulders/smallboulderdark,
/turf/open/auto_turf/hybrisa_auto_turf/layer2,
/area/tyrargo/underground/bunker/south)
"B" = (
/obj/effect/decal/cleanable/dirt,
/obj/item/ammo_casing/bullet,
/obj/item/ammo_casing/bullet,
/obj/item/ammo_casing/bullet,
/turf/open/floor/corsat/plate,
/area/tyrargo/underground/bunker/south)
"E" = (
/obj/structure/prop/hybrisa/boulders/large_boulderdark,
/turf/open/auto_turf/hybrisa_auto_turf/layer2,
/area/tyrargo/underground/bunker/south)
"F" = (
/obj/structure/prop/hybrisa/boulders/large_boulderdark,
/obj/structure/prop/hybrisa/boulders/wide_boulderdark/wide_boulder1{
	pixel_y = -12
	},
/turf/open/auto_turf/hybrisa_auto_turf/layer2,
/area/tyrargo/underground/bunker/south)
"G" = (
/obj/structure/machinery/light/small,
/turf/open/floor/corsat/plate,
/area/tyrargo/underground/bunker/south)
"H" = (
/turf/closed/wall/strata_ice/forest/rock,
/area/tyrargo/oob)
"J" = (
/obj/effect/decal/cleanable/dirt,
/turf/open/floor/corsat/red/northeast,
/area/tyrargo/underground/bunker/south)
"K" = (
/turf/open/floor/corsat/box,
/area/tyrargo/underground/bunker/south)
"L" = (
/obj/structure/machinery/light/small{
	dir = 8
	},
/turf/open/floor/corsat/box,
/area/tyrargo/underground/bunker/south)
"M" = (
/obj/effect/decal/cleanable/dirt,
/turf/open/floor/corsat/arrow_east,
/area/tyrargo/underground/bunker/south)
"N" = (
/obj/effect/decal/cleanable/dirt,
/turf/open/floor/corsat/red/north,
/area/tyrargo/underground/bunker/south)
"O" = (
/obj/structure/prop/hybrisa/boulders,
/turf/open/auto_turf/hybrisa_auto_turf/layer2,
/area/tyrargo/underground/bunker/south)
"P" = (
/turf/open/floor/corsat/plate,
/area/tyrargo/underground/bunker/south)
"Q" = (
/obj/effect/decal/cleanable/dirt,
/obj/item/ammo_casing/bullet,
/turf/open/floor/corsat/redcorner,
/area/tyrargo/underground/bunker/south)
"R" = (
/obj/structure/prop/hybrisa/boulders/wide_boulderdark/wide_boulder1,
/turf/open/auto_turf/hybrisa_auto_turf/layer2,
/area/tyrargo/underground/bunker/south)
"S" = (
/obj/structure/surface/rack,
/obj/item/ammo_magazine/m56d{
	pixel_x = 4;
	pixel_y = 5;
	current_rounds = 5
	},
/obj/item/ammo_magazine/m56d{
	pixel_x = -9;
	pixel_y = 9;
	current_rounds = 45
	},
/turf/open/floor/corsat/plate,
/area/tyrargo/underground/bunker/south)
"X" = (
/obj/effect/decal/cleanable/dirt,
/turf/open/floor/corsat/red/southeast,
/area/tyrargo/underground/bunker/south)
"Y" = (
/obj/effect/decal/cleanable/dirt,
/obj/item/ammo_casing/bullet,
/obj/item/ammo_casing/bullet,
/obj/item/ammo_casing/bullet,
/turf/open/floor/corsat/redcorner/east,
/area/tyrargo/underground/bunker/south)

(1,1,1) = {"
t
g
g
g
g
g
t
H
"}
(2,1,1) = {"
t
R
E
F
A
R
t
t
"}
(3,1,1) = {"
L
o
o
o
o
O
v
t
"}
(4,1,1) = {"
c
N
x
l
x
y
P
t
"}
(5,1,1) = {"
c
J
Y
B
Q
z
S
t
"}
(6,1,1) = {"
c
c
N
s
a
K
K
t
"}
(7,1,1) = {"
P
f
J
p
X
P
t
t
"}
(8,1,1) = {"
t
w
c
M
c
G
t
t
"}
