//MAP CONVERTED BY dmm2tgm.py THIS HEADER COMMENT PREVENTS RECONVERSION, DO NOT REMOVE
"aa" = (
/obj/structure/machinery/power/apc/no_power/north,
/turf/open/floor/plating,
/area/lv624/lazarus/hydroponics)
"ab" = (
/obj/effect/spawner/random/claymore/lowchance{
	dir = 8
	},
/turf/open/floor/plating/platingdmg3,
/area/lv624/lazarus/hydroponics)
"ac" = (
/obj/structure/girder,
/turf/open/floor/plating,
/area/lv624/lazarus/hydroponics)
"ad" = (
/obj/item/reagent_container/spray/plantbgone{
	pixel_x = 4;
	pixel_y = 6
	},
/obj/effect/landmark/crap_item,
/obj/item/stack/sheet/metal,
/obj/effect/spawner/random/claymore/midchance,
/turf/open/floor/platingdmg1,
/area/lv624/lazarus/hydroponics)
"ae" = (
/obj/item/stack/sheet/metal,
/obj/effect/spawner/random/claymore/midchance,
/turf/open/floor/plating/panelscorched,
/area/lv624/lazarus/hydroponics)
"af" = (
/obj/structure/barricade/deployable{
	damage_state = 3;
	health = 45;
	icon_state = "folding_3"
	},
/obj/effect/decal/cleanable/blood,
/obj/item/weapon/gun/smg/fp9000,
/obj/item/clothing/under/marine/veteran/pmc/leader{
	pixel_x = -7
	},
/turf/open/floor/plating/panelscorched,
/area/lv624/lazarus/hydroponics)
"ag" = (
/obj/structure/barricade/deployable{
	damage_state = 1;
	health = 245;
	icon_state = "folding_1"
	},
/obj/effect/landmark/corpsespawner/wy/manager,
/obj/item/weapon/gun/pistol/vp78{
	current_mag = null;
	name = "dented VP78 pistol";
	pixel_x = -5;
	pixel_y = -4
	},
/obj/item/ammo_magazine/pistol/vp78{
	current_rounds = 4;
	name = "scratched VP78 magazine (9mm)";
	pixel_x = 6
	},
/turf/open/floor/plating/platingdmg3,
/area/lv624/lazarus/hydroponics)
"ah" = (
/obj/structure/barricade/deployable{
	damage_state = 3;
	health = 50;
	icon_state = "folding_3";
	dir = 1
	},
/obj/item/ammo_magazine/rifle/nsg23,
/obj/item/ammo_magazine/rifle/nsg23,
/obj/item/ammo_magazine/rifle/nsg23,
/turf/open/floor/plating/panelscorched,
/area/lv624/lazarus/hydroponics)
"ai" = (
/obj/item/stack/sheet/metal,
/obj/effect/spawner/random/claymore/lowchance{
	dir = 1
	},
/turf/open/floor/platingdmg1,
/area/lv624/lazarus/hydroponics)
"aj" = (
/obj/item/device/analyzer/plant_analyzer,
/obj/effect/spawner/random/claymore{
	dir = 1
	},
/turf/open/floor/green/northwest,
/area/lv624/lazarus/hydroponics)
"ak" = (
/obj/item/stack/sheet/metal,
/obj/effect/spawner/random/claymore/midchance{
	dir = 1
	},
/turf/open/floor/plating/platingdmg3,
/area/lv624/lazarus/hydroponics)
"al" = (
/obj/item/stack/sheet/metal,
/obj/effect/spawner/random/claymore/lowchance{
	dir = 1
	},
/turf/open/floor/plating,
/area/lv624/lazarus/hydroponics)
"am" = (
/obj/item/reagent_container/glass/fertilizer{
	pixel_x = 6;
	pixel_y = 2
	},
/obj/item/reagent_container/glass/fertilizer,
/obj/item/stack/sheet/metal,
/obj/effect/spawner/random/claymore/midchance{
	dir = 1
	},
/turf/open/floor/platingdmg1,
/area/lv624/lazarus/hydroponics)
"an" = (
/obj/structure/fence,
/turf/open/gm/dirtgrassborder/north,
/area/lv624/ground/colony/south_medbay_road)
"ao" = (
/turf/open/gm/dirtgrassborder/grassdirt_corner2/south_west,
/area/lv624/ground/colony/south_medbay_road)
"ap" = (
/turf/open/gm/dirtgrassborder/grassdirt_corner2/south_east,
/area/lv624/ground/colony/north_nexus_road)
"aq" = (
/obj/structure/fence,
/turf/open/gm/dirtgrassborder/north,
/area/lv624/ground/colony/north_nexus_road)
"aO" = (
/obj/effect/landmark/crap_item,
/obj/item/reagent_container/glass/watertank,
/turf/open/floor/platingdmg1,
/area/lv624/lazarus/hydroponics)
"bd" = (
/obj/item/stack/sheet/metal,
/obj/item/explosive/mine/pmc/active{
	dir = 1
	},
/turf/open/floor/platingdmg1,
/area/lv624/lazarus/hydroponics)
"bk" = (
/obj/item/tool/extinguisher,
/obj/effect/decal/cleanable/blood/tracks/footprints{
	dir = 1
	},
/turf/open/floor/platingdmg1,
/area/lv624/lazarus/hydroponics)
"ck" = (
/obj/effect/decal/cleanable/blood/xeno,
/turf/open/floor/plating,
/area/lv624/lazarus/hydroponics)
"cQ" = (
/obj/effect/decal/cleanable/blood/xeno,
/turf/open/floor/plating/panelscorched,
/area/lv624/lazarus/hydroponics)
"dZ" = (
/turf/closed/wall/r_wall,
/area/lv624/lazarus/hydroponics)
"ft" = (
/obj/item/clothing/gloves/marine/veteran/pmc{
	armor_bio = 10;
	armor_bomb = 10;
	armor_bullet = 15;
	armor_energy = 15;
	armor_internaldamage = 15;
	armor_laser = 15;
	armor_melee = 15;
	armor_rad = 10;
	name = "damaged WY PMC gloves"
	},
/turf/open/floor/platingdmg1,
/area/lv624/lazarus/hydroponics)
"ih" = (
/obj/item/clothing/gloves/botanic_leather,
/obj/item/stack/sheet/metal,
/turf/open/floor/plating/panelscorched,
/area/lv624/lazarus/hydroponics)
"it" = (
/obj/item/tool/hatchet{
	pixel_x = 6;
	pixel_y = 4
	},
/obj/structure/machinery/portable_atmospherics/hydroponics,
/turf/open/floor/plating/platingdmg3,
/area/lv624/lazarus/hydroponics)
"jg" = (
/obj/structure/flora/bush/ausbushes/var3/sparsegrass,
/turf/open/gm/grass/grass1,
/area/lv624/ground/jungle/north_jungle)
"jy" = (
/obj/structure/machinery/portable_atmospherics/hydroponics,
/turf/open/floor/plating/platingdmg3,
/area/lv624/lazarus/hydroponics)
"kg" = (
/obj/structure/window/framed/colony/reinforced,
/turf/open/floor/plating,
/area/lv624/lazarus/hydroponics)
"km" = (
/obj/effect/decal/cleanable/blood/tracks/footprints{
	dir = 1
	},
/turf/open/floor/plating/panelscorched,
/area/lv624/lazarus/hydroponics)
"kD" = (
/obj/item/reagent_container/glass/bucket,
/turf/open/floor/plating/platingdmg3,
/area/lv624/lazarus/hydroponics)
"lm" = (
/obj/item/stack/sheet/metal,
/turf/open/floor/plating/platingdmg3,
/area/lv624/lazarus/hydroponics)
"lP" = (
/obj/item/stack/sheet/metal,
/obj/effect/spawner/random/claymore/midchance{
	dir = 4
	},
/turf/open/floor/plating,
/area/lv624/lazarus/hydroponics)
"mK" = (
/obj/item/clothing/suit/storage/marine/veteran/pmc/light/synth{
	desc = "A serious modification of the standard Armat Systems M3 armor. This variant was designed for PMC Support Units in the field, with every armor insert removed. It's designed with the idea of a high speed lifesaver in mind. This set seems damaged...";
	name = "damaged M4 Synthetic PMC armor";
	pixel_x = -5;
	pixel_y = -5
	},
/obj/effect/spawner/gibspawner/robot,
/obj/item/limb/head/synth{
	desc = "This appears to be the head of a synthetic, though it it is so destroyed there is no way in hell anyone is going to bring it back to even basic functionality.";
	name = "shattered synthetic head";
	pixel_x = 9;
	pixel_y = 3;
	icon_state = "pale0_head"
	},
/obj/item/robot_parts/arm/l_arm,
/turf/open/floor/green/northwest,
/area/lv624/lazarus/hydroponics)
"np" = (
/obj/item/tool/weldingtool/simple,
/obj/item/stack/sheet/wood,
/turf/open/floor/green/northwest,
/area/lv624/lazarus/hydroponics)
"nJ" = (
/obj/item/stack/sheet/metal,
/turf/open/floor/plating,
/area/lv624/lazarus/hydroponics)
"og" = (
/turf/open/gm/dirt,
/area/lv624/ground/colony/south_medbay_road)
"ot" = (
/obj/effect/landmark/crap_item,
/turf/open/floor/plating/panelscorched,
/area/lv624/lazarus/hydroponics)
"ou" = (
/turf/open/gm/dirt,
/area/lv624/ground/colony/north_nexus_road)
"qe" = (
/obj/item/stack/sheet/metal,
/obj/effect/spawner/random/claymore/lowchance{
	dir = 4
	},
/turf/open/floor/plating,
/area/lv624/lazarus/hydroponics)
"vm" = (
/obj/item/stack/sheet/wood{
	amount = 16
	},
/obj/item/ammo_magazine/rifle/nsg23{
	current_rounds = 13
	},
/obj/effect/spawner/gibspawner/human,
/obj/item/clothing/head/helmet/marine/veteran/pmc{
	pixel_x = -6;
	pixel_y = 8
	},
/turf/open/floor/plating/platingdmg3,
/area/lv624/lazarus/hydroponics)
"xa" = (
/obj/effect/decal/cleanable/blood,
/obj/item/ammo_magazine/rifle/nsg23{
	current_rounds = 2
	},
/obj/effect/spawner/gibspawner/human,
/obj/item/clothing/under/marine/veteran/pmc{
	pixel_x = 6;
	pixel_y = 8
	},
/turf/open/floor/plating/panelscorched,
/area/lv624/lazarus/hydroponics)
"xF" = (
/obj/effect/decal/cleanable/blood,
/obj/item/clothing/under/marine/veteran/pmc{
	pixel_x = -7;
	pixel_y = 9
	},
/turf/open/floor/plating/panelscorched,
/area/lv624/lazarus/hydroponics)
"xM" = (
/obj/structure/surface/rack,
/obj/item/tool/crowbar,
/obj/item/reagent_container/glass/bucket{
	pixel_y = -3
	},
/obj/item/reagent_container/glass/bucket,
/turf/open/floor/platingdmg1,
/area/lv624/lazarus/hydroponics)
"ym" = (
/obj/item/tool/crowbar,
/obj/effect/spawner/random/claymore/midchance{
	dir = 4
	},
/turf/open/floor/platingdmg1,
/area/lv624/lazarus/hydroponics)
"zj" = (
/obj/item/stack/folding_barricade,
/obj/item/ammo_magazine/rifle/nsg23{
	current_rounds = 17
	},
/obj/effect/spawner/gibspawner/human,
/obj/item/clothing/head/helmet/marine/veteran/pmc/leader,
/turf/open/floor/plating,
/area/lv624/lazarus/hydroponics)
"zL" = (
/obj/structure/window_frame/colony/reinforced,
/turf/open/floor/platingdmg1,
/area/lv624/lazarus/hydroponics)
"zS" = (
/obj/structure/window_frame/colony/reinforced,
/obj/item/shard,
/turf/open/floor/plating,
/area/lv624/lazarus/hydroponics)
"zX" = (
/obj/effect/decal/cleanable/blood,
/obj/item/weapon/gun/smg/fp9000,
/obj/item/ammo_magazine/smg/fp9000{
	pixel_x = 1
	},
/obj/item/ammo_magazine/smg/fp9000{
	pixel_x = -3
	},
/obj/structure/barricade/wooden{
	dir = 8
	},
/turf/open/floor/plating/panelscorched,
/area/lv624/lazarus/hydroponics)
"BL" = (
/obj/structure/flora/bush/ausbushes/genericbush,
/turf/open/gm/grass/grass1,
/area/lv624/ground/jungle/north_jungle)
"Cp" = (
/obj/structure/surface/rack,
/obj/item/clothing/suit/apron,
/obj/item/tool/shovel,
/obj/item/clothing/gloves/botanic_leather,
/turf/open/floor/platingdmg1,
/area/lv624/lazarus/hydroponics)
"Cq" = (
/obj/structure/girder,
/turf/open/floor/green/northwest,
/area/lv624/lazarus/hydroponics)
"Ed" = (
/obj/item/stack/sheet/metal,
/turf/open/floor/platingdmg1,
/area/lv624/lazarus/hydroponics)
"Fk" = (
/obj/item/clothing/head/helmet/marine/veteran/pmc{
	pixel_x = -13;
	pixel_y = 11
	},
/turf/open/floor/plating,
/area/lv624/lazarus/hydroponics)
"FJ" = (
/obj/effect/decal/cleanable/blood/xeno,
/turf/open/floor/platingdmg1,
/area/lv624/lazarus/hydroponics)
"IO" = (
/obj/item/device/analyzer/plant_analyzer,
/obj/effect/landmark/crap_item,
/turf/open/floor/platingdmg1,
/area/lv624/lazarus/hydroponics)
"Jc" = (
/obj/item/stack/sheet/metal,
/obj/effect/decal/cleanable/blood/tracks/footprints{
	dir = 1
	},
/turf/open/floor/plating/panelscorched,
/area/lv624/lazarus/hydroponics)
"JE" = (
/turf/open/floor,
/area/lv624/lazarus/hydroponics)
"JK" = (
/obj/effect/landmark/crap_item,
/turf/open/floor/green/northwest,
/area/lv624/lazarus/hydroponics)
"JO" = (
/obj/structure/machinery/portable_atmospherics/hydroponics,
/turf/open/floor/plating/panelscorched,
/area/lv624/lazarus/hydroponics)
"Km" = (
/turf/open/gm/grass/grass1,
/area/lv624/ground/colony/south_medbay_road)
"Lk" = (
/obj/effect/decal/cleanable/blood/xeno,
/turf/open/floor/plating/platingdmg3,
/area/lv624/lazarus/hydroponics)
"Lu" = (
/obj/structure/window_frame/colony/reinforced,
/turf/open/floor/plating,
/area/lv624/lazarus/hydroponics)
"Mm" = (
/obj/effect/landmark/crap_item,
/turf/open/gm/grass/grass1,
/area/lv624/ground/colony/south_medbay_road)
"MT" = (
/obj/effect/landmark/crap_item,
/turf/open/floor/platingdmg1,
/area/lv624/lazarus/hydroponics)
"NO" = (
/obj/effect/landmark/crap_item,
/turf/open/floor/plating,
/area/lv624/lazarus/hydroponics)
"OH" = (
/obj/structure/surface/rack,
/obj/item/tool/shovel/spade,
/obj/item/tool/hatchet{
	pixel_x = 6;
	pixel_y = 4
	},
/obj/item/tool/hatchet{
	pixel_x = 6;
	pixel_y = 4
	},
/obj/item/tool/minihoe{
	pixel_y = -2
	},
/turf/open/floor/plating/platingdmg3,
/area/lv624/lazarus/hydroponics)
"OI" = (
/obj/item/reagent_container/glass/fertilizer,
/obj/item/stack/sheet/metal,
/turf/open/floor/plating,
/area/lv624/lazarus/hydroponics)
"OK" = (
/obj/structure/closet/crate/hydroponics/prespawned,
/obj/effect/landmark/objective_landmark/close,
/turf/open/floor/platingdmg1,
/area/lv624/lazarus/hydroponics)
"OO" = (
/obj/item/ammo_magazine/rifle/nsg23/extended,
/obj/effect/landmark/objective_landmark/medium,
/obj/item/stack/sheet/wood,
/turf/open/floor/plating/panelscorched,
/area/lv624/lazarus/hydroponics)
"Pk" = (
/obj/item/stack/sheet/metal,
/turf/open/floor/green/northwest,
/area/lv624/lazarus/hydroponics)
"Px" = (
/obj/effect/decal/cleanable/blood/tracks/footprints{
	dir = 1
	},
/turf/open/floor/platingdmg1,
/area/lv624/lazarus/hydroponics)
"Qd" = (
/obj/item/stack/folding_barricade,
/obj/item/ammo_magazine/smg/fp9000,
/obj/item/ammo_magazine/smg/fp9000,
/obj/item/ammo_magazine/smg/fp9000,
/obj/item/clothing/gloves/marine/veteran/pmc{
	armor_bio = 10;
	armor_bomb = 10;
	armor_bullet = 15;
	armor_energy = 15;
	armor_internaldamage = 15;
	armor_laser = 15;
	armor_melee = 15;
	armor_rad = 10;
	name = "damaged WY PMC gloves";
	pixel_y = 9
	},
/turf/open/floor/plating,
/area/lv624/lazarus/hydroponics)
"QR" = (
/turf/open/floor/plating/panelscorched,
/area/lv624/lazarus/hydroponics)
"RT" = (
/obj/item/clothing/shoes/veteran/pmc{
	armor_bio = 15;
	armor_bomb = 5;
	armor_bullet = 15;
	armor_energy = 5;
	armor_internaldamage = 5;
	armor_laser = 5;
	armor_melee = 15;
	desc = "The height of fashion, but these look to be woven with protective fiber. This pair seems heavily damaged, especially around the soles...";
	name = "scuffed shoes";
	pixel_x = -14;
	pixel_y = -10;
	slowdown = 0.5
	},
/turf/open/floor/green/northwest,
/area/lv624/lazarus/hydroponics)
"TC" = (
/turf/open/floor/plating/platingdmg3,
/area/lv624/lazarus/hydroponics)
"Ul" = (
/obj/structure/barricade/deployable{
	damage_state = 2;
	dir = 8;
	health = 140;
	icon_state = "folding_2"
	},
/obj/item/weapon/gun/rifle/nsg23/no_lock,
/obj/item/ammo_magazine/rifle/nsg23,
/turf/open/floor/plating/panelscorched,
/area/lv624/lazarus/hydroponics)
"UG" = (
/obj/effect/decal/cleanable/blood,
/obj/structure/barricade/wooden{
	dir = 4
	},
/obj/item/weapon/gun/rifle/nsg23/no_lock,
/turf/open/floor/plating/platingdmg3,
/area/lv624/lazarus/hydroponics)
"Wg" = (
/turf/open/floor/plating,
/area/lv624/lazarus/hydroponics)
"Xv" = (
/turf/open/floor/green/northwest,
/area/lv624/lazarus/hydroponics)
"XA" = (
/turf/open/gm/grass/grass1,
/area/lv624/ground/jungle/north_jungle)
"XJ" = (
/obj/structure/flora/bush/ausbushes/ausbush,
/turf/open/gm/grass/grass1,
/area/lv624/ground/jungle/north_jungle)
"YJ" = (
/obj/item/storage/firstaid,
/obj/item/explosive/grenade/high_explosive/pmc{
	pixel_x = 6
	},
/turf/open/floor/plating/platingdmg3,
/area/lv624/lazarus/hydroponics)
"YV" = (
/turf/open/floor/platingdmg1,
/area/lv624/lazarus/hydroponics)
"Zm" = (
/obj/item/stack/sheet/metal,
/obj/item/robot_parts/leg/l_leg,
/turf/open/floor/plating/panelscorched,
/area/lv624/lazarus/hydroponics)
"ZL" = (
/obj/item/tool/minihoe{
	pixel_x = 1;
	pixel_y = -1
	},
/turf/open/floor/green/northwest,
/area/lv624/lazarus/hydroponics)

(1,1,1) = {"
an
Mm
Km
Km
Km
zS
JE
JE
kg
XA
jg
XA
XA
XA
"}
(2,1,1) = {"
an
Km
Km
Km
Km
nJ
JE
JE
ac
XA
XA
XA
BL
XA
"}
(3,1,1) = {"
an
Km
Km
Km
Cq
lP
Wg
Ed
ac
YV
BL
XA
XA
XA
"}
(4,1,1) = {"
an
Wg
Ed
Wg
ac
Xv
FJ
ym
aa
dZ
TC
Lu
ac
XJ
"}
(5,1,1) = {"
ao
zL
xM
OK
OK
Wg
Wg
YV
Wg
FJ
ab
YV
qe
XA
"}
(6,1,1) = {"
og
zL
Cp
lP
Wg
Wg
Xv
TC
kD
JK
Wg
Wg
Ed
XA
"}
(7,1,1) = {"
Wg
Wg
OH
Lk
Xv
jy
zX
Ul
JO
Pk
Wg
Lk
Wg
Wg
"}
(8,1,1) = {"
Wg
ZL
ak
Wg
JO
xa
OO
zj
af
ae
TC
ft
Wg
YV
"}
(9,1,1) = {"
Xv
Ed
TC
Wg
ot
ah
Qd
YJ
km
Jc
km
Px
bk
Px
"}
(10,1,1) = {"
Xv
FJ
Wg
TC
aj
jy
vm
ag
xF
Fk
JO
QR
Xv
RT
"}
(11,1,1) = {"
YV
YV
al
Wg
Xv
np
UG
it
TC
Wg
Xv
cQ
Xv
Wg
"}
(12,1,1) = {"
ac
ac
OI
lm
TC
TC
Wg
TC
Wg
mK
QR
aO
bd
Wg
"}
(13,1,1) = {"
ou
YV
am
ck
lm
TC
Wg
NO
TC
Lk
Zm
IO
zL
XA
"}
(14,1,1) = {"
ap
Lu
Ed
lm
Wg
FJ
Wg
Wg
Wg
MT
ad
ih
Lu
XA
"}
(15,1,1) = {"
aq
ac
YV
Wg
Wg
ai
YV
Xv
Xv
YV
Ed
Wg
Wg
XA
"}
(16,1,1) = {"
aq
XA
XA
XA
ac
Lu
Xv
Xv
Wg
Wg
XA
XA
XA
XA
"}
