//MAP CONVERTED BY dmm2tgm.py THIS HEADER COMMENT PREVENTS RECONVERSION, DO NOT REMOVE
"a" = (
/turf/open/floor{
	dir = 8;
	icon_state = "warning"
	},
/area/lv624/lazarus/landing_zones/lz1)
"b" = (
/obj/item/stack/sheet/wood{
	amount = 2
	},
/turf/open/floor{
	icon_state = "bot";
	dir = 1
	},
/area/lv624/lazarus/landing_zones/lz1)
"c" = (
/obj/structure/largecrate,
/turf/open/floor{
	icon_state = "bot";
	dir = 1
	},
/area/lv624/lazarus/landing_zones/lz1)
"d" = (
/turf/open/floor{
	icon_state = "bot";
	dir = 1
	},
/area/lv624/lazarus/landing_zones/lz1)
"e" = (
/obj/structure/largecrate/random,
/turf/open/floor{
	icon_state = "bot";
	dir = 1
	},
/area/lv624/lazarus/landing_zones/lz1)
"f" = (
/turf/open/floor{
	dir = 8;
	icon_state = "loadingarea";
	tag = "loading"
	},
/area/lv624/lazarus/landing_zones/lz1)
"g" = (
/turf/open/floor,
/area/lv624/lazarus/landing_zones/lz1)
"h" = (
/obj/effect/landmark/crap_item,
/turf/open/floor{
	dir = 8;
	icon_state = "loadingarea";
	tag = "loading"
	},
/area/lv624/lazarus/landing_zones/lz1)
"i" = (
/obj/effect/decal/cleanable/blood/tracks/footprints{
	dir = 4
	},
/obj/effect/decal/cleanable/blood/tracks/footprints{
	dir = 8
	},
/turf/open/floor{
	dir = 8;
	icon_state = "warning"
	},
/area/lv624/lazarus/landing_zones/lz1)
"j" = (
/obj/effect/landmark/hunter_primary,
/turf/open/floor,
/area/lv624/lazarus/landing_zones/lz1)
"k" = (
/obj/item/device/radio/intercom{
	anyai = 1;
	freerange = 1;
	frequency = 1469;
	name = "General Listening Channel";
	pixel_x = -30;
	pixel_y = 0
	},
/turf/open/floor{
	dir = 10;
	icon_state = "warning"
	},
/area/lv624/lazarus/landing_zones/lz1)
"l" = (
/turf/open/floor{
	icon_state = "warning"
	},
/area/lv624/lazarus/landing_zones/lz1)
"m" = (
/turf/open/floor{
	dir = 1;
	icon_state = "loadingarea"
	},
/area/lv624/lazarus/landing_zones/lz1)
"n" = (
/turf/open/floor{
	icon_state = "warningcorner";
	dir = 4
	},
/area/lv624/lazarus/landing_zones/lz1)
"o" = (
/obj/structure/largecrate/random,
/turf/open/floor,
/area/lv624/lazarus/landing_zones/lz1)

(1,1,1) = {"
a
a
a
i
a
a
a
k
a
a
n
g
g
g
l
"}
(2,1,1) = {"
b
f
h
f
f
f
d
l
b
d
c
b
d
e
l
"}
(3,1,1) = {"
c
g
d
g
d
g
e
l
m
g
g
g
g
g
l
"}
(4,1,1) = {"
d
g
e
g
b
g
b
l
m
g
d
e
d
c
l
"}
(5,1,1) = {"
d
g
d
j
d
g
c
l
m
g
o
g
g
g
l
"}
(6,1,1) = {"
e
g
d
g
b
g
d
l
b
d
d
d
e
b
l
"}
