//MAP CONVERTED BY dmm2tgm.py THIS HEADER COMMENT PREVENTS RECONVERSION, DO NOT REMOVE
"a" = (
/turf/closed/wall/shiva/prefabricated/reinforced/hull,
/area/shiva/exterior/lz2_fortress)
"i" = (
/turf/open/auto_turf/snow/layer3,
/area/shiva/exterior/cp_lz2)
"j" = (
/obj/structure/flora/bush/snow{
	icon_state = "snowgrassbb_3"
	},
/turf/open/auto_turf/snow/layer3,
/area/shiva/exterior/cp_lz2)
"n" = (
/obj/item/clothing/shoes/snow,
/obj/structure/surface/rack,
/obj/item/clothing/shoes/snow,
/obj/item/clothing/suit/storage/snow_suit,
/obj/item/clothing/suit/storage/snow_suit,
/obj/item/tank/emergency_oxygen/engi,
/obj/effect/decal/strata_decals/grime/grime3{
	dir = 8
	},
/obj/item/clothing/mask/rebreather,
/obj/item/tank/emergency_oxygen/engi,
/obj/item/clothing/mask/rebreather,
/turf/open/floor/shiva/multi_tiles/north,
/area/shiva/exterior/lz2_fortress)
"r" = (
/turf/open/auto_turf/snow/layer4,
/area/shiva/exterior/cp_lz2)
"L" = (
/turf/open/floor/shiva/radiator_tile,
/area/shiva/exterior/lz2_fortress)
"N" = (
/turf/open/floor/shiva/north,
/area/shiva/exterior/lz2_fortress)

(1,1,1) = {"
N
N
a
a
r
j
"}
(2,1,1) = {"
N
N
a
a
r
r
"}
(3,1,1) = {"
N
L
a
a
a
a
"}
(4,1,1) = {"
N
L
a
a
a
a
"}
(5,1,1) = {"
N
n
a
a
r
i
"}
(6,1,1) = {"
N
n
a
a
r
r
"}
