//MAP CONVERTED BY dmm2tgm.py THIS HEADER COMMENT PREVENTS RECONVERSION, DO NOT REMOVE
"a" = (
/turf/open/auto_turf/snow/layer4,
/area/shiva/exterior/cp_lz2)
"b" = (
/turf/closed/wall/shiva/prefabricated/pink,
/area/shiva/exterior/lz2_fortress)
"k" = (
/obj/item/clothing/shoes/snow,
/obj/structure/surface/rack,
/obj/item/clothing/shoes/snow,
/obj/item/clothing/suit/storage/snow_suit,
/obj/item/clothing/suit/storage/snow_suit,
/obj/item/tank/emergency_oxygen/engi,
/obj/effect/decal/strata_decals/grime/grime3{
	dir = 8
	},
/obj/item/clothing/mask/rebreather,
/obj/item/tank/emergency_oxygen/engi,
/obj/item/clothing/mask/rebreather,
/turf/open/floor/shiva/multi_tiles/north,
/area/shiva/exterior/lz2_fortress)
"t" = (
/obj/structure/flora/bush/snow{
	icon_state = "snowgrassbb_3"
	},
/turf/open/auto_turf/snow/layer3,
/area/shiva/exterior/cp_lz2)
"u" = (
/turf/open/auto_turf/snow/layer3,
/area/shiva/exterior/cp_lz2)
"x" = (
/turf/closed/wall/shiva/prefabricated/reinforced/hull,
/area/shiva/exterior/lz2_fortress)
"C" = (
/turf/open/floor/shiva/radiator_tile,
/area/shiva/exterior/lz2_fortress)
"Z" = (
/turf/open/floor/shiva/north,
/area/shiva/exterior/lz2_fortress)

(1,1,1) = {"
Z
k
b
b
a
t
"}
(2,1,1) = {"
Z
k
b
b
a
a
"}
(3,1,1) = {"
Z
C
x
x
x
x
"}
(4,1,1) = {"
Z
C
x
x
x
x
"}
(5,1,1) = {"
Z
Z
b
b
a
u
"}
(6,1,1) = {"
Z
Z
b
b
a
a
"}
