//MAP CONVERTED BY dmm2tgm.py THIS HEADER COMMENT PREVENTS RECONVERSION, DO NOT REMOVE
"a" = (
/turf/closed/wall/r_wall/prison,
/area/desert_dam/building/security/armory)
"b" = (
/obj/structure/machinery/light,
/turf/open/floor/prison/darkredcorners2/west,
/area/desert_dam/building/security/staffroom)
"d" = (
/turf/open/floor/prison,
/area/desert_dam/building/security/armory)
"e" = (
/obj/structure/closet/secure_closet/guncabinet{
	req_access = null
	},
/obj/item/ammo_magazine/shotgun,
/obj/item/ammo_magazine/shotgun,
/turf/open/floor/prison/darkredfull2,
/area/desert_dam/building/security/armory)
"f" = (
/obj/structure/surface/rack,
/obj/item/weapon/gun/launcher/grenade/m81/riot,
/turf/open/floor/prison/darkredfull2,
/area/desert_dam/building/security/armory)
"g" = (
/turf/open/floor/prison/darkred2/northeast,
/area/desert_dam/building/security/armory)
"h" = (
/obj/item/clothing/mask/gas/swat,
/obj/item/clothing/mask/gas/swat,
/obj/structure/closet/secure_closet/guncabinet{
	req_access = null
	},
/obj/item/clothing/head/helmet/marine/veteran/cmb,
/turf/open/floor/prison/darkred2/northwest,
/area/desert_dam/building/security/armory)
"i" = (
/turf/open/floor/prison/darkredcorners2/east,
/area/desert_dam/building/security/armory)
"j" = (
/turf/open/floor/prison/darkredcorners2/southwest,
/area/desert_dam/building/security/staffroom)
"k" = (
/turf/open/floor/prison/darkred2/southeast,
/area/desert_dam/building/security/armory)
"l" = (
/obj/structure/surface/rack,
/obj/item/storage/box/packet/m15/rubber,
/turf/open/floor/prison,
/area/desert_dam/building/security/armory)
"m" = (
/obj/structure/surface/rack,
/obj/item/ammo_magazine/revolver/cmb,
/obj/item/ammo_magazine/revolver/cmb,
/obj/item/ammo_magazine/revolver/cmb,
/obj/item/ammo_magazine/revolver/cmb,
/turf/open/floor/prison,
/area/desert_dam/building/security/armory)
"n" = (
/obj/structure/machinery/light{
	dir = 1
	},
/turf/open/floor/prison/darkredcorners2/east,
/area/desert_dam/building/security/armory)
"p" = (
/obj/structure/closet/l3closet/security,
/obj/effect/landmark/objective_landmark/medium,
/turf/open/floor/prison/floor_marked,
/area/desert_dam/building/security/armory)
"q" = (
/obj/structure/machinery/door/airlock/almayer/security/glass/colony{
	name = "\improper Armoury"
	},
/turf/open/floor/prison,
/area/desert_dam/building/security/armory)
"r" = (
/obj/structure/surface/rack,
/obj/item/weapon/shield/riot{
	pixel_x = -6
	},
/obj/item/weapon/shield/riot{
	pixel_x = 5
	},
/turf/open/floor/prison/darkredfull2,
/area/desert_dam/building/security/armory)
"s" = (
/obj/structure/surface/rack,
/obj/item/storage/box/nade_box/tear_gas,
/turf/open/floor/prison/darkredfull2,
/area/desert_dam/building/security/armory)
"t" = (
/obj/structure/machinery/flasher/portable,
/turf/open/floor/prison/floor_marked,
/area/desert_dam/building/security/armory)
"u" = (
/obj/structure/closet/l3closet/security,
/obj/structure/machinery/light{
	dir = 1
	},
/obj/effect/landmark/objective_landmark/science,
/turf/open/floor/prison/floor_marked,
/area/desert_dam/building/security/armory)
"v" = (
/obj/structure/machinery/deployable/barrier,
/turf/open/floor/prison/floor_marked,
/area/desert_dam/building/security/armory)
"w" = (
/obj/item/clothing/suit/storage/marine/veteran/cmb/light,
/obj/item/clothing/suit/storage/marine/veteran/cmb/light,
/obj/structure/closet/secure_closet/guncabinet{
	req_access = null
	},
/turf/open/floor/prison/darkredfull2,
/area/desert_dam/building/security/armory)
"x" = (
/obj/structure/surface/table,
/obj/effect/spawner/random/toolbox,
/turf/open/floor/prison/darkred2/southwest,
/area/desert_dam/building/security/staffroom)
"y" = (
/obj/structure/machinery/vending/security,
/turf/open/floor/prison/darkredfull2,
/area/desert_dam/building/security/staffroom)
"z" = (
/obj/structure/closet/l3closet/security,
/obj/effect/landmark/objective_landmark/science,
/turf/open/floor/prison/floor_marked,
/area/desert_dam/building/security/armory)
"A" = (
/turf/open/floor/prison/darkred2/north,
/area/desert_dam/building/security/armory)
"B" = (
/turf/open/floor/prison/darkred2/east,
/area/desert_dam/building/security/armory)
"C" = (
/turf/open/floor/prison/darkred2,
/area/desert_dam/building/security/staffroom)
"D" = (
/obj/structure/closet/secure_closet/guncabinet{
	req_access = null
	},
/obj/item/ammo_magazine/shotgun/buckshot,
/obj/item/ammo_magazine/shotgun/buckshot,
/turf/open/floor/prison/darkredfull2,
/area/desert_dam/building/security/armory)
"E" = (
/obj/structure/bed/chair{
	dir = 1
	},
/turf/open/floor/prison,
/area/desert_dam/building/security/staffroom)
"F" = (
/turf/open/floor/prison/darkredcorners2/north,
/area/desert_dam/building/security/armory)
"G" = (
/obj/structure/surface/rack,
/obj/item/explosive/plastic/breaching_charge/rubber,
/turf/open/floor/prison,
/area/desert_dam/building/security/armory)
"H" = (
/turf/open/floor/prison/darkred2,
/area/desert_dam/building/security/armory)
"I" = (
/turf/open/floor/prison/darkred2/southeast,
/area/desert_dam/building/security/staffroom)
"J" = (
/obj/item/clothing/suit/storage/marine/veteran/cmb,
/obj/item/clothing/suit/storage/marine/veteran/cmb,
/obj/structure/closet/secure_closet/guncabinet{
	req_access = null
	},
/turf/open/floor/prison/darkredfull2,
/area/desert_dam/building/security/armory)
"K" = (
/obj/structure/machinery/light,
/turf/open/floor/prison/darkred2,
/area/desert_dam/building/security/armory)
"L" = (
/obj/structure/surface/rack,
/obj/item/storage/box/flashbangs{
	pixel_x = 3;
	pixel_y = -2
	},
/obj/item/storage/box/flashbangs,
/turf/open/floor/prison/darkredfull2,
/area/desert_dam/building/security/armory)
"M" = (
/obj/structure/surface/rack,
/obj/item/weapon/gun/revolver/cmb,
/obj/item/weapon/gun/revolver/cmb{
	pixel_y = -5
	},
/turf/open/floor/prison,
/area/desert_dam/building/security/armory)
"N" = (
/obj/structure/machinery/power/apc/no_power/north,
/turf/open/floor/prison/darkred2/east,
/area/desert_dam/building/security/armory)
"O" = (
/turf/closed/wall/r_wall/prison,
/area/desert_dam/building/security/staffroom)
"P" = (
/turf/open/floor/prison,
/area/desert_dam/building/security/staffroom)
"Q" = (
/obj/structure/surface/table,
/obj/effect/spawner/random/toolbox,
/turf/open/floor/prison/darkred2,
/area/desert_dam/building/security/staffroom)
"R" = (
/obj/structure/surface/rack,
/obj/item/ammo_magazine/shotgun/beanbag/riot,
/obj/item/ammo_magazine/shotgun/beanbag/riot,
/turf/open/floor/prison,
/area/desert_dam/building/security/armory)
"S" = (
/turf/open/floor/prison/darkredcorners2/west,
/area/desert_dam/building/security/staffroom)
"T" = (
/obj/structure/machinery/door/airlock/almayer/security/glass/colony{
	dir = 1;
	name = "\improper Armoury"
	},
/turf/open/floor/prison,
/area/desert_dam/building/security/armory)
"U" = (
/obj/structure/machinery/light,
/turf/open/floor/prison/darkred2,
/area/desert_dam/building/security/staffroom)
"V" = (
/obj/structure/machinery/light{
	dir = 1
	},
/turf/open/floor/prison/darkred2/north,
/area/desert_dam/building/security/armory)
"W" = (
/obj/structure/surface/rack,
/obj/item/storage/box/packet/baton_slug,
/turf/open/floor/prison/darkredfull2,
/area/desert_dam/building/security/armory)
"X" = (
/turf/closed/wall/rock/orange,
/area/desert_dam/exterior/rock)
"Y" = (
/obj/item/clothing/under/marine/veteran/cmb,
/obj/item/clothing/under/marine/veteran/cmb,
/obj/item/clothing/under/marine/veteran/cmb,
/obj/item/clothing/under/marine/veteran/cmb,
/obj/structure/closet/secure_closet/guncabinet{
	req_access = null
	},
/turf/open/floor/prison/darkred2/west,
/area/desert_dam/building/security/armory)
"Z" = (
/obj/structure/surface/rack,
/obj/item/weapon/gun/shotgun/pump/dual_tube/cmb{
	pixel_y = 5
	},
/obj/item/weapon/gun/shotgun/pump/dual_tube/cmb,
/obj/item/weapon/gun/shotgun/pump/dual_tube/cmb{
	pixel_y = -5
	},
/turf/open/floor/prison,
/area/desert_dam/building/security/armory)

(1,1,1) = {"
S
x
a
a
a
a
q
a
a
a
"}
(2,1,1) = {"
P
Q
a
h
Y
i
d
H
J
a
"}
(3,1,1) = {"
P
b
a
n
d
d
d
H
w
a
"}
(4,1,1) = {"
P
P
T
d
d
Z
R
H
r
a
"}
(5,1,1) = {"
P
j
a
N
F
d
d
K
a
a
"}
(6,1,1) = {"
E
U
a
u
A
M
m
H
L
a
"}
(7,1,1) = {"
E
C
a
z
A
d
d
H
D
a
"}
(8,1,1) = {"
E
C
a
p
A
M
m
H
e
a
"}
(9,1,1) = {"
E
C
a
a
V
d
d
K
a
a
"}
(10,1,1) = {"
j
I
a
v
A
l
G
H
s
a
"}
(11,1,1) = {"
U
O
a
v
A
d
d
H
f
a
"}
(12,1,1) = {"
C
y
a
v
g
B
B
k
W
a
"}
(13,1,1) = {"
C
y
a
a
a
t
t
t
a
a
"}
(14,1,1) = {"
I
y
O
X
a
a
a
a
a
X
"}
