//MAP CONVERTED BY dmm2tgm.py THIS HEADER COMMENT PREVENTS RECONVERSION, DO NOT REMOVE
"am" = (
/obj/structure/platform/metal/strata/west,
/turf/open/floor/strata/orange_edge/west,
/area/lv759/indoors/spaceport/docking_bay_1)
"aT" = (
/turf/open/floor/strata/orange_edge/north,
/area/lv759/indoors/spaceport/docking_bay_1)
"bG" = (
/obj/structure/platform/metal/strata/east,
/obj/structure/machinery/floodlight/landing,
/turf/open/floor/plating,
/area/lv759/indoors/spaceport/docking_bay_1)
"eI" = (
/obj/structure/platform/metal/strata/north,
/obj/structure/platform/metal/strata/east,
/turf/open/floor/strata/orange_cover,
/area/lv759/indoors/spaceport/docking_bay_1)
"eY" = (
/obj/structure/platform_decoration/metal/strata/north,
/obj/effect/decal/warning_stripes{
	icon_state = "W"
	},
/turf/open/floor/strata/multi_tiles/west,
/area/lv759/indoors/spaceport/docking_bay_1)
"fC" = (
/obj/structure/platform/metal/strata/west,
/obj/item/stack/cable_coil/cut{
	icon_state = "coil2"
	},
/obj/item/stack/rods{
	amount = 15
	},
/obj/effect/decal/cleanable/generic{
	color = "#5d524b";
	alpha = 155
	},
/turf/open/floor/strata/orange_edge/west,
/area/lv759/indoors/spaceport/docking_bay_1)
"gE" = (
/obj/structure/surface/table/reinforced/prison,
/obj/structure/machinery/computer/shuttle/dropship/flight/remote_control/upp{
	name = "Remote dropship navigation computer"
	},
/turf/open/floor/hybrisa/carpet/carpetdarkerblue,
/area/lv759/indoors/spaceport/docking_bay_1)
"gF" = (
/obj/structure/platform/metal/strata/east,
/turf/open/floor/strata/orange_edge/east,
/area/lv759/indoors/spaceport/docking_bay_1)
"gN" = (
/obj/structure/platform/metal/strata/west,
/obj/effect/hybrisa/decal/dirt,
/obj/effect/hybrisa/decal/dirt,
/obj/item/stack/sheet/metal,
/obj/effect/decal/cleanable/generic{
	color = "#5d524b";
	alpha = 155
	},
/turf/open/floor/strata/orange_edge/north,
/area/lv759/indoors/spaceport/docking_bay_1)
"io" = (
/obj/structure/platform/metal/strata/north,
/obj/structure/platform/metal/strata/west,
/obj/item/tool/warning_cone{
	pixel_x = -4;
	pixel_y = 5
	},
/turf/open/floor/strata/orange_icorner,
/area/lv759/indoors/spaceport/docking_bay_1)
"iv" = (
/obj/structure/platform_decoration/metal/strata/east,
/turf/open/floor/strata/orange_cover,
/area/lv759/indoors/spaceport/docking_bay_1)
"iw" = (
/turf/open/floor/strata/orange_icorner/north,
/area/lv759/indoors/spaceport/docking_bay_1)
"jz" = (
/obj/structure/machinery/conveyor,
/turf/open/floor/prison/ramptop,
/area/lv759/indoors/spaceport/docking_bay_1)
"mt" = (
/obj/effect/decal/warning_stripes{
	icon_state = "N"
	},
/turf/open/floor/prison/ramptop,
/area/lv759/indoors/spaceport/docking_bay_1)
"nu" = (
/obj/structure/platform/metal/strata/west,
/turf/open/floor/strata/orange_edge,
/area/lv759/indoors/spaceport/docking_bay_1)
"pn" = (
/obj/structure/platform/metal/strata/west,
/obj/effect/hybrisa/decal/dirt,
/obj/effect/hybrisa/decal/dirt,
/obj/item/stack/cable_coil/green{
	icon_state = "coil1"
	},
/turf/open/floor/strata/orange_edge/west,
/area/lv759/indoors/spaceport/docking_bay_1)
"sL" = (
/obj/structure/platform_decoration/metal/strata/west,
/obj/effect/decal/warning_stripes{
	icon_state = "E";
	layer = 3.33
	},
/turf/open/floor/strata/multi_tiles/west,
/area/lv759/indoors/spaceport/docking_bay_1)
"uv" = (
/obj/structure/platform_decoration/metal/strata/east,
/obj/effect/hybrisa/decal/dirt,
/obj/effect/decal/warning_stripes{
	icon_state = "W"
	},
/turf/open/floor/strata/multi_tiles/west,
/area/lv759/indoors/spaceport/docking_bay_1)
"yx" = (
/obj/structure/platform/metal/strata/west,
/obj/structure/machinery/floodlight/landing,
/turf/open/floor/plating,
/area/lv759/indoors/spaceport/docking_bay_1)
"zl" = (
/obj/structure/platform_decoration/metal/strata/west,
/turf/open/floor/strata/orange_cover,
/area/lv759/indoors/spaceport/docking_bay_1)
"Bu" = (
/obj/structure/platform/metal/strata/west,
/obj/structure/machinery/telecomms/relay/preset/tower/all,
/turf/open/floor/strata/orange_edge/west,
/area/lv759/indoors/spaceport/docking_bay_1)
"CN" = (
/obj/effect/decal/warning_stripes{
	icon_state = "N"
	},
/obj/structure/machinery/conveyor,
/turf/open/floor/prison/ramptop,
/area/lv759/indoors/spaceport/docking_bay_1)
"DY" = (
/obj/structure/platform/metal/strata/east,
/turf/open/floor/strata/orange_edge/north,
/area/lv759/indoors/spaceport/docking_bay_1)
"Fv" = (
/obj/structure/platform/metal/strata/north,
/obj/structure/platform/metal/strata/west,
/turf/open/floor/strata/orange_cover,
/area/lv759/indoors/spaceport/docking_bay_1)
"FE" = (
/obj/docking_port/stationary/marine_dropship/upp{
	name = "Celestial Gateway Space-port LZ"
	},
/turf/open/floor/plating,
/area/lv759/indoors/spaceport/docking_bay_1)
"Gp" = (
/obj/structure/platform_decoration/metal/strata/east,
/obj/effect/decal/warning_stripes{
	icon_state = "W"
	},
/turf/open/floor/strata/multi_tiles/west,
/area/lv759/indoors/spaceport/docking_bay_1)
"Ia" = (
/obj/structure/platform/metal/strata/west,
/turf/open/floor/strata/orange_edge/north,
/area/lv759/indoors/spaceport/docking_bay_1)
"IK" = (
/turf/open/floor/plating,
/area/lv759/indoors/spaceport/docking_bay_1)
"Jv" = (
/obj/structure/machinery/floodlight/landing/floor,
/turf/open/floor/plating,
/area/lv759/indoors/spaceport/docking_bay_1)
"Ko" = (
/obj/structure/platform/metal/strata/north,
/obj/structure/platform/metal/strata/east,
/obj/structure/largecrate/random/mini/small_case,
/turf/open/floor/strata/orange_icorner/north,
/area/lv759/indoors/spaceport/docking_bay_1)
"Kz" = (
/obj/structure/platform/metal/strata/west,
/obj/effect/hybrisa/decal/dirt,
/turf/open/floor/strata/orange_edge/west,
/area/lv759/indoors/spaceport/docking_bay_1)
"LI" = (
/obj/structure/platform_decoration/metal/strata/east,
/turf/open/floor/strata/orange_edge/north,
/area/lv759/indoors/spaceport/docking_bay_1)
"NL" = (
/turf/open/floor/prison/ramptop,
/area/lv759/indoors/spaceport/docking_bay_1)
"NP" = (
/obj/structure/platform/metal/strata/east,
/turf/open/floor/strata/orange_edge,
/area/lv759/indoors/spaceport/docking_bay_1)
"Oc" = (
/obj/structure/platform_decoration/metal/strata/west,
/obj/item/tool/warning_cone{
	pixel_x = 4;
	pixel_y = 14
	},
/turf/open/floor/strata/orange_edge/north,
/area/lv759/indoors/spaceport/docking_bay_1)
"QF" = (
/obj/structure/platform/metal/strata/north,
/turf/open/floor/strata/orange_cover,
/area/lv759/indoors/spaceport/docking_bay_1)
"TO" = (
/obj/structure/platform_decoration/metal/strata/north,
/obj/effect/hybrisa/decal/dirt,
/obj/effect/decal/warning_stripes{
	icon_state = "W"
	},
/turf/open/floor/strata/multi_tiles/west,
/area/lv759/indoors/spaceport/docking_bay_1)
"Ul" = (
/obj/structure/platform_decoration/metal/strata,
/obj/effect/decal/warning_stripes{
	icon_state = "E";
	layer = 3.33
	},
/turf/open/floor/strata/multi_tiles/west,
/area/lv759/indoors/spaceport/docking_bay_1)
"WJ" = (
/turf/open/floor/strata/orange_icorner,
/area/lv759/indoors/spaceport/docking_bay_1)
"Xr" = (
/obj/structure/platform/metal/strata/north,
/obj/item/tool/warning_cone{
	pixel_x = -4;
	pixel_y = 5
	},
/turf/open/floor/strata/orange_cover,
/area/lv759/indoors/spaceport/docking_bay_1)

(1,1,1) = {"
gF
gF
gF
gF
gF
gF
gF
DY
sL
Ul
NP
DY
sL
Ul
NP
gF
gF
gF
gF
gF
gF
zl
WJ
"}
(2,1,1) = {"
Jv
IK
IK
IK
IK
IK
IK
IK
IK
IK
IK
IK
IK
IK
IK
IK
IK
IK
IK
IK
Jv
Xr
aT
"}
(3,1,1) = {"
IK
IK
IK
IK
IK
IK
IK
IK
IK
IK
IK
IK
IK
IK
IK
IK
IK
IK
IK
IK
IK
eI
Oc
"}
(4,1,1) = {"
IK
IK
IK
IK
IK
IK
IK
IK
IK
IK
IK
IK
IK
IK
IK
IK
IK
IK
IK
IK
IK
bG
Ko
"}
(5,1,1) = {"
IK
IK
IK
IK
IK
IK
IK
IK
IK
IK
IK
IK
IK
IK
IK
IK
IK
IK
IK
IK
IK
mt
NL
"}
(6,1,1) = {"
IK
IK
IK
IK
IK
IK
IK
IK
IK
IK
IK
IK
IK
IK
IK
IK
IK
IK
IK
IK
IK
CN
jz
"}
(7,1,1) = {"
IK
IK
IK
IK
IK
IK
IK
IK
IK
IK
FE
IK
IK
IK
IK
IK
IK
IK
IK
IK
IK
mt
NL
"}
(8,1,1) = {"
IK
IK
IK
IK
IK
IK
IK
IK
IK
IK
IK
IK
IK
IK
IK
IK
IK
IK
IK
IK
IK
CN
jz
"}
(9,1,1) = {"
IK
IK
IK
IK
IK
IK
IK
IK
IK
IK
IK
IK
IK
IK
IK
IK
IK
IK
IK
IK
IK
mt
NL
"}
(10,1,1) = {"
IK
IK
IK
IK
IK
IK
IK
IK
IK
IK
IK
IK
IK
IK
IK
IK
IK
IK
IK
IK
IK
yx
io
"}
(11,1,1) = {"
IK
IK
IK
IK
IK
IK
IK
IK
IK
IK
IK
IK
IK
IK
IK
IK
IK
IK
IK
IK
IK
Fv
LI
"}
(12,1,1) = {"
Jv
IK
IK
IK
IK
IK
IK
IK
IK
IK
IK
IK
IK
IK
IK
IK
IK
IK
IK
IK
Jv
QF
aT
"}
(13,1,1) = {"
am
am
Bu
Kz
fC
pn
gE
gN
uv
TO
nu
Ia
Gp
eY
nu
am
am
am
am
am
am
iv
iw
"}
