//MAP CONVERTED BY dmm2tgm.py THIS HEADER COMMENT PREVENTS RECONVERSION, DO NOT REMOVE
"al" = (
/obj/structure/flora/jungle/vines{
	icon_state = "light_2";
	icon_tag = "light"
	},
/obj/structure/flora/jungle/vines/heavy{
	icon_state = "heavy_6";
	icon_tag = "heavy";
	pixel_x = 0
	},
/turf/open/gm/grass,
/area/lv624/ground/jungle/south_east_jungle)
"aK" = (
/turf/closed/wall/strata_ice/jungle,
/area/lv624/ground/jungle/south_east_jungle)
"br" = (
/obj/structure/flora/bush/ausbushes/var3/ywflowers,
/turf/open/floor/sandstone/runed,
/area/lv624/ground/jungle/south_east_jungle)
"cC" = (
/obj/structure/flora/jungle/vines,
/turf/closed/wall/strata_ice/jungle,
/area/lv624/lazarus/landing_zones/lz1)
"eR" = (
/obj/structure/flora/jungle/vines/heavy{
	icon_state = "heavy_6";
	pixel_x = 0;
	pixel_y = 0
	},
/turf/closed/wall/mineral/sandstone/runed,
/area/lv624/ground/jungle/south_east_jungle)
"gO" = (
/obj/structure/flora/jungle/vines{
	icon_state = "light_3";
	icon_tag = "light"
	},
/turf/open/gm/grass,
/area/lv624/lazarus/landing_zones/lz1)
"gU" = (
/obj/structure/flora/jungle/vines/heavy{
	icon_state = "heavy_6";
	pixel_x = 0;
	pixel_y = 26
	},
/obj/structure/flora/jungle/vines{
	icon_state = "light_2";
	pixel_y = -22
	},
/turf/open/floor/sandstone/runed,
/area/lv624/ground/jungle/south_east_jungle)
"jc" = (
/obj/structure/flora/jungle/vines/heavy{
	icon_state = "heavy_6";
	pixel_x = 0
	},
/turf/open/gm/grass,
/area/lv624/ground/jungle/south_east_jungle)
"kd" = (
/obj/structure/flora/jungle/planttop1,
/turf/open/gm/grass,
/area/lv624/ground/jungle/south_east_jungle)
"lV" = (
/obj/structure/flora/jungle/vines/heavy{
	icon_state = "heavy_6";
	pixel_x = 0;
	pixel_y = 26
	},
/obj/structure/flora/jungle/vines{
	icon_state = "light_3"
	},
/turf/closed/wall/strata_ice/jungle,
/area/lv624/ground/jungle/south_east_jungle)
"nI" = (
/obj/structure/flora/jungle/vines/heavy{
	icon_state = "heavy_6";
	pixel_x = 0
	},
/turf/open/gm/grass,
/area/lv624/lazarus/landing_zones/lz1)
"qo" = (
/turf/open/gm/grass,
/area/lv624/ground/jungle/south_east_jungle)
"rA" = (
/obj/structure/flora/jungle/vines/heavy{
	icon_state = "heavy_6";
	pixel_x = 0;
	pixel_y = 26
	},
/turf/closed/wall/strata_ice/jungle,
/area/lv624/ground/jungle/south_east_jungle)
"ug" = (
/obj/structure/flora/jungle/vines,
/turf/closed/wall/strata_ice/jungle,
/area/lv624/ground/jungle/south_east_jungle)
"uk" = (
/obj/structure/flora/jungle/vines/heavy{
	icon_state = "heavy_6";
	pixel_x = 0;
	pixel_y = 26
	},
/turf/closed/wall/mineral/sandstone/runed,
/area/lv624/ground/jungle/south_east_jungle)
"un" = (
/obj/structure/flora/bush/ausbushes/reedbush,
/turf/open/floor/sandstone/runed,
/area/lv624/ground/jungle/south_east_jungle)
"ur" = (
/obj/structure/flora/jungle/vines{
	icon_state = "light_2";
	icon_tag = "light_2"
	},
/turf/open/gm/grass,
/area/lv624/ground/jungle/south_east_jungle)
"wQ" = (
/obj/structure/flora/jungle/vines/heavy{
	pixel_x = -28
	},
/turf/open/gm/grass,
/area/lv624/ground/jungle/south_east_jungle)
"xk" = (
/turf/closed/wall/mineral/sandstone/runed/decor,
/area/lv624/ground/jungle/south_east_jungle)
"yg" = (
/obj/structure/flora/jungle/vines/heavy{
	icon_state = "heavy_6";
	pixel_x = 0;
	pixel_y = 26
	},
/obj/structure/flora/jungle/vines{
	icon_state = "light_3"
	},
/turf/open/floor/sandstone/runed,
/area/lv624/ground/jungle/south_east_jungle)
"zg" = (
/obj/structure/flora/jungle/vines{
	icon_state = "light_3";
	icon_tag = "light"
	},
/turf/closed/wall/strata_ice/jungle,
/area/lv624/lazarus/landing_zones/lz1)
"Be" = (
/obj/structure/flora/jungle/vines/heavy,
/turf/open/floor/sandstone/runed,
/area/lv624/ground/jungle/south_east_jungle)
"CW" = (
/obj/structure/flora/jungle/vines/heavy{
	icon_state = "heavy_6";
	pixel_x = 0;
	pixel_y = 26
	},
/obj/effect/decal/cleanable/cobweb,
/turf/open/gm/dirt,
/area/lv624/ground/jungle/south_east_jungle)
"EZ" = (
/obj/structure/flora/jungle/vines{
	icon_state = "light_3"
	},
/turf/open/floor/sandstone/runed,
/area/lv624/ground/jungle/south_east_jungle)
"LV" = (
/turf/open/gm/grass,
/area/lv624/lazarus/landing_zones/lz1)
"LW" = (
/turf/closed/wall/strata_ice/jungle,
/area/lv624/lazarus/landing_zones/lz1)
"NU" = (
/obj/structure/flora/jungle/vines/heavy{
	icon_state = "heavy_6";
	pixel_x = 0;
	pixel_y = 26
	},
/turf/open/gm/dirt,
/area/lv624/ground/jungle/south_east_jungle)
"Tl" = (
/obj/structure/flora/jungle/plantbot1,
/turf/open/gm/grass,
/area/lv624/ground/jungle/south_east_jungle)
"Uc" = (
/obj/structure/flora/jungle/vines/heavy{
	icon_state = "heavy_6";
	pixel_x = 0;
	pixel_y = 26
	},
/turf/open/floor/sandstone/runed,
/area/lv624/ground/jungle/south_east_jungle)
"UA" = (
/obj/structure/flora/jungle/vines{
	icon_state = "light_3";
	icon_tag = "light"
	},
/turf/open/gm/grass,
/area/lv624/ground/jungle/south_east_jungle)
"VR" = (
/obj/effect/landmark/yautja_teleport,
/turf/open/gm/grass,
/area/lv624/ground/jungle/south_east_jungle)
"Wl" = (
/turf/closed/wall/mineral/sandstone/runed,
/area/lv624/ground/jungle/south_east_jungle)
"Wp" = (
/obj/structure/flora/jungle/vines{
	icon_state = "light_2";
	pixel_y = -22
	},
/turf/open/gm/dirtgrassborder,
/area/lv624/ground/jungle/south_east_jungle)
"Wr" = (
/obj/structure/flora/jungle/vines{
	icon_state = "light_2";
	icon_tag = "light"
	},
/turf/closed/wall/strata_ice/jungle,
/area/lv624/ground/jungle/south_east_jungle)
"Wt" = (
/obj/structure/flora/jungle/vines{
	icon_state = "light_2";
	pixel_y = -22
	},
/turf/closed/wall/mineral/sandstone/runed,
/area/lv624/ground/jungle/south_east_jungle)
"WQ" = (
/turf/open/gm/dirtgrassborder{
	dir = 4
	},
/area/lv624/ground/jungle/south_east_jungle)
"Xl" = (
/turf/open/gm/dirt,
/area/lv624/ground/jungle/south_east_jungle)
"Xy" = (
/turf/open/floor/sandstone/runed,
/area/lv624/ground/jungle/south_east_jungle)
"Xz" = (
/obj/effect/landmark/monkey_spawn,
/turf/open/gm/dirt,
/area/lv624/ground/jungle/south_east_jungle)
"XB" = (
/obj/structure/flora/jungle/vines,
/turf/open/gm/grass,
/area/lv624/ground/jungle/south_east_jungle)
"XN" = (
/obj/structure/flora/jungle/vines{
	icon_state = "light_2";
	icon_tag = "light"
	},
/turf/open/gm/grass,
/area/lv624/ground/jungle/south_east_jungle)
"XR" = (
/obj/structure/flora/jungle/vines/heavy{
	icon_state = "heavy_6";
	pixel_x = 0
	},
/turf/closed/wall/strata_ice/jungle,
/area/lv624/ground/jungle/south_east_jungle)
"XS" = (
/obj/structure/flora/jungle/vines/heavy,
/turf/closed/wall/mineral/sandstone/runed,
/area/lv624/ground/jungle/south_east_jungle)
"Ya" = (
/obj/effect/landmark/lv624/xeno_tunnel,
/turf/open/gm/grass,
/area/lv624/ground/jungle/south_east_jungle)
"Yr" = (
/turf/open/gm/grass{
	icon_state = "grass2"
	},
/area/lv624/ground/jungle/south_east_jungle)
"Yz" = (
/obj/structure/flora/jungle/vines/heavy{
	icon_state = "heavy_6";
	pixel_x = 0;
	pixel_y = 24
	},
/turf/closed/wall/strata_ice/jungle,
/area/lv624/ground/jungle/south_east_jungle)
"YD" = (
/obj/structure/flora/jungle/vines/heavy{
	icon_state = "heavy_6";
	icon_tag = "heavy";
	pixel_x = 0
	},
/turf/open/gm/grass,
/area/lv624/ground/jungle/south_east_jungle)
"Ze" = (
/turf/open/gm/dirtgrassborder{
	dir = 1
	},
/area/lv624/ground/jungle/south_east_jungle)
"Zi" = (
/obj/structure/flora/jungle/vines/heavy{
	icon_state = "heavy_6";
	pixel_x = 0;
	pixel_y = 24
	},
/obj/structure/flora/jungle/vines,
/turf/open/gm/grass,
/area/lv624/ground/jungle/south_east_jungle)
"Zp" = (
/obj/structure/flora/bush/ausbushes/var3/sparsegrass,
/turf/open/gm/grass,
/area/lv624/ground/jungle/south_east_jungle)

(1,1,1) = {"
LV
nI
gO
LW
LW
jc
ur
XB
XR
ug
qo
qo
qo
qo
"}
(2,1,1) = {"
gO
zg
gO
LW
aK
al
UA
UA
qo
qo
qo
qo
qo
UA
"}
(3,1,1) = {"
nI
LW
LW
LW
UA
Wl
Wl
WQ
WQ
XS
jc
jc
Yr
aK
"}
(4,1,1) = {"
cC
LW
Wr
XN
YD
Wl
CW
Xl
Xl
eR
XS
XS
aK
aK
"}
(5,1,1) = {"
LW
YD
YD
qo
UA
xk
EZ
Xl
Xy
Xy
EZ
Wl
Yz
aK
"}
(6,1,1) = {"
LW
LW
XN
qo
qo
Wl
Uc
Xy
Xy
Xy
un
xk
rA
aK
"}
(7,1,1) = {"
qo
UA
YD
qo
qo
Wt
gU
Xz
Xy
Xl
Xl
Xl
Ze
qo
"}
(8,1,1) = {"
qo
qo
qo
qo
qo
xk
EZ
Xy
Xy
Xy
Xl
Xl
Ze
qo
"}
(9,1,1) = {"
qo
aK
kd
Tl
aK
Wl
yg
Xy
Xl
br
EZ
Wl
Zi
qo
"}
(10,1,1) = {"
aK
aK
qo
qo
qo
Wp
EZ
Xy
Xy
EZ
Be
Wl
lV
qo
"}
(11,1,1) = {"
qo
qo
Zp
qo
qo
Wp
EZ
Xy
Xy
EZ
uk
Wl
XB
qo
"}
(12,1,1) = {"
qo
qo
qo
aK
qo
Wp
NU
yg
EZ
Xl
Ze
wQ
qo
qo
"}
(13,1,1) = {"
qo
qo
aK
aK
aK
Wl
Wl
Wl
xk
Wl
qo
qo
qo
qo
"}
(14,1,1) = {"
aK
aK
aK
aK
aK
aK
aK
Ya
qo
qo
qo
VR
qo
aK
"}
(15,1,1) = {"
aK
aK
aK
aK
aK
aK
aK
aK
qo
qo
qo
qo
aK
aK
"}
