//MAP CONVERTED BY dmm2tgm.py THIS HEADER COMMENT PREVENTS RECONVERSION, DO NOT REMOVE
"a" = (
/turf/closed/wall/shiva/prefabricated/pink,
/area/shiva/interior/lz2_habs)
"b" = (
/obj/structure/surface/rack,
/obj/effect/spawner/random/toy,
/turf/open/floor/shiva/floor3,
/area/shiva/interior/lz2_habs)
"c" = (
/turf/open/auto_turf/snow/layer4,
/area/shiva/exterior/cp_lz2)
"d" = (
/turf/closed/wall/shiva/ice,
/area/shiva/interior/caves/s_lz2)
"e" = (
/obj/effect/decal/cleanable/dirt,
/turf/open/floor/shiva/multi_tiles,
/area/shiva/interior/lz2_habs)
"f" = (
/obj/structure/machinery/door/airlock/multi_tile/almayer/generic2/autoname,
/turf/open/floor/plating/plating_catwalk/shiva,
/area/shiva/interior/lz2_habs)
"i" = (
/turf/closed/wall/shiva/ice,
/area/shiva/interior/oob)
"k" = (
/turf/open/floor/shiva/floor3,
/area/shiva/interior/lz2_habs)
"l" = (
/turf/open/floor/shiva/multi_tiles,
/area/shiva/interior/lz2_habs)
"m" = (
/obj/effect/decal/cleanable/ash,
/turf/open/floor/shiva/multi_tiles,
/area/shiva/interior/lz2_habs)
"n" = (
/turf/open/auto_turf/snow/layer3,
/area/shiva/exterior/cp_lz2)
"o" = (
/turf/open/floor/shiva/north,
/area/shiva/interior/lz2_habs)
"p" = (
/obj/structure/surface/rack,
/obj/effect/spawner/random/tool,
/obj/effect/spawner/random/powercell,
/turf/open/floor/shiva/floor3,
/area/shiva/interior/lz2_habs)
"q" = (
/turf/open/floor/shiva/radiator_tile,
/area/shiva/interior/lz2_habs)
"r" = (
/turf/open/auto_turf/ice/layer2,
/area/shiva/interior/caves/s_lz2)
"s" = (
/obj/structure/machinery/space_heater,
/obj/structure/machinery/light/small{
	dir = 4
	},
/turf/open/floor/shiva/floor3,
/area/shiva/interior/lz2_habs)
"t" = (
/obj/structure/surface/rack,
/obj/item/weapon/ice_axe/red,
/turf/open/floor/shiva/floor3,
/area/shiva/interior/lz2_habs)
"v" = (
/obj/structure/surface/rack,
/obj/item/reagent_container/food/snacks/sliceable/bananabread,
/turf/open/floor/shiva/floor3,
/area/shiva/interior/lz2_habs)
"w" = (
/obj/structure/machinery/light/double{
	dir = 4;
	pixel_y = -5
	},
/turf/open/floor/shiva/radiator_tile,
/area/shiva/interior/lz2_habs)
"x" = (
/turf/open/auto_turf/ice/layer1,
/area/shiva/interior/caves/s_lz2)
"y" = (
/obj/structure/largecrate/random/mini/small_case/b{
	pixel_x = 7;
	pixel_y = -3
	},
/obj/structure/largecrate/random/mini/small_case/c{
	pixel_y = -3;
	pixel_x = -8
	},
/obj/structure/largecrate/random/mini/small_case{
	pixel_y = 8
	},
/obj/structure/machinery/light/small{
	dir = 8
	},
/turf/open/floor/shiva/floor3,
/area/shiva/interior/lz2_habs)
"z" = (
/obj/structure/machinery/door/poddoor/shutters/almayer{
	density = 0;
	dir = 2;
	id = "nlz_shutters";
	name = "\improper Bio-lab Shutters"
	},
/turf/open/floor/shiva/floor3,
/area/shiva/interior/lz2_habs)
"B" = (
/obj/structure/machinery/door/poddoor/shutters/almayer{
	density = 0;
	dir = 2;
	id = "nlz_shutters";
	name = "\improper Bio-lab Shutters"
	},
/turf/open/floor/shiva/north,
/area/shiva/interior/lz2_habs)
"C" = (
/obj/structure/machinery/light/double{
	dir = 8;
	pixel_y = -5
	},
/turf/open/floor/shiva/radiator_tile,
/area/shiva/interior/lz2_habs)
"D" = (
/turf/open/auto_turf/ice/layer0,
/area/shiva/interior/caves/s_lz2)
"F" = (
/obj/effect/decal/cleanable/dirt,
/turf/open/floor/shiva/north,
/area/shiva/interior/lz2_habs)
"G" = (
/obj/item/shard{
	icon_state = "large";
	name = "ice shard"
	},
/turf/closed/wall/shiva/prefabricated/pink,
/area/shiva/interior/lz2_habs)
"H" = (
/turf/open/auto_turf/snow/layer2,
/area/shiva/interior/caves/s_lz2)
"I" = (
/obj/structure/machinery/light/double{
	dir = 4;
	pixel_y = -5
	},
/obj/effect/decal/cleanable/dirt,
/turf/open/floor/shiva/floor3,
/area/shiva/interior/lz2_habs)
"K" = (
/obj/structure/machinery/light/double{
	dir = 8;
	pixel_y = -5
	},
/turf/open/floor/shiva/floor3,
/area/shiva/interior/lz2_habs)
"L" = (
/obj/effect/decal/cleanable/dirt,
/turf/open/floor/shiva/floor3,
/area/shiva/interior/lz2_habs)
"P" = (
/obj/structure/bed/chair{
	dir = 1
	},
/turf/open/floor/shiva/north,
/area/shiva/interior/lz2_habs)
"Q" = (
/obj/item/clothing/shoes/snow,
/obj/structure/surface/rack,
/obj/item/clothing/shoes/snow,
/obj/item/clothing/suit/storage/snow_suit,
/obj/item/clothing/suit/storage/snow_suit,
/obj/item/tank/emergency_oxygen/engi,
/obj/effect/decal/strata_decals/grime/grime3{
	dir = 8
	},
/obj/item/clothing/mask/rebreather,
/obj/item/tank/emergency_oxygen/engi,
/obj/item/clothing/mask/rebreather,
/turf/open/floor/shiva/multi_tiles/north,
/area/shiva/interior/lz2_habs)
"S" = (
/obj/effect/decal/cleanable/dirt,
/turf/open/floor/plating/plating_catwalk/shiva,
/area/shiva/interior/lz2_habs)
"T" = (
/turf/open/floor/plating/plating_catwalk/shiva,
/area/shiva/interior/lz2_habs)
"U" = (
/obj/structure/surface/table,
/obj/effect/landmark/item_pool_spawner/survivor_ammo/buckshot,
/turf/open/floor/shiva/floor3,
/area/shiva/interior/lz2_habs)
"V" = (
/obj/structure/surface/table,
/obj/structure/largecrate/random/mini/chest/b{
	pixel_x = -1
	},
/turf/open/floor/shiva/floor3,
/area/shiva/interior/lz2_habs)
"W" = (
/turf/closed/wall/shiva/prefabricated/reinforced/hull,
/area/shiva/exterior/lz2_fortress)
"X" = (
/obj/item/weapon/gun/boltaction,
/obj/structure/surface/rack,
/obj/item/ammo_magazine/rifle/boltaction{
	pixel_y = -5;
	pixel_x = -6
	},
/obj/item/ammo_magazine/rifle/boltaction{
	pixel_y = -5;
	pixel_x = 2
	},
/turf/open/floor/shiva/floor3,
/area/shiva/interior/lz2_habs)
"Y" = (
/turf/open/floor/shiva/north,
/area/shiva/exterior/lz2_fortress)
"Z" = (
/obj/structure/machinery/light/double{
	dir = 1;
	pixel_y = 6
	},
/obj/effect/decal/cleanable/dirt,
/turf/open/floor/shiva/floor3,
/area/shiva/interior/lz2_habs)

(1,1,1) = {"
a
a
a
a
a
a
a
a
a
i
i
i
i
"}
(2,1,1) = {"
a
X
K
v
Q
y
a
a
a
i
i
i
i
"}
(3,1,1) = {"
f
L
F
o
F
o
B
C
z
D
D
i
i
"}
(4,1,1) = {"
T
k
o
T
S
o
B
S
z
x
D
D
D
"}
(5,1,1) = {"
a
Z
T
l
e
T
B
q
z
r
x
x
D
"}
(6,1,1) = {"
a
p
S
l
m
T
B
q
z
x
D
x
x
"}
(7,1,1) = {"
a
b
o
T
T
o
B
S
z
x
x
x
x
"}
(8,1,1) = {"
a
V
P
F
o
F
B
w
z
x
r
x
x
"}
(9,1,1) = {"
a
U
I
t
Q
s
a
a
a
d
x
x
x
"}
(10,1,1) = {"
a
G
a
a
a
G
a
a
a
d
d
x
r
"}
(11,1,1) = {"
Y
Y
Y
Y
Y
Y
W
W
W
W
W
W
H
"}
(12,1,1) = {"
Y
Y
Y
Y
Y
Y
W
W
W
W
W
W
c
"}
(13,1,1) = {"
Y
Y
Y
Y
Y
Y
Y
Y
W
W
c
c
n
"}
