//MAP CONVERTED BY dmm2tgm.py THIS HEADER COMMENT PREVENTS RECONVERSION, DO NOT REMOVE
"aI" = (
/turf/open/floor/prison/darkredfull2/southwest,
/area/prison/visitation)
"bR" = (
/obj/structure/pipes/vents/scrubber{
	dir = 4
	},
/obj/structure/bed/chair/office/dark{
	dir = 1
	},
/obj/item/shard/shrapnel,
/obj/effect/decal/cleanable/blood/oil,
/turf/open/floor/prison/darkredcorners2/east,
/area/prison/visitation)
"ch" = (
/obj/structure/pipes/vents/scrubber{
	dir = 8
	},
/obj/item/stack/sheet/metal,
/turf/open/floor/prison,
/area/prison/visitation)
"cu" = (
/obj/structure/pipes/vents/scrubber{
	dir = 8
	},
/turf/open/floor/prison,
/area/prison/visitation)
"dW" = (
/obj/structure/pipes/standard/simple/hidden/supply{
	dir = 4
	},
/turf/open/floor/prison,
/area/prison/visitation)
"eo" = (
/obj/structure/pipes/vents/pump{
	dir = 8
	},
/turf/open/floor/prison/darkred2/east,
/area/prison/visitation)
"eF" = (
/obj/structure/pipes/standard/simple/hidden/supply,
/obj/structure/disposalpipe/segment,
/obj/structure/machinery/door/airlock/multi_tile/almayer/generic{
	name = "Visitation";
	welded = 1
	},
/turf/open/floor/prison,
/area/prison/visitation)
"eR" = (
/obj/structure/pipes/standard/simple/hidden/supply,
/obj/item/stack/sheet/metal{
	pixel_x = -13;
	pixel_y = 14
	},
/obj/item/paper_bin{
	pixel_x = -3;
	pixel_y = 7
	},
/turf/open/floor/prison/darkredcorners2/east,
/area/prison/visitation)
"fj" = (
/obj/effect/decal/cleanable/blood,
/obj/effect/decal/cleanable/dirt,
/turf/open/floor/prison,
/area/prison/visitation)
"fF" = (
/obj/structure/bed/chair/office/dark,
/obj/effect/decal/cleanable/dirt,
/turf/open/floor/prison,
/area/prison/visitation)
"ge" = (
/obj/structure/pipes/standard/simple/hidden/supply,
/obj/item/stack/sheet/metal{
	pixel_x = -13;
	pixel_y = 14
	},
/obj/item/shard{
	icon_state = "medium"
	},
/obj/item/stack/cable_coil{
	amount = 1
	},
/obj/effect/decal/cleanable/blood/oil,
/turf/open/floor/prison,
/area/prison/visitation)
"hJ" = (
/turf/closed/wall/prison{
	damage = 200
	},
/area/prison/visitation)
"ja" = (
/obj/effect/decal/cleanable/dirt,
/turf/open/floor/prison,
/area/prison/visitation)
"jJ" = (
/obj/effect/decal/cleanable/blood,
/turf/open/floor/prison/damaged2/southwest,
/area/prison/visitation)
"kP" = (
/turf/open/floor/prison/darkred2/northwest,
/area/prison/visitation)
"lb" = (
/obj/structure/machinery/light/double/blue{
	dir = 1;
	pixel_y = 21
	},
/turf/open/floor/prison,
/area/prison/visitation)
"ma" = (
/obj/item/shard{
	icon_state = "small"
	},
/turf/open/floor/prison/damaged2,
/area/prison/visitation)
"mg" = (
/obj/item/shard{
	icon_state = "medium";
	pixel_x = -10;
	pixel_y = -8
	},
/obj/structure/surface/table/reinforced/prison,
/turf/open/floor/prison,
/area/prison/visitation)
"mu" = (
/obj/structure/window_frame/prison/reinforced,
/obj/item/shard{
	icon_state = "small"
	},
/turf/open/floor/plating/prison,
/area/prison/visitation)
"mY" = (
/obj/item/stack/sheet/metal{
	pixel_x = -13;
	pixel_y = 14
	},
/turf/open/floor/prison/darkredfull2/southwest,
/area/prison/visitation)
"nd" = (
/obj/structure/machinery/computer/secure_data,
/obj/structure/surface/table/reinforced/prison,
/obj/structure/machinery/light/double/blue{
	dir = 4;
	pixel_x = 10;
	pixel_y = -1
	},
/turf/open/floor/prison/darkredfull2/southwest,
/area/prison/visitation)
"ni" = (
/obj/structure/pipes/standard/manifold/hidden/supply,
/obj/item/tool/weldingtool/simple,
/turf/open/floor/prison,
/area/prison/visitation)
"nN" = (
/turf/open/floor/prison,
/area/prison/visitation)
"nZ" = (
/obj/structure/filingcabinet,
/turf/open/floor/prison/darkredfull2/southwest,
/area/prison/visitation)
"ol" = (
/obj/structure/machinery/door/airlock/almayer/security/glass/colony{
	name = "Security Booth"
	},
/turf/open/floor/prison,
/area/prison/visitation)
"pN" = (
/obj/structure/machinery/light/double/blue{
	pixel_y = -1
	},
/turf/open/floor/prison,
/area/prison/visitation)
"qt" = (
/turf/open/floor/prison/darkred2/northeast,
/area/prison/visitation)
"qy" = (
/turf/open/floor/prison/darkred2/southwest,
/area/prison/visitation)
"rh" = (
/obj/structure/bed/chair/office/dark{
	dir = 4
	},
/turf/open/floor/prison/darkred2/east,
/area/prison/visitation)
"rZ" = (
/turf/closed/wall/r_wall/prison,
/area/prison/visitation)
"sW" = (
/obj/structure/pipes/standard/simple/hidden/supply,
/obj/item/shard{
	icon_state = "medium"
	},
/turf/open/floor/prison/darkred2/northwest,
/area/prison/visitation)
"ua" = (
/obj/item/stack/sheet/metal,
/turf/open/floor/prison/darkred2/southeast,
/area/prison/visitation)
"uC" = (
/obj/structure/pipes/standard/simple/hidden/supply{
	dir = 4
	},
/obj/structure/machinery/door/airlock/multi_tile/almayer/generic{
	dir = 2;
	name = "Visitation";
	welded = 1
	},
/turf/open/floor/prison,
/area/prison/visitation)
"uY" = (
/obj/structure/pipes/standard/manifold/hidden/supply{
	dir = 1
	},
/obj/effect/decal/cleanable/dirt,
/turf/open/floor/prison,
/area/prison/visitation)
"vp" = (
/obj/structure/pipes/standard/manifold/hidden/supply{
	dir = 1
	},
/turf/open/floor/prison,
/area/prison/visitation)
"we" = (
/obj/structure/machinery/computer/cameras{
	network = list("PRISON")
	},
/obj/structure/surface/table/reinforced/prison,
/turf/open/floor/prison/damaged2,
/area/prison/visitation)
"xn" = (
/turf/open/floor/prison/darkred2,
/area/prison/visitation)
"yq" = (
/obj/item/shard{
	icon_state = "small"
	},
/turf/open/floor/prison,
/area/prison/visitation)
"yZ" = (
/obj/structure/machinery/door/airlock/multi_tile/almayer/generic{
	name = "Visitation";
	welded = 1
	},
/turf/open/floor/prison,
/area/prison/visitation)
"zJ" = (
/obj/structure/bed/chair{
	dir = 4
	},
/turf/open/floor/prison,
/area/prison/visitation)
"AG" = (
/turf/closed/wall/prison,
/area/prison/visitation)
"BM" = (
/obj/structure/window_frame/prison/reinforced,
/turf/open/floor/plating/prison,
/area/prison/visitation)
"CA" = (
/obj/item/stack/sheet/metal,
/turf/open/floor/prison,
/area/prison/visitation)
"CM" = (
/obj/effect/decal/cleanable/dirt,
/turf/closed/wall/prison,
/area/prison/visitation)
"CU" = (
/obj/structure/machinery/alarm/almayer{
	dir = 1
	},
/turf/open/floor/prison,
/area/prison/visitation)
"Ds" = (
/obj/structure/pipes/standard/simple/hidden/supply{
	dir = 4
	},
/obj/item/tool/pen{
	pixel_x = 9;
	pixel_y = 8
	},
/turf/open/floor/prison/damaged2/southwest,
/area/prison/visitation)
"Hu" = (
/obj/structure/bed/chair{
	dir = 1
	},
/turf/open/floor/prison,
/area/prison/visitation)
"HI" = (
/turf/open/floor/prison/damaged2/southwest,
/area/prison/visitation)
"JK" = (
/turf/closed/wall/prison{
	damage = 600
	},
/area/prison/visitation)
"JQ" = (
/turf/open/floor/prison/damaged2,
/area/prison/visitation)
"KJ" = (
/obj/structure/pipes/standard/simple/hidden/supply,
/turf/open/floor/prison,
/area/prison/visitation)
"Mx" = (
/obj/structure/window/framed/prison/reinforced,
/turf/open/floor/plating/prison,
/area/prison/visitation)
"MD" = (
/obj/item/stack/cable_coil{
	amount = 1
	},
/turf/open/floor/prison/damaged2/southwest,
/area/prison/visitation)
"NL" = (
/obj/structure/surface/table/reinforced/prison,
/turf/open/floor/prison,
/area/prison/visitation)
"NT" = (
/obj/item/device/flashlight/lamp,
/obj/effect/landmark/item_pool_spawner/prison_lock,
/obj/structure/surface/table/reinforced/prison,
/turf/open/floor/prison/darkredfull2/southwest,
/area/prison/visitation)
"OV" = (
/obj/effect/landmark/corpsespawner/prisoner,
/turf/open/floor/prison/darkred2/northwest,
/area/prison/visitation)
"Ri" = (
/obj/effect/decal/cleanable/dirt,
/obj/effect/decal/cleanable/dirt,
/obj/effect/landmark/corpsespawner/prisoner,
/turf/open/floor/prison,
/area/prison/visitation)
"RW" = (
/obj/structure/pipes/vents/pump{
	dir = 4
	},
/obj/item/shard/shrapnel,
/turf/open/floor/prison/damaged2/southwest,
/area/prison/visitation)
"So" = (
/obj/structure/pipes/vents/pump{
	dir = 4
	},
/turf/open/floor/prison,
/area/prison/visitation)
"Tb" = (
/obj/effect/decal/cleanable/blood,
/turf/open/floor/prison,
/area/prison/visitation)
"Tz" = (
/obj/structure/machinery/power/apc{
	dir = 1;
	pixel_y = 24;
	start_charge = 0
	},
/turf/open/floor/prison,
/area/prison/visitation)
"Vz" = (
/obj/structure/bed/chair/office/dark,
/turf/open/floor/prison,
/area/prison/visitation)
"XF" = (
/turf/open/floor/prison/damaged1,
/area/prison/visitation)
"Zh" = (
/obj/structure/flora/pottedplant,
/obj/structure/machinery/light/double/blue{
	dir = 4;
	pixel_x = 10;
	pixel_y = -1
	},
/turf/open/floor/prison,
/area/prison/visitation)
"Zt" = (
/obj/structure/machinery/computer/cameras{
	network = list("PRISON")
	},
/obj/structure/surface/table/reinforced/prison,
/turf/open/floor/prison/darkredfull2/southwest,
/area/prison/visitation)
"ZE" = (
/obj/structure/pipes/standard/manifold/hidden/supply,
/turf/open/floor/prison,
/area/prison/visitation)

(1,1,1) = {"
rZ
CM
AG
AG
AG
AG
AG
AG
AG
rZ
"}
(2,1,1) = {"
AG
nN
ja
fF
NL
Mx
Hu
nN
zJ
AG
"}
(3,1,1) = {"
Mx
nN
nN
nN
AG
CM
AG
nN
So
Mx
"}
(4,1,1) = {"
yZ
nN
nN
Vz
NL
Mx
Hu
nN
uY
eF
"}
(5,1,1) = {"
nN
nN
nN
nN
AG
AG
AG
nN
dW
nN
"}
(6,1,1) = {"
Mx
nN
Tb
fF
mg
BM
Hu
nN
cu
Mx
"}
(7,1,1) = {"
AG
nN
nN
nN
AG
AG
AG
Tb
nN
AG
"}
(8,1,1) = {"
rZ
lb
nN
fF
NL
mu
Hu
nN
pN
AG
"}
(9,1,1) = {"
rZ
nN
XF
nN
hJ
AG
hJ
nN
nN
AG
"}
(10,1,1) = {"
rZ
nN
nN
fj
JK
JK
JK
yq
nN
AG
"}
(11,1,1) = {"
rZ
nN
XF
Ri
HI
JQ
nN
jJ
nN
AG
"}
(12,1,1) = {"
rZ
nN
CA
Tb
HI
ma
JQ
nN
nN
AG
"}
(13,1,1) = {"
rZ
nN
yq
RW
JQ
nN
HI
ol
Mx
rZ
"}
(14,1,1) = {"
rZ
CU
nN
dW
MD
mY
we
kP
qy
rZ
"}
(15,1,1) = {"
rZ
Tz
HI
Ds
HI
aI
OV
bR
xn
rZ
"}
(16,1,1) = {"
rZ
nN
nN
vp
ge
sW
eR
ZE
xn
rZ
"}
(17,1,1) = {"
rZ
ch
KJ
ni
mu
qt
rh
eo
ua
rZ
"}
(18,1,1) = {"
rZ
Zh
nN
dW
rZ
Zt
nd
NT
nZ
rZ
"}
(19,1,1) = {"
rZ
rZ
nN
uC
rZ
rZ
rZ
rZ
rZ
rZ
"}
