//MAP CONVERTED BY dmm2tgm.py THIS HEADER COMMENT PREVENTS RECONVERSION, DO NOT REMOVE
"a" = (
/obj/effect/landmark/nightmare{
	insert_tag = "hvhuscmlz2"
	},
/turf/open/floor/plating/icefloor/asteroidplating,
/area/varadero/exterior/lz2_near)
"b" = (
/obj/docking_port/stationary/marine_dropship/lz2{
	name = "LZ2: LACN Navybase Port";
	faction = "Yautja"
	},
/turf/open/floor/plating/icefloor/asteroidplating,
/area/varadero/exterior/lz2_near)
"c" = (
/turf/open/floor/plating/almayer,
/area/varadero/exterior/lz2_near)
"d" = (
/turf/open/floor/plating/icefloor/asteroidplating,
/area/varadero/exterior/lz2_near)

(1,1,1) = {"
d
c
a
"}
(2,1,1) = {"
c
b
c
"}
(3,1,1) = {"
d
c
d
"}
