//MAP CONVERTED BY dmm2tgm.py THIS HEADER COMMENT PREVENTS RECONVERSION, DO NOT REMOVE
"a" = (
/turf/open/floor/plating/icefloor/asteroidplating,
/area/varadero/exterior/lz2_near)
"b" = (
/obj/docking_port/stationary/marine_dropship/lz2{
	name = "LZ2: LACN Navybase Port";
	faction = "Yautja"
	},
/turf/open/floor/plating/icefloor/asteroidplating,
/area/varadero/exterior/lz2_near)
"c" = (
/turf/open/floor/plating/almayer,
/area/varadero/exterior/lz2_near)
"d" = (
/obj/effect/landmark/nightmare{
	insert_tag = "hvhuscmlz2"
	},
/turf/open/floor/plating/icefloor/asteroidplating,
/area/varadero/exterior/lz2_near)

(1,1,1) = {"
a
c
d
"}
(2,1,1) = {"
c
b
c
"}
(3,1,1) = {"
a
c
a
"}
