//MAP CONVERTED BY dmm2tgm.py THIS HEADER COMMENT PREVENTS RECONVERSION, DO NOT REMOVE
"a" = (
/obj/structure/machinery/light{
	dir = 4;
	on = 1;
	needs_power = 0
	},
/turf/open/floor/almayer/sterile_green,
/area/misc/tutorial/no_baselight)
"b" = (
/obj/structure/surface/table/almayer,
/turf/open/floor/almayer/sterile_green_side,
/area/misc/tutorial/no_baselight)
"c" = (
/obj/effect/landmark/tutorial_bottom_left,
/obj/structure/machinery/light{
	needs_power = 0
	},
/turf/open/floor/almayer/sterile_green,
/area/misc/tutorial/no_baselight)
"d" = (
/obj/structure/bed/chair/comfy/beige,
/turf/open/floor/almayer/dark_sterile,
/area/misc/tutorial/no_baselight)
"e" = (
/turf/open/floor/almayer/sterile_green_side/east,
/area/misc/tutorial/no_baselight)
"g" = (
/obj/structure/machinery/cm_vending/sorted/medical/blood/bolted,
/turf/open/floor/almayer/sterile_green,
/area/misc/tutorial/no_baselight)
"j" = (
/obj/structure/machinery/door/airlock/almayer/medical{
	lights = 0;
	not_weldable = 1;
	heavy = 1;
	needs_power = 0;
	use_power = 0;
	breakable = 0;
	unslashable = 1;
	req_one_access = null
	},
/turf/closed/wall/almayer/white/hull,
/area/misc/tutorial/no_baselight)
"n" = (
/obj/structure/surface/table/almayer,
/obj/item/device/flashlight/lamp{
	on = 1
	},
/turf/open/floor/almayer/dark_sterile,
/area/misc/tutorial/no_baselight)
"o" = (
/turf/open/floor/almayer/sterile_green,
/area/misc/tutorial/no_baselight)
"p" = (
/obj/structure/machinery/light{
	dir = 1;
	on = 1;
	needs_power = 0
	},
/turf/open/floor/almayer/sterile_green_corner/north,
/area/misc/tutorial/no_baselight)
"q" = (
/obj/structure/foamed_metal,
/turf/open/floor/almayer/sterile_green,
/area/misc/tutorial/no_baselight)
"s" = (
/obj/item/storage/firstaid/toxin{
	pixel_x = 6;
	pixel_y = 6
	},
/obj/item/storage/firstaid/fire{
	pixel_x = 3;
	pixel_y = 3
	},
/obj/item/storage/firstaid/o2,
/obj/item/storage/firstaid/adv{
	pixel_x = 6;
	pixel_y = 6
	},
/obj/item/storage/firstaid/adv{
	pixel_x = 3;
	pixel_y = 3
	},
/obj/item/storage/firstaid/adv,
/obj/item/device/healthanalyzer,
/obj/structure/surface/table/reinforced/prison,
/obj/structure/machinery/light{
	dir = 1;
	on = 1;
	needs_power = 0
	},
/turf/open/floor/almayer/sterile_green,
/area/misc/tutorial/no_baselight)
"t" = (
/obj/structure/window/framed/almayer/white/hull,
/turf/open/floor/almayer/sterile_green,
/area/misc/tutorial/no_baselight)
"v" = (
/obj/structure/machinery/door/airlock/multi_tile/almayer/medidoor{
	dir = 1
	},
/turf/open/floor/almayer/dark_sterile,
/area/misc/tutorial/no_baselight)
"w" = (
/turf/open/floor/almayer/sterile_green_side/north,
/area/misc/tutorial/no_baselight)
"x" = (
/obj/structure/surface/table/almayer,
/obj/structure/machinery/recharger,
/obj/item/device/defibrillator,
/obj/item/device/defibrillator,
/obj/item/device/defibrillator,
/obj/item/device/defibrillator,
/obj/structure/machinery/light{
	dir = 1;
	on = 1;
	needs_power = 0
	},
/turf/open/floor/almayer/sterile_green_corner,
/area/misc/tutorial/no_baselight)
"E" = (
/obj/structure/machinery/chem_dispenser/corpsman,
/obj/structure/machinery/light{
	dir = 4;
	on = 1;
	needs_power = 0
	},
/turf/open/floor/almayer/sterile_green,
/area/misc/tutorial/no_baselight)
"F" = (
/obj/structure/bed,
/obj/item/bedsheet/medical,
/turf/open/floor/almayer/sterile_green_corner/east,
/area/misc/tutorial/no_baselight)
"I" = (
/turf/open/floor/almayer/dark_sterile,
/area/misc/tutorial/no_baselight)
"K" = (
/obj/structure/machinery/door/airlock/multi_tile/almayer/medidoor/solid{
	dir = 2;
	locked = 1;
	no_panel = 1;
	lights = 0
	},
/turf/closed/wall/almayer/white/hull,
/area/misc/tutorial/no_baselight)
"O" = (
/turf/closed/wall/almayer/white/hull,
/area/misc/tutorial/no_baselight)
"P" = (
/obj/structure/machinery/door/airlock/almayer/medical{
	lights = 0;
	not_weldable = 1;
	heavy = 1;
	needs_power = 0;
	use_power = 0;
	breakable = 0;
	unslashable = 1;
	req_one_access = null
	},
/turf/open/floor/almayer/dark_sterile,
/area/misc/tutorial/no_baselight)
"Q" = (
/obj/structure/machinery/light{
	dir = 1;
	on = 1;
	needs_power = 0
	},
/turf/open/floor/almayer/dark_sterile,
/area/misc/tutorial/no_baselight)
"R" = (
/obj/structure/bed,
/obj/item/bedsheet/medical,
/turf/open/floor/almayer/sterile_green_corner/west,
/area/misc/tutorial/no_baselight)
"V" = (
/obj/structure/surface/table/almayer,
/turf/open/floor/almayer/dark_sterile,
/area/misc/tutorial/no_baselight)
"X" = (
/obj/structure/machinery/cm_vending/sorted/medical/marinemed,
/turf/open/floor/almayer/sterile_green,
/area/misc/tutorial/no_baselight)
"Y" = (
/turf/open/floor/almayer/sterile_green_side/west,
/area/misc/tutorial/no_baselight)
"Z" = (
/obj/structure/bed,
/obj/item/bedsheet/medical,
/obj/structure/machinery/light{
	needs_power = 0
	},
/turf/open/floor/almayer/sterile_green_side,
/area/misc/tutorial/no_baselight)

(1,1,1) = {"
O
O
O
O
O
O
O
K
O
O
"}
(2,1,1) = {"
O
q
q
q
O
s
I
I
c
O
"}
(3,1,1) = {"
O
q
q
q
O
X
I
I
o
O
"}
(4,1,1) = {"
O
q
q
q
O
o
I
I
g
O
"}
(5,1,1) = {"
O
q
q
q
O
a
I
I
E
O
"}
(6,1,1) = {"
O
j
O
O
O
O
I
v
O
O
"}
(7,1,1) = {"
O
I
I
O
p
Y
Y
Y
R
O
"}
(8,1,1) = {"
O
Q
V
t
w
I
o
I
Z
O
"}
(9,1,1) = {"
O
d
V
t
w
o
o
o
b
O
"}
(10,1,1) = {"
O
Q
n
t
w
I
o
I
Z
O
"}
(11,1,1) = {"
O
I
I
O
x
e
e
e
F
O
"}
(12,1,1) = {"
O
j
O
O
O
P
O
P
O
O
"}
(13,1,1) = {"
O
q
q
q
O
I
O
I
O
O
"}
(14,1,1) = {"
O
q
q
q
O
I
I
I
O
O
"}
(15,1,1) = {"
O
O
O
O
O
O
O
O
O
O
"}
