//MAP CONVERTED BY dmm2tgm.py THIS HEADER COMMENT PREVENTS RECONVERSION, DO NOT REMOVE
"a" = (
/turf/closed/wall/almayer/outer,
/area/misc/tutorial)
"f" = (
/obj/effect/landmark/tutorial_bottom_left,
/turf/open/floor/almayer,
/area/misc/tutorial)
"k" = (
/obj/structure/machinery/door/airlock/almayer/engineering,
/obj/effect/landmark/tutorial_tracking_marker{
	tracking_target_type = /obj/structure/machinery/door/airlock/almayer/engineering
	},
/turf/open/floor/almayer,
/area/misc/tutorial)
"r" = (
/obj/structure/surface/table/almayer,
/obj/item/device/reagent_scanner/adv/objective,
/obj/effect/landmark/tutorial_tracking_marker{
	tracking_target_type = /obj/item/device/reagent_scanner/adv/objective
	},
/turf/open/floor/almayer,
/area/misc/tutorial)
"M" = (
/turf/open/floor/almayer,
/area/misc/tutorial)
"R" = (
/obj/structure/surface/table/almayer,
/obj/effect/landmark/tutorial_tracking_marker{
	tracking_target_type = /obj/structure/surface/table/almayer
	},
/turf/open/floor/almayer,
/area/misc/tutorial)

(1,1,1) = {"
a
a
a
a
a
a
a
a
"}
(2,1,1) = {"
a
r
M
M
M
M
f
a
"}
(3,1,1) = {"
a
M
M
M
M
M
M
a
"}
(4,1,1) = {"
a
R
M
M
M
M
M
a
"}
(5,1,1) = {"
a
M
M
M
M
M
M
a
"}
(6,1,1) = {"
a
k
M
M
M
M
M
a
"}
(7,1,1) = {"
a
M
M
M
M
M
M
a
"}
(8,1,1) = {"
a
a
a
a
a
a
a
a
"}
