//MAP CONVERTED BY dmm2tgm.py THIS HEADER COMMENT PREVENTS RECONVERSION, DO NOT REMOVE
"a" = (
/turf/open/gm/grass,
/area/lv624/ground/jungle5)
"b" = (
/turf/closed/gm/dense{
	icon_state = "wall2"
	},
/area/lv624/ground/jungle5)
"c" = (
/obj/effect/landmark/lv624/fog_blocker,
/turf/open/gm/grass{
	icon_state = "grass2"
	},
/area/lv624/ground/jungle5)
"d" = (
/obj/effect/landmark/lv624/fog_blocker,
/turf/open/gm/grass,
/area/lv624/ground/jungle5)
"e" = (
/obj/effect/landmark/lv624/fog_blocker,
/turf/open/gm/dirtgrassborder{
	dir = 4
	},
/area/lv624/ground/jungle5)
"f" = (
/obj/effect/landmark/lv624/fog_blocker,
/turf/open/gm/coast{
	dir = 8;
	icon_state = "beachcorner"
	},
/area/lv624/ground/river3)
"i" = (
/turf/open/gm/dirtgrassborder{
	dir = 8;
	icon_state = "grassdirt_corner"
	},
/area/lv624/ground/jungle5)
"j" = (
/turf/open/gm/dirtgrassborder{
	dir = 1
	},
/area/lv624/ground/jungle5)
"l" = (
/obj/structure/machinery/colony_floodlight,
/turf/open/gm/grass,
/area/lv624/ground/jungle5)
"n" = (
/turf/closed/wall,
/area/lv624/lazarus/quartstorage)
"o" = (
/obj/effect/landmark{
	name = "monkey_spawn"
	},
/turf/open/gm/grass,
/area/lv624/ground/jungle5)
"p" = (
/obj/structure/window/framed/colony/reinforced,
/turf/open/floor/plating,
/area/lv624/lazarus/quartstorage)
"q" = (
/obj/structure/machinery/light/small{
	dir = 1
	},
/turf/open/floor/vault,
/area/lv624/lazarus/quartstorage)
"r" = (
/turf/open/floor/vault,
/area/lv624/lazarus/quartstorage)
"s" = (
/obj/structure/largecrate/supply/weapons/sentries{
	unslashable = 1;
	unacidable = 1
	},
/turf/open/floor/vault,
/area/lv624/lazarus/quartstorage)
"t" = (
/obj/structure/largecrate/supply/explosives/mines{
	unslashable = 1;
	unacidable = 1
	},
/turf/open/floor/vault,
/area/lv624/lazarus/quartstorage)
"u" = (
/obj/structure/window_frame/colony,
/turf/open/floor/plating,
/area/lv624/lazarus/quartstorage)
"v" = (
/obj/structure/largecrate,
/turf/open/floor/vault,
/area/lv624/lazarus/quartstorage)
"w" = (
/obj/effect/landmark/lv624/xeno_tunnel,
/turf/open/gm/grass,
/area/lv624/ground/jungle5)

(1,1,1) = {"
b
a
a
n
n
q
v
r
"}
(2,1,1) = {"
a
a
a
a
p
r
r
r
"}
(3,1,1) = {"
a
a
a
a
p
s
r
r
"}
(4,1,1) = {"
b
a
l
a
p
t
r
r
"}
(5,1,1) = {"
c
a
a
o
n
u
p
p
"}
(6,1,1) = {"
d
a
a
a
a
a
a
w
"}
(7,1,1) = {"
e
i
a
o
a
a
a
a
"}
(8,1,1) = {"
f
j
a
a
a
a
a
a
"}
