//MAP CONVERTED BY dmm2tgm.py THIS HEADER COMMENT PREVENTS RECONVERSION, DO NOT REMOVE
"a" = (
/turf/open/gm/dirt,
/area/lv624/ground/caves/central3)
"b" = (
/turf/closed/wall/resin/ondirt,
/area/lv624/ground/caves/central3)
"c" = (
/turf/closed/wall/rock/brown,
/area/lv624/ground/caves/central3)
"d" = (
/turf/closed/wall/rock/brown,
/area/lv624/ground/caves/central1)
"e" = (
/turf/closed/wall/resin/ondirt,
/area/lv624/ground/caves/central1)
"f" = (
/turf/open/gm/dirt,
/area/lv624/ground/caves/central1)
"g" = (
/obj/effect/alien/weeds/node,
/turf/open/gm/dirt,
/area/lv624/ground/caves/central3)
"h" = (
/obj/effect/alien/weeds/node,
/turf/open/gm/dirt,
/area/lv624/ground/caves/central1)
"i" = (
/obj/effect/landmark{
	name = "hunter_primary"
	},
/turf/open/gm/dirt,
/area/lv624/ground/caves/central3)
"j" = (
/obj/structure/mineral_door/resin,
/turf/open/gm/dirt,
/area/lv624/ground/caves/central3)
"k" = (
/turf/open/gm/dirt,
/area/lv624/ground/sand5)
"l" = (
/turf/closed/wall/rock/brown,
/area/lv624/ground/sand5)
"m" = (
/obj/structure/mineral_door/resin,
/turf/open/gm/dirt,
/area/lv624/ground/caves/central1)
"n" = (
/obj/structure/mineral_door/resin,
/obj/structure/blocker/forcefield/vehicles,
/turf/open/gm/dirt,
/area/lv624/ground/caves/central3)
"o" = (
/obj/effect/alien/weeds/node,
/turf/open/gm/dirt,
/area/lv624/ground/sand5)
"q" = (
/obj/structure/fence,
/turf/open/floor/greengrid,
/area/lv624/ground/sand5)
"r" = (
/obj/structure/fence,
/turf/open/floor{
	dir = 1;
	icon_state = "warning"
	},
/area/lv624/ground/sand5)

(1,1,1) = {"
a
a
a
a
i
a
a
a
a
j
a
g
a
b
c
c
c
c
c
c
c
"}
(2,1,1) = {"
a
a
a
a
a
a
a
a
a
j
a
b
b
b
c
c
c
c
c
k
o
"}
(3,1,1) = {"
a
a
a
g
a
c
a
a
a
b
b
b
c
c
c
c
c
c
c
k
k
"}
(4,1,1) = {"
a
a
a
a
c
c
c
a
a
g
c
c
c
c
c
c
c
c
c
k
k
"}
(5,1,1) = {"
b
a
a
b
c
c
c
a
a
a
a
b
a
a
b
a
g
a
c
k
k
"}
(6,1,1) = {"
c
a
g
a
b
b
c
c
a
a
a
a
a
a
a
a
a
a
n
k
k
"}
(7,1,1) = {"
c
a
a
a
a
a
a
a
a
a
a
a
a
a
a
a
a
a
n
k
k
"}
(8,1,1) = {"
c
a
a
a
a
a
g
a
a
a
a
a
g
a
a
a
a
a
n
k
k
"}
(9,1,1) = {"
c
b
a
a
a
a
a
a
a
a
a
a
a
a
a
g
a
c
c
l
k
"}
(10,1,1) = {"
c
c
c
c
a
a
a
a
a
g
a
a
a
a
a
a
a
j
c
l
l
"}
(11,1,1) = {"
c
c
c
c
b
a
a
a
a
a
a
i
a
c
c
a
a
b
c
l
l
"}
(12,1,1) = {"
c
c
c
c
c
b
a
g
a
a
a
b
b
c
c
c
c
c
c
l
l
"}
(13,1,1) = {"
c
c
c
c
c
c
a
a
a
a
a
a
b
c
c
c
c
c
c
l
l
"}
(14,1,1) = {"
d
d
d
d
d
d
d
d
a
d
d
d
d
d
d
d
d
d
d
l
l
"}
(15,1,1) = {"
d
d
d
d
d
d
d
d
d
d
d
d
d
d
d
d
d
d
d
l
l
"}
(16,1,1) = {"
d
d
d
d
d
d
d
d
d
d
d
d
d
d
d
d
d
d
d
l
l
"}
(17,1,1) = {"
d
d
d
d
d
d
d
d
d
d
d
d
d
d
d
d
d
d
d
l
l
"}
(18,1,1) = {"
d
d
d
d
d
d
d
d
d
d
d
d
d
d
d
d
d
d
d
l
l
"}
(19,1,1) = {"
d
d
d
d
d
d
d
d
d
d
d
d
d
f
f
f
d
d
d
l
l
"}
(20,1,1) = {"
d
d
f
f
d
d
d
d
d
d
d
d
f
f
f
f
d
d
d
l
l
"}
(21,1,1) = {"
d
f
f
f
f
d
d
f
e
e
e
f
f
h
f
d
d
d
d
l
l
"}
(22,1,1) = {"
d
d
f
f
f
f
f
f
f
f
f
f
f
f
f
f
d
d
d
l
l
"}
(23,1,1) = {"
d
f
f
f
f
f
f
f
f
h
f
f
f
f
f
f
f
e
d
l
l
"}
(24,1,1) = {"
d
e
f
f
h
f
f
f
f
f
f
d
d
f
f
f
f
f
d
l
l
"}
(25,1,1) = {"
d
e
f
f
f
f
f
f
e
d
d
d
d
d
f
f
f
f
d
l
l
"}
(26,1,1) = {"
d
e
f
f
f
f
f
e
e
d
d
d
d
d
f
h
f
f
d
l
l
"}
(27,1,1) = {"
d
e
e
f
f
f
d
d
d
d
d
d
d
d
f
f
f
d
d
l
q
"}
(28,1,1) = {"
d
d
d
f
f
d
d
d
d
d
d
d
d
d
f
f
f
d
d
l
r
"}
(29,1,1) = {"
d
d
d
f
f
d
d
d
d
d
d
d
d
d
m
m
d
d
d
l
r
"}
(30,1,1) = {"
d
d
f
h
f
d
d
d
d
d
d
d
d
l
k
k
l
k
k
k
r
"}
(31,1,1) = {"
d
d
f
f
f
d
d
d
d
d
d
d
d
l
k
k
k
k
k
k
r
"}
(32,1,1) = {"
d
d
f
f
d
d
d
d
d
d
d
d
d
k
k
k
k
k
k
k
r
"}
(33,1,1) = {"
d
f
f
f
f
f
f
d
d
f
f
d
k
k
k
k
k
k
k
k
r
"}
