//MAP CONVERTED BY dmm2tgm.py THIS HEADER COMMENT PREVENTS RECONVERSION, DO NOT REMOVE
"aa" = (
/turf/open/gm/dirt,
/area/lv624/ground/caves/central1)
"ab" = (
/turf/closed/wall/rock/brown,
/area/lv624/ground/caves/central1)
"ac" = (
/obj/effect/alien/weeds/node,
/turf/open/gm/dirt,
/area/lv624/ground/caves/central1)
"ad" = (
/turf/closed/wall/rock/brown,
/area/lv624/ground/caves/east1)
"ae" = (
/turf/closed/wall/rock/brown,
/area/lv624/ground/sand6)
"af" = (
/obj/structure/foamedmetal,
/turf/open/shuttle{
	icon_state = "floor4"
	},
/area/lv624/ground/sand6)
"ag" = (
/turf/closed/wall/r_wall,
/area/lv624/ground/sand6)
"ah" = (
/obj/structure/foamedmetal{
	layer = 4
	},
/turf/open/shuttle{
	icon_state = "floor4"
	},
/area/lv624/ground/sand6)
"ai" = (
/obj/effect/spider/stickyweb,
/turf/open/shuttle{
	icon_state = "floor4"
	},
/area/lv624/ground/sand6)
"aj" = (
/obj/effect/decal/remains/human,
/obj/item/explosive/grenade/HE,
/obj/effect/landmark{
	name = "good_item"
	},
/turf/open/shuttle{
	icon_state = "floor4"
	},
/area/lv624/ground/sand6)
"ak" = (
/turf/closed/wall/sulaco,
/area/lv624/ground/sand6)
"al" = (
/obj/structure/machinery/constructable_frame{
	icon_state = "box_1"
	},
/turf/open/shuttle{
	icon_state = "floor4"
	},
/area/lv624/ground/sand6)
"am" = (
/turf/open/shuttle{
	icon_state = "floor4"
	},
/area/lv624/ground/sand6)
"an" = (
/obj/structure/foamedmetal{
	layer = 3.5
	},
/turf/open/shuttle{
	icon_state = "floor4"
	},
/area/lv624/ground/sand6)
"ao" = (
/obj/structure/bed/chair{
	dir = 4
	},
/obj/effect/spider/stickyweb,
/turf/open/shuttle{
	icon_state = "floor4"
	},
/area/lv624/ground/sand6)
"ap" = (
/obj/effect/spider/stickyweb,
/obj/item/explosive/grenade/HE,
/turf/open/shuttle{
	icon_state = "floor4"
	},
/area/lv624/ground/sand6)
"aq" = (
/obj/structure/bed/chair{
	dir = 4
	},
/turf/open/shuttle{
	icon_state = "floor4"
	},
/area/lv624/ground/sand6)
"ar" = (
/obj/effect/decal/remains/human,
/turf/open/shuttle{
	icon_state = "floor4"
	},
/area/lv624/ground/sand6)
"as" = (
/obj/structure/foamedmetal,
/obj/structure/bed/chair{
	dir = 8
	},
/turf/open/shuttle{
	icon_state = "floor4"
	},
/area/lv624/ground/sand6)
"at" = (
/obj/effect/landmark/corpsespawner/security,
/turf/open/shuttle{
	icon_state = "floor4"
	},
/area/lv624/ground/sand6)
"au" = (
/obj/effect/spawner/random/toolbox,
/turf/open/shuttle{
	icon_state = "floor4"
	},
/area/lv624/ground/sand6)
"av" = (
/obj/structure/foamedmetal,
/obj/structure/bed/chair{
	dir = 8
	},
/obj/item/explosive/grenade/HE,
/turf/open/shuttle{
	icon_state = "floor4"
	},
/area/lv624/ground/sand6)
"aw" = (
/obj/item/tool/crowbar,
/turf/open/shuttle{
	icon_state = "floor4"
	},
/area/lv624/ground/sand6)
"ax" = (
/obj/structure/bed/chair{
	dir = 8
	},
/turf/open/shuttle{
	icon_state = "floor4"
	},
/area/lv624/ground/sand6)
"ay" = (
/turf/open/gm/dirt,
/area/lv624/ground/sand5)
"az" = (
/obj/item/ammo_casing,
/turf/open/shuttle{
	icon_state = "floor4"
	},
/area/lv624/ground/sand6)
"aA" = (
/obj/structure/bed/chair{
	dir = 4
	},
/obj/item/weapon/gun/shotgun/pump/cmb,
/turf/open/shuttle{
	icon_state = "floor4"
	},
/area/lv624/ground/sand6)
"aB" = (
/obj/item/stack/cable_coil/random,
/turf/open/shuttle{
	icon_state = "floor4"
	},
/area/lv624/ground/sand6)
"aC" = (
/obj/effect/alien/weeds/node,
/turf/open/gm/dirt,
/area/lv624/ground/sand5)
"aD" = (
/obj/item/storage/firstaid/adv,
/turf/open/shuttle{
	icon_state = "floor4"
	},
/area/lv624/ground/sand6)
"aE" = (
/obj/structure/girder,
/turf/open/gm/dirt,
/area/lv624/ground/sand6)
"aF" = (
/obj/item/clothing/suit/armor/bulletproof,
/turf/open/shuttle{
	icon_state = "floor4"
	},
/area/lv624/ground/sand6)
"aG" = (
/obj/structure/girder,
/turf/open/shuttle{
	icon_state = "floor4"
	},
/area/lv624/ground/sand6)
"aH" = (
/obj/effect/landmark{
	name = "crap_item"
	},
/turf/open/gm/dirt,
/area/lv624/ground/sand5)
"aI" = (
/turf/open/gm/dirt,
/area/lv624/ground/sand6)
"aJ" = (
/obj/structure/girder/displaced,
/turf/closed/shuttle{
	icon_state = "wall3"
	},
/area/lv624/ground/sand6)
"aK" = (
/obj/structure/foamedmetal,
/turf/open/gm/dirt,
/area/lv624/ground/sand6)
"aL" = (
/obj/structure/girder,
/turf/closed/shuttle{
	icon_state = "wall3"
	},
/area/lv624/ground/sand6)
"aM" = (
/obj/structure/foamedmetal{
	layer = 4
	},
/turf/open/gm/dirt,
/area/lv624/ground/sand6)
"aN" = (
/obj/structure/foamedmetal,
/obj/effect/decal/remains/human{
	layer = 2.9
	},
/turf/open/gm/dirt,
/area/lv624/ground/sand6)
"aO" = (
/turf/open/gm/dirt,
/area/lv624/ground/caves/east1)
"aP" = (
/turf/closed/wall,
/area/lv624/ground/sand5)
"aQ" = (
/turf/open/floor/airless{
	dir = 5;
	icon_state = "asteroidfloor"
	},
/area/lv624/ground/sand6)
"aR" = (
/obj/effect/alien/weeds/node,
/turf/open/gm/dirt,
/area/lv624/ground/caves/east1)
"aS" = (
/turf/closed/wall/rock/brown,
/area/lv624/ground/sand5)
"aT" = (
/obj/structure/rack,
/obj/item/stack/sheet/mineral/gold{
	amount = 2
	},
/obj/item/stack/sheet/mineral/platinum{
	pixel_x = -6
	},
/turf/open/floor{
	icon_state = "vault";
	dir = 8
	},
/area/lv624/ground/sand5)
"aU" = (
/obj/structure/rack,
/obj/item/stack/sheet/mineral/diamond{
	amount = 2
	},
/turf/open/floor{
	icon_state = "vault";
	dir = 8
	},
/area/lv624/ground/sand5)
"aV" = (
/obj/structure/rack,
/obj/item/stack/sheet/metal{
	amount = 50;
	pixel_x = 4;
	pixel_y = 4
	},
/obj/item/stack/sheet/metal{
	amount = 30
	},
/turf/open/floor{
	icon_state = "vault";
	dir = 8
	},
/area/lv624/ground/sand5)
"aW" = (
/obj/structure/rack,
/obj/item/tool/shovel,
/turf/open/floor{
	icon_state = "vault";
	dir = 8
	},
/area/lv624/ground/sand5)
"aX" = (
/obj/structure/machinery/door/airlock/almayer/secure{
	dir = 4;
	icon_state = "door_locked";
	id = "";
	locked = 1;
	name = "Mining Storage"
	},
/turf/open/floor{
	icon_state = "dark"
	},
/area/lv624/ground/sand5)
"aY" = (
/turf/open/floor{
	icon_state = "dark"
	},
/area/lv624/ground/sand5)
"aZ" = (
/obj/structure/rack,
/obj/item/stack/sheet/mineral/iron{
	amount = 5
	},
/obj/item/stack/sheet/mineral/platinum,
/obj/structure/machinery/light{
	dir = 4;
	icon_state = "tube1"
	},
/turf/open/floor{
	icon_state = "vault";
	dir = 8
	},
/area/lv624/ground/sand5)
"ba" = (
/obj/effect/alien/weeds/node,
/turf/open/gm/dirt,
/area/lv624/ground/sand6)
"bb" = (
/obj/structure/rack,
/obj/item/stack/sheet/mineral/tritium{
	pixel_x = -4
	},
/turf/open/floor{
	icon_state = "vault";
	dir = 8
	},
/area/lv624/ground/sand5)
"bc" = (
/obj/structure/rack,
/obj/item/stack/sheet/mineral/silver{
	amount = 20
	},
/turf/open/floor{
	icon_state = "vault";
	dir = 8
	},
/area/lv624/ground/sand5)
"bd" = (
/obj/structure/rack,
/turf/open/floor{
	icon_state = "vault";
	dir = 8
	},
/area/lv624/ground/sand5)
"be" = (
/obj/structure/rack,
/obj/item/tool/pickaxe,
/turf/open/floor{
	icon_state = "vault";
	dir = 8
	},
/area/lv624/ground/sand5)
"bf" = (
/obj/effect/landmark{
	name = "crap_item"
	},
/turf/open/floor/airless{
	dir = 5;
	icon_state = "asteroidfloor"
	},
/area/lv624/ground/sand6)
"bg" = (
/obj/effect/decal/remains/human,
/turf/open/gm/dirt,
/area/lv624/ground/sand6)
"bh" = (
/obj/structure/shuttle/engine/propulsion,
/turf/open/gm/dirt,
/area/lv624/ground/sand6)
"bi" = (
/obj/effect/landmark{
	name = "crap_item"
	},
/turf/open/gm/dirt,
/area/lv624/ground/sand6)
"bj" = (
/obj/effect/landmark{
	name = "hunter_secondary"
	},
/turf/open/gm/dirt,
/area/lv624/ground/sand5)

(1,1,1) = {"
aa
ab
ab
ab
ab
ab
ab
ab
ab
ab
ab
ab
ab
ab
ab
ab
ab
ab
ab
aS
ay
ay
aS
ay
ay
ay
"}
(2,1,1) = {"
ab
ab
ab
ab
ab
ab
ab
ab
ab
ab
ab
ab
ab
ab
ab
ab
ab
ab
ab
aS
ay
ay
ay
ay
ay
ay
"}
(3,1,1) = {"
ab
ab
ab
ab
ab
ab
ab
ab
ab
ab
ab
ab
ab
ab
ab
ab
ab
ab
ab
ay
ay
ay
ay
ay
ay
ay
"}
(4,1,1) = {"
aa
ab
ab
ab
ab
ab
ab
ab
ab
ab
ab
ab
ab
ab
ab
ab
ab
ab
ay
ay
ay
ay
ay
ay
ay
ay
"}
(5,1,1) = {"
aa
ab
ab
ab
ab
ab
ab
ab
ab
ab
ab
ab
ab
ab
ab
ab
ab
ay
ay
ay
ay
aC
ay
ay
ay
bj
"}
(6,1,1) = {"
ab
ab
ab
ab
ab
ab
ab
ab
ab
ab
ab
ab
ab
ab
ab
ab
ay
ay
ay
ay
ay
ay
ay
ay
ay
ay
"}
(7,1,1) = {"
ab
ab
ab
ab
ab
ab
ab
ab
ab
ab
ab
ab
ab
ab
ab
ay
aC
ay
ay
ay
ay
ay
ay
ay
ay
ay
"}
(8,1,1) = {"
aa
ab
ab
ab
ab
ab
ab
ab
ab
ab
ab
ab
ab
ab
ab
ay
ay
ay
aP
aP
aX
aP
aP
ay
ay
ay
"}
(9,1,1) = {"
aa
ab
ab
ab
ab
ab
ab
ab
ab
ab
ab
ab
ab
ab
ab
aH
ay
ay
aP
aT
aY
bb
aP
ay
ay
ay
"}
(10,1,1) = {"
aa
ab
ab
ab
ab
ab
ab
ab
ab
ab
ab
ab
ab
ab
ab
ay
ay
ay
aP
aU
aY
bc
aP
ay
ay
ay
"}
(11,1,1) = {"
aa
ab
ab
ab
ab
ab
ab
ab
ab
ab
ab
ab
ab
ab
ay
ay
ay
ay
aP
aV
aY
bd
aP
ay
ay
ay
"}
(12,1,1) = {"
ac
aa
ab
ab
ab
ab
ab
ab
ab
ab
ab
ab
ab
ay
ay
ay
ay
ay
aP
aW
aY
be
aP
ay
aC
ay
"}
(13,1,1) = {"
aa
aa
ab
ab
ab
ab
ab
ab
ab
ab
ab
ab
ay
ay
ay
ay
ay
ay
aP
aW
aZ
bd
aP
ay
ay
ay
"}
(14,1,1) = {"
aa
aa
ab
ab
ab
ab
ab
ab
ab
ab
ab
ab
ay
aC
ay
ay
ay
ay
aP
aP
aP
aP
aP
ay
ay
ay
"}
(15,1,1) = {"
aa
ab
ab
ab
ab
ab
ab
ab
ab
ab
ab
ay
ay
ay
ay
ay
ay
ay
ay
aC
ay
ay
ay
ay
ay
ay
"}
(16,1,1) = {"
aa
ab
ab
ab
ab
ab
ab
ab
ab
ab
ab
ay
ay
ay
ay
ay
ay
ay
ay
ay
ay
ay
ay
ay
ay
ay
"}
(17,1,1) = {"
ab
ab
ab
ab
ae
ae
ak
ak
ak
ak
ak
ak
ak
ak
aE
aI
aI
aI
aI
ak
aI
aI
aI
aI
aI
aI
"}
(18,1,1) = {"
ab
ab
ab
ab
ae
ae
af
ak
ak
ak
ak
ak
ak
ak
ak
ak
aJ
aI
aI
ak
aI
ak
aI
aI
aI
aI
"}
(19,1,1) = {"
ab
ab
ab
ab
ae
ah
al
ao
aq
aq
aq
aq
aA
aq
aq
ak
ak
aM
aI
aI
aI
bf
am
ba
aI
aI
"}
(20,1,1) = {"
ab
ab
ab
ab
af
ai
am
am
ar
am
aw
az
aB
ar
aF
ak
aK
aN
aK
aI
aI
aI
aQ
aI
aE
aI
"}
(21,1,1) = {"
ab
ab
ab
ab
af
aj
am
am
am
am
am
am
am
az
am
af
aK
aE
aK
aI
aI
aI
aI
aI
aI
aI
"}
(22,1,1) = {"
ab
ab
ab
ab
ag
ae
ae
ap
am
at
am
am
az
am
af
af
aK
aK
aN
aI
ba
bg
aI
aI
aI
aI
"}
(23,1,1) = {"
ab
ab
ab
ab
ae
ae
ae
ae
an
au
am
ar
am
aD
am
ak
ak
aK
aI
aQ
aI
aI
aI
aQ
am
aI
"}
(24,1,1) = {"
ab
ab
ab
ab
ae
ae
an
af
as
av
ax
ax
ax
ax
aG
ak
aL
aI
aQ
am
aI
aE
aI
aI
ak
aI
"}
(25,1,1) = {"
ab
ab
ab
ab
ae
ae
ak
ak
ak
ak
ak
ak
ak
ak
ak
ak
ak
aI
aI
ak
aI
aI
aI
aI
aI
aI
"}
(26,1,1) = {"
ab
ab
ab
ab
ae
ae
ae
ak
ak
ak
ak
ak
ak
ak
aE
aE
aI
aI
aI
aI
aI
bh
bi
aI
aI
aI
"}
(27,1,1) = {"
ad
ad
ad
ad
ad
ad
ad
ad
ad
ad
ad
ad
ad
ad
ad
ad
ad
aI
aI
aI
aI
aI
aI
aI
ba
aI
"}
(28,1,1) = {"
ad
ad
ad
ad
ad
ad
ad
ad
ad
ad
ad
ad
ad
ad
ad
ad
ad
aI
aI
aI
aI
aI
aI
aI
aI
aI
"}
(29,1,1) = {"
ad
ad
ad
ad
ad
ad
ad
ad
ad
ad
ad
ad
ad
ad
ad
ad
ad
aI
aI
aI
aI
aI
aI
ae
ae
ae
"}
(30,1,1) = {"
ad
ad
ad
ad
ad
ad
ad
ad
ad
ad
ad
ad
ad
ad
ad
ad
ad
aO
aR
aO
aO
ad
ad
ad
ae
ae
"}
