//MAP CONVERTED BY dmm2tgm.py THIS HEADER COMMENT PREVENTS RECONVERSION, DO NOT REMOVE
"aa" = (
/turf/open/gm/grass,
/area/lv624/ground/jungle9)
"ab" = (
/turf/closed/wall/r_wall,
/area/lv624/lazarus/internal_affairs)
"ac" = (
/obj/structure/window/framed/colony/reinforced,
/obj/structure/machinery/door/poddoor/almayer{
	dir = 1;
	id = "corporate_blast";
	layer = 3.3;
	name = "\improper Corporate Dome Blast Door"
	},
/turf/open/floor/plating,
/area/lv624/lazarus/internal_affairs)
"ae" = (
/obj/structure/largecrate/random,
/turf/open/floor{
	tag = "icon-whiteblue (EAST)";
	icon_state = "whiteblue";
	dir = 4
	},
/area/lv624/lazarus/internal_affairs)
"ag" = (
/obj/effect/spawner/random/toolbox,
/turf/open/floor{
	dir = 8;
	icon_state = "whiteblue"
	},
/area/lv624/lazarus/internal_affairs)
"ah" = (
/obj/structure/window/framed/colony/reinforced,
/obj/structure/machinery/door/poddoor/almayer{
	dir = 4;
	id = "corporate_blast";
	layer = 3.3;
	name = "\improper Corporate Dome Blast Door"
	},
/turf/open/floor/plating,
/area/lv624/lazarus/internal_affairs)
"ai" = (
/obj/structure/closet/cabinet,
/turf/open/floor/bluegrid,
/area/lv624/lazarus/internal_affairs)
"aj" = (
/obj/structure/bookcase,
/obj/item/paper/research_notes,
/turf/open/floor/bluegrid,
/area/lv624/lazarus/internal_affairs)
"ak" = (
/turf/closed/wall,
/area/lv624/lazarus/internal_affairs)
"al" = (
/turf/open/floor{
	tag = "icon-whiteblue (EAST)";
	icon_state = "whiteblue";
	dir = 4
	},
/area/lv624/lazarus/internal_affairs)
"am" = (
/turf/open/floor{
	tag = "icon-whiteblue (NORTH)";
	icon_state = "whiteblue";
	dir = 1
	},
/area/lv624/lazarus/internal_affairs)
"an" = (
/obj/structure/machinery/light/small{
	dir = 4
	},
/turf/open/floor{
	dir = 8;
	icon_state = "whiteblue"
	},
/area/lv624/lazarus/internal_affairs)
"ao" = (
/obj/structure/displaycase/destroyed,
/obj/item/shard,
/turf/open/floor/bluegrid,
/area/lv624/lazarus/internal_affairs)
"ap" = (
/obj/structure/table/woodentable/fancy,
/obj/item/device/megaphone,
/turf/open/floor/bluegrid,
/area/lv624/lazarus/internal_affairs)
"aq" = (
/obj/structure/table/woodentable/fancy,
/turf/open/floor/bluegrid,
/area/lv624/lazarus/internal_affairs)
"ar" = (
/obj/structure/machinery/light/small{
	dir = 8
	},
/turf/open/floor/bluegrid,
/area/lv624/lazarus/internal_affairs)
"as" = (
/turf/open/floor/bluegrid,
/area/lv624/lazarus/internal_affairs)
"at" = (
/obj/structure/machinery/door/airlock/almayer/generic/corporate{
	density = 0;
	dir = 4;
	icon_state = "door_open";
	name = "Corporate Dome";
	opacity = 0
	},
/turf/open/floor/greengrid,
/area/lv624/lazarus/internal_affairs)
"av" = (
/obj/item/bedsheet/rd,
/obj/item/toy/bikehorn/rubberducky,
/obj/structure/bed{
	desc = "For prime comfort.";
	name = "fancy bed"
	},
/turf/open/floor/bluegrid,
/area/lv624/lazarus/internal_affairs)
"aw" = (
/obj/effect/landmark{
	name = "surv_spawn";
	pixel_x = -1
	},
/turf/open/floor/bluegrid,
/area/lv624/lazarus/internal_affairs)
"ax" = (
/obj/structure/safe{
	spawnkey = 0
	},
/obj/item/weapon/gun/rifle/sniper/svd,
/obj/item/ammo_magazine/sniper/svd,
/obj/item/ammo_magazine/sniper/svd,
/obj/item/ammo_magazine/sniper/svd,
/turf/open/floor/bluegrid,
/area/lv624/lazarus/internal_affairs)
"ay" = (
/obj/structure/machinery/light{
	dir = 8;
	icon_state = "tube1";
	pixel_y = 0
	},
/turf/open/floor{
	tag = "icon-whiteblue (EAST)";
	icon_state = "whiteblue";
	dir = 4
	},
/area/lv624/lazarus/internal_affairs)
"az" = (
/obj/structure/closet/gmcloset,
/turf/open/floor/bluegrid,
/area/lv624/lazarus/internal_affairs)
"aA" = (
/obj/item/clothing/glasses/regular/hipster,
/obj/item/bedsheet/captain,
/obj/structure/bed{
	desc = "For prime comfort.";
	name = "fancy bed"
	},
/turf/open/floor/bluegrid,
/area/lv624/lazarus/internal_affairs)
"aB" = (
/obj/structure/machinery/door/airlock/almayer/generic/corporate{
	density = 0;
	dir = 1;
	icon_state = "door_open";
	name = "Corporate Dome";
	opacity = 0
	},
/turf/open/floor/greengrid,
/area/lv624/lazarus/internal_affairs)
"aC" = (
/obj/structure/machinery/door/airlock/almayer/generic/corporate{
	dir = 1;
	name = "Corporate Dome"
	},
/turf/open/floor/greengrid,
/area/lv624/lazarus/internal_affairs)
"aD" = (
/obj/structure/machinery/vending/cola,
/turf/open/floor{
	tag = "icon-whiteblue";
	icon_state = "whiteblue"
	},
/area/lv624/lazarus/internal_affairs)
"aE" = (
/turf/open/floor{
	tag = "icon-whiteblue";
	icon_state = "whiteblue"
	},
/area/lv624/lazarus/internal_affairs)
"aF" = (
/obj/structure/extinguisher_cabinet{
	pixel_y = 30
	},
/obj/effect/landmark{
	name = "good_item"
	},
/turf/open/floor{
	tag = "icon-whiteblue";
	icon_state = "whiteblue"
	},
/area/lv624/lazarus/internal_affairs)
"aG" = (
/obj/structure/window/reinforced,
/turf/open/floor{
	tag = "icon-whiteblue (NORTH)";
	icon_state = "whiteblue";
	dir = 1
	},
/area/lv624/lazarus/internal_affairs)
"aH" = (
/obj/structure/machinery/firealarm{
	pixel_y = 28
	},
/obj/structure/machinery/vending/cigarette/colony,
/turf/open/floor{
	tag = "icon-whiteblue";
	icon_state = "whiteblue"
	},
/area/lv624/lazarus/internal_affairs)
"aI" = (
/obj/structure/machinery/power/apc{
	dir = 1;
	name = "Corporate Office APC";
	pixel_y = 30;
	start_charge = 100
	},
/turf/open/floor{
	tag = "icon-whiteblue";
	icon_state = "whiteblue"
	},
/area/lv624/lazarus/internal_affairs)
"aJ" = (
/obj/structure/machinery/status_display{
	pixel_y = 30
	},
/obj/item/folder/white,
/obj/structure/machinery/light/small{
	dir = 1
	},
/turf/open/floor{
	tag = "icon-whiteblue";
	icon_state = "whiteblue"
	},
/area/lv624/lazarus/internal_affairs)
"aK" = (
/obj/structure/machinery/door/poddoor/almayer{
	dir = 4;
	id = "corporate_blast";
	layer = 3.3;
	name = "\improper Corporate Dome Blast Door"
	},
/obj/structure/machinery/door/airlock/almayer/generic/corporate{
	dir = 4;
	name = "Corporate Dome"
	},
/turf/open/floor/plating,
/area/lv624/lazarus/internal_affairs)
"aL" = (
/turf/open/floor{
	tag = "icon-whitebluefull";
	icon_state = "whitebluefull"
	},
/area/lv624/lazarus/internal_affairs)
"aM" = (
/obj/item/folder/blue,
/turf/open/floor{
	tag = "icon-whitebluefull";
	icon_state = "whitebluefull"
	},
/area/lv624/lazarus/internal_affairs)
"aN" = (
/obj/structure/window/reinforced{
	dir = 4
	},
/turf/open/floor{
	tag = "icon-whiteblue (EAST)";
	icon_state = "whiteblue";
	dir = 4
	},
/area/lv624/lazarus/internal_affairs)
"aO" = (
/obj/structure/showcase,
/obj/effect/landmark{
	name = "good_item"
	},
/turf/open/floor{
	icon_state = "white"
	},
/area/lv624/lazarus/internal_affairs)
"aP" = (
/obj/structure/window/reinforced{
	dir = 8
	},
/turf/open/floor{
	dir = 8;
	icon_state = "whiteblue"
	},
/area/lv624/lazarus/internal_affairs)
"aS" = (
/obj/structure/machinery/light/small,
/turf/open/floor{
	tag = "icon-whiteblue (NORTH)";
	icon_state = "whiteblue";
	dir = 1
	},
/area/lv624/lazarus/internal_affairs)
"aT" = (
/obj/structure/machinery/door_control{
	id = "corporate_blast";
	name = "Dome Lockdown";
	pixel_y = -25
	},
/turf/open/floor{
	tag = "icon-whiteblue (NORTH)";
	icon_state = "whiteblue";
	dir = 1
	},
/area/lv624/lazarus/internal_affairs)
"aU" = (
/obj/item/storage/toolbox/mechanical,
/turf/open/floor{
	tag = "icon-whiteblue (EAST)";
	icon_state = "whiteblue";
	dir = 4
	},
/area/lv624/lazarus/internal_affairs)
"aV" = (
/obj/structure/window/reinforced{
	dir = 1
	},
/obj/item/ammo_casing{
	pixel_x = 2;
	pixel_y = 3
	},
/obj/item/ammo_casing,
/turf/open/floor{
	tag = "icon-whiteblue (NORTH)";
	icon_state = "whiteblue";
	dir = 1
	},
/area/lv624/lazarus/internal_affairs)
"aW" = (
/obj/item/device/flashlight,
/turf/open/floor{
	dir = 8;
	icon_state = "whiteblue"
	},
/area/lv624/lazarus/internal_affairs)
"aY" = (
/obj/structure/machinery/newscaster{
	pixel_y = -28
	},
/turf/open/floor{
	tag = "icon-whiteblue (NORTH)";
	icon_state = "whiteblue";
	dir = 1
	},
/area/lv624/lazarus/internal_affairs)
"aZ" = (
/obj/effect/landmark{
	name = "surv_spawn";
	pixel_x = -1
	},
/turf/open/floor{
	tag = "icon-whiteblue (NORTH)";
	icon_state = "whiteblue";
	dir = 1
	},
/area/lv624/lazarus/internal_affairs)
"ba" = (
/obj/structure/machinery/vending/coffee,
/turf/open/floor{
	tag = "icon-whiteblue (NORTH)";
	icon_state = "whiteblue";
	dir = 1
	},
/area/lv624/lazarus/internal_affairs)
"bb" = (
/obj/item/spacecash/c500{
	pixel_x = 5;
	pixel_y = -2
	},
/obj/item/device/radio/intercom{
	anyai = 1;
	freerange = 1;
	frequency = 1469;
	name = "General Listening Channel";
	pixel_x = -30;
	pixel_y = 0
	},
/turf/open/floor{
	tag = "icon-whiteblue (EAST)";
	icon_state = "whiteblue";
	dir = 4
	},
/area/lv624/lazarus/internal_affairs)
"bc" = (
/obj/effect/landmark/corpsespawner/bridgeofficer/johnson,
/obj/item/tool/crowbar,
/obj/effect/decal/cleanable/blood{
	layer = 3;
	pixel_x = 24
	},
/obj/effect/decal/cleanable/blood{
	layer = 3;
	pixel_x = 0
	},
/turf/open/floor{
	tag = "icon-whiteblue (NORTH)";
	icon_state = "whiteblue";
	dir = 1
	},
/area/lv624/lazarus/internal_affairs)
"bd" = (
/obj/item/weapon/gun/pistol/holdout,
/turf/open/floor{
	dir = 8;
	icon_state = "whiteblue"
	},
/area/lv624/lazarus/internal_affairs)
"bf" = (
/turf/open/gm/grass,
/area/lv624/ground/jungle3)
"bg" = (
/obj/structure/bookcase,
/obj/item/book/manual/chef_recipes,
/obj/item/book/manual/nuclear,
/turf/open/floor/bluegrid,
/area/lv624/lazarus/internal_affairs)
"bh" = (
/obj/structure/computerframe{
	anchored = 1
	},
/turf/open/floor/bluegrid,
/area/lv624/lazarus/internal_affairs)
"bi" = (
/obj/item/ammo_magazine/pistol/holdout,
/turf/open/floor{
	tag = "icon-whiteblue (EAST)";
	icon_state = "whiteblue";
	dir = 4
	},
/area/lv624/lazarus/internal_affairs)
"bj" = (
/obj/item/spacecash/c100,
/obj/item/spacecash/c200{
	pixel_x = 3;
	pixel_y = -3
	},
/turf/open/floor{
	tag = "icon-whiteblue (NORTH)";
	icon_state = "whiteblue";
	dir = 1
	},
/area/lv624/lazarus/internal_affairs)
"bk" = (
/obj/item/spacecash/c100{
	pixel_x = -12
	},
/obj/item/reagent_container/food/drinks/bottle/sake,
/obj/structure/machinery/light{
	dir = 4
	},
/turf/open/floor{
	dir = 8;
	icon_state = "whiteblue"
	},
/area/lv624/lazarus/internal_affairs)
"bl" = (
/obj/item/book/manual/ripley_build_and_repair,
/obj/item/book/manual/security_space_law,
/turf/open/floor/bluegrid,
/area/lv624/lazarus/internal_affairs)
"bm" = (
/obj/structure/table/woodentable/fancy,
/obj/item/device/pinpointer,
/turf/open/floor/bluegrid,
/area/lv624/lazarus/internal_affairs)
"bn" = (
/obj/item/poster,
/obj/structure/machinery/light/small{
	dir = 8
	},
/turf/open/floor/bluegrid,
/area/lv624/lazarus/internal_affairs)
"bo" = (
/obj/structure/machinery/door/airlock/almayer/generic/corporate{
	dir = 4;
	name = "Corporate Dome"
	},
/turf/open/floor/greengrid,
/area/lv624/lazarus/internal_affairs)
"bp" = (
/obj/item/spacecash/c100,
/turf/open/floor{
	tag = "icon-whiteblue (NORTH)";
	icon_state = "whiteblue";
	dir = 1
	},
/area/lv624/lazarus/internal_affairs)
"bq" = (
/obj/item/spacecash/c200{
	pixel_y = 4
	},
/turf/open/floor{
	dir = 8;
	icon_state = "whiteblue"
	},
/area/lv624/lazarus/internal_affairs)
"bs" = (
/obj/item/clothing/glasses/regular,
/turf/open/floor/bluegrid,
/area/lv624/lazarus/internal_affairs)
"bt" = (
/obj/structure/table/woodentable/fancy,
/obj/item/device/flashlight/lamp,
/turf/open/floor/bluegrid,
/area/lv624/lazarus/internal_affairs)
"bu" = (
/obj/structure/table/woodentable/fancy,
/obj/item/storage/box/donkpockets,
/obj/item/clothing/glasses/sunglasses/big{
	pixel_y = 5
	},
/turf/open/floor/bluegrid,
/area/lv624/lazarus/internal_affairs)
"bv" = (
/obj/structure/table/woodentable/fancy,
/obj/structure/machinery/computer/crew,
/turf/open/floor/bluegrid,
/area/lv624/lazarus/internal_affairs)
"bw" = (
/obj/structure/table/woodentable/fancy,
/obj/item/ashtray/glass,
/obj/item/toy/deck,
/obj/structure/prop/mech/mech_parts/part/gygax_head,
/turf/open/floor/bluegrid,
/area/lv624/lazarus/internal_affairs)
"bx" = (
/obj/structure/machinery/light/small{
	dir = 8
	},
/turf/open/floor{
	tag = "icon-whiteblue (EAST)";
	icon_state = "whiteblue";
	dir = 4
	},
/area/lv624/lazarus/internal_affairs)
"by" = (
/obj/item/ammo_magazine/pistol/holdout,
/turf/open/floor{
	dir = 8;
	icon_state = "whiteblue"
	},
/area/lv624/lazarus/internal_affairs)
"bz" = (
/obj/structure/machinery/light/small,
/turf/open/floor/bluegrid,
/area/lv624/lazarus/internal_affairs)
"bA" = (
/obj/structure/machinery/vending/snack,
/turf/open/floor{
	tag = "icon-whiteblue (EAST)";
	icon_state = "whiteblue";
	dir = 4
	},
/area/lv624/lazarus/internal_affairs)
"bB" = (
/turf/open/floor{
	dir = 8;
	icon_state = "whiteblue"
	},
/area/lv624/lazarus/internal_affairs)
"bD" = (
/obj/structure/machinery/door/poddoor/almayer{
	dir = 1;
	id = "corporate_blast";
	layer = 3.3;
	name = "\improper Corporate Dome Blast Door"
	},
/obj/structure/machinery/door/airlock/almayer/generic/corporate{
	dir = 1;
	name = "Corporate Dome"
	},
/turf/open/floor/plating,
/area/lv624/lazarus/internal_affairs)
"bG" = (
/obj/structure/flora/jungle/planttop1,
/turf/open/gm/grass,
/area/lv624/ground/jungle9)
"pv" = (
/turf/open/gm/grass,
/area/lv624/lazarus/landing_zones/lz2)
"wG" = (
/obj/structure/flora/jungle/vines{
	icon_state = "light_2";
	icon_tag = "light_2"
	},
/obj/structure/flora/jungle/vines/heavy{
	icon_state = "heavy_6";
	pixel_x = 0
	},
/turf/open/gm/grass,
/area/lv624/ground/jungle9)
"Kh" = (
/obj/structure/flora/jungle/vines,
/turf/open/gm/grass,
/area/lv624/ground/jungle9)
"Kl" = (
/obj/structure/table/woodentable/fancy,
/obj/item/storage/fancy/vials/random,
/turf/open/floor/bluegrid,
/area/lv624/lazarus/internal_affairs)
"MD" = (
/turf/closed/wall/strata_ice/jungle,
/area/lv624/ground/jungle3)
"RK" = (
/turf/open/gm/grass{
	icon_state = "grass2"
	},
/area/lv624/ground/jungle9)

(1,1,1) = {"
pv
pv
pv
pv
pv
ab
ab
ab
ab
ab
MD
MD
MD
MD
bf
"}
(2,1,1) = {"
pv
ab
ah
ah
ah
ab
aD
aL
am
ab
ab
ab
ab
ab
bf
"}
(3,1,1) = {"
pv
ac
ai
ar
av
ak
aE
aL
aS
ak
bg
bn
bu
ac
bf
"}
(4,1,1) = {"
pv
ac
aj
as
aw
aB
aE
aM
am
aC
as
as
bv
ac
bf
"}
(5,1,1) = {"
pv
ac
aj
as
ax
ak
aF
aL
aT
ak
bh
as
bw
ac
bf
"}
(6,1,1) = {"
ab
ab
ak
at
ak
ak
aE
aL
am
ak
ak
bo
ak
ab
ab
"}
(7,1,1) = {"
ac
ae
al
al
ay
al
al
aN
aU
bb
bi
al
bx
bA
ac
"}
(8,1,1) = {"
bD
am
am
am
am
am
aG
aO
aV
bc
bj
bp
am
am
bD
"}
(9,1,1) = {"
ac
ag
an
bB
bB
bB
bB
aP
aW
bd
bk
bq
by
bB
ac
"}
(10,1,1) = {"
ab
ab
ak
at
ak
ak
aH
aL
am
ak
ak
at
ak
ab
ab
"}
(11,1,1) = {"
aa
ac
ao
as
az
ak
aI
aL
aY
ak
bl
as
as
ac
aa
"}
(12,1,1) = {"
aa
ac
ap
as
as
aC
aE
aL
aZ
aC
as
bs
bz
ac
aa
"}
(13,1,1) = {"
aa
ac
Kl
as
aA
ak
aJ
aL
am
ak
bm
bt
aq
ac
aa
"}
(14,1,1) = {"
aa
ab
ah
ah
ah
ab
aE
aL
ba
ab
ah
ah
ah
ab
bG
"}
(15,1,1) = {"
aa
aa
RK
aa
aa
ab
ah
aK
ah
ab
aa
wG
Kh
wG
aa
"}
