//MAP CONVERTED BY dmm2tgm.py THIS HEADER COMMENT PREVENTS RECONVERSION, DO NOT REMOVE
"a" = (
/turf/open/gm/dirt,
/area/lv624/ground/caves/east1)
"b" = (
/obj/effect/landmark/crap_item,
/turf/open/gm/dirt,
/area/lv624/ground/caves/east1)
"c" = (
/turf/closed/wall/rock/brown,
/area/lv624/ground/caves/east1)
"d" = (
/turf/closed/wall/mineral/sandstone,
/area/lv624/ground/caves/east1)
"e" = (
/obj/item/hunting_trap{
	armed = 1;
	desc = "A bizarre alien device used for trapping and killing prey.";
	name = "Alien Mine"
	},
/turf/open/gm/dirt,
/area/lv624/ground/caves/east1)
"f" = (
/obj/item/stack/sheet/mineral/sandstone{
	amount = 50
	},
/obj/structure/surface/table,
/turf/open/floor{
	dir = 4;
	icon_state = "whiteyellowfull"
	},
/area/lv624/ground/caves/east1)
"g" = (
/obj/effect/decal/remains/xeno,
/obj/structure/surface/table,
/obj/effect/landmark/good_item,
/turf/open/floor{
	dir = 4;
	icon_state = "whiteyellowfull"
	},
/area/lv624/ground/caves/east1)
"h" = (
/obj/structure/surface/table,
/obj/item/weapon/melee/harpoon,
/turf/open/floor{
	dir = 4;
	icon_state = "whiteyellowfull"
	},
/area/lv624/ground/caves/east1)
"i" = (
/turf/open/floor{
	dir = 4;
	icon_state = "whiteyellowfull"
	},
/area/lv624/ground/caves/east1)
"j" = (
/obj/structure/machinery/door/airlock/sandstone{
	desc = "This strange temple is covered in runes. It looks extremely ancient.";
	icon_state = "door_locked";
	locked = 1;
	name = "Strange Temple"
	},
/turf/open/floor{
	dir = 4;
	icon_state = "whiteyellowfull"
	},
/area/lv624/ground/caves/east1)
"k" = (
/turf/closed/wall/rock/brown,
/area/lv624/ground/sand6)
"l" = (
/turf/open/floor{
	dir = 4;
	icon_state = "whiteyellowfull"
	},
/area/lv624/ground/sand6)
"m" = (
/obj/item/hunting_trap{
	armed = 1;
	desc = "A bizarre alien device used for trapping and killing prey.";
	name = "Alien Mine"
	},
/turf/open/floor{
	dir = 4;
	icon_state = "whiteyellowfull"
	},
/area/lv624/ground/sand6)
"n" = (
/turf/open/gm/dirt,
/area/lv624/ground/sand6)
"o" = (
/turf/closed/wall/mineral/sandstone,
/area/lv624/ground/sand6)
"p" = (
/obj/structure/surface/table,
/turf/open/floor{
	dir = 4;
	icon_state = "whiteyellowfull"
	},
/area/lv624/ground/sand6)
"q" = (
/obj/structure/surface/table,
/obj/item/weapon/melee/harpoon/yautja{
	name = "Alien Harpoon"
	},
/turf/open/floor{
	dir = 4;
	icon_state = "whiteyellowfull"
	},
/area/lv624/ground/sand6)
"r" = (
/obj/structure/machinery/door/airlock/sandstone,
/turf/open/floor{
	dir = 4;
	icon_state = "whiteyellowfull"
	},
/area/lv624/ground/sand6)
"s" = (
/obj/structure/surface/table,
/obj/item/hunting_trap{
	desc = "A bizarre alien device used for trapping and killing prey.";
	name = "Alien Mine"
	},
/turf/open/floor{
	dir = 4;
	icon_state = "whiteyellowfull"
	},
/area/lv624/ground/sand6)
"t" = (
/obj/structure/surface/table,
/obj/effect/landmark/crap_item,
/turf/open/floor{
	dir = 4;
	icon_state = "whiteyellowfull"
	},
/area/lv624/ground/sand6)
"u" = (
/obj/item/stack/sheet/mineral/sandstone{
	amount = 50
	},
/turf/open/floor{
	dir = 4;
	icon_state = "whiteyellowfull"
	},
/area/lv624/ground/sand6)
"v" = (
/obj/structure/surface/table,
/obj/item/weapon/melee/harpoon/yautja{
	name = "Alien Harpoon"
	},
/obj/effect/landmark/crap_item,
/turf/open/floor{
	dir = 4;
	icon_state = "whiteyellowfull"
	},
/area/lv624/ground/sand6)
"w" = (
/turf/open/gm/dirt,
/area/lv624/ground/sand3)
"x" = (
/obj/structure/machinery/door/airlock/sandstone{
	desc = "This strange temple is covered in runes. It looks extremely ancient.";
	icon_state = "door_locked";
	locked = 1;
	name = "Strange Temple"
	},
/turf/open/floor{
	dir = 4;
	icon_state = "whiteyellowfull"
	},
/area/lv624/ground/sand6)
"y" = (
/obj/effect/landmark/crap_item,
/turf/open/gm/dirt,
/area/lv624/ground/sand3)
"z" = (
/obj/item/hunting_trap{
	armed = 1;
	desc = "A bizarre alien device used for trapping and killing prey.";
	name = "Alien Mine"
	},
/turf/open/gm/dirt,
/area/lv624/ground/sand3)
"A" = (
/turf/closed/wall/rock/brown,
/area/lv624/ground/sand3)
"B" = (
/turf/open/floor{
	dir = 4;
	icon_state = "whiteyellowfull"
	},
/area/lv624/ground/sand3)
"C" = (
/turf/closed/wall/mineral/sandstone,
/area/lv624/ground/sand3)

(1,1,1) = {"
a
a
a
c
c
k
k
n
k
k
k
k
k
k
k
k
w
w
w
A
B
A
A
A
A
A
"}
(2,1,1) = {"
b
a
a
c
c
k
n
n
n
k
k
k
k
k
k
n
w
w
w
A
A
A
A
A
A
A
"}
(3,1,1) = {"
a
a
c
c
c
k
n
n
n
k
k
n
n
n
n
n
w
y
w
w
w
A
A
A
A
w
"}
(4,1,1) = {"
a
c
c
c
c
k
k
n
n
n
n
n
n
n
n
n
w
w
w
w
w
A
A
w
w
w
"}
(5,1,1) = {"
a
c
c
c
c
k
n
n
n
n
n
n
n
n
n
n
w
w
w
w
w
w
w
w
w
w
"}
(6,1,1) = {"
a
c
c
c
c
c
o
o
o
o
o
o
o
o
o
o
o
w
w
w
w
w
w
w
w
w
"}
(7,1,1) = {"
c
c
f
i
i
i
l
l
o
l
s
o
l
o
l
u
o
w
w
w
w
w
w
w
w
w
"}
(8,1,1) = {"
c
c
g
i
i
i
l
l
r
l
p
o
l
r
l
l
o
w
w
w
w
w
w
w
w
w
"}
(9,1,1) = {"
a
d
h
i
i
i
l
l
o
l
l
o
l
o
l
l
o
w
w
w
w
w
w
w
w
w
"}
(10,1,1) = {"
a
d
d
d
d
d
o
o
o
l
l
o
l
o
l
l
o
w
w
w
w
w
C
w
w
w
"}
(11,1,1) = {"
a
a
a
e
j
i
l
p
o
l
l
r
l
o
l
l
o
w
w
w
w
w
w
C
w
w
"}
(12,1,1) = {"
a
e
a
e
j
i
l
p
o
l
l
o
l
o
t
p
o
w
w
w
w
w
w
w
w
w
"}
(13,1,1) = {"
a
a
a
a
d
d
l
l
o
o
o
o
l
o
o
o
o
w
w
w
w
w
w
w
w
w
"}
(14,1,1) = {"
a
a
a
a
c
d
l
l
l
l
l
l
l
l
l
l
x
z
w
w
w
w
w
w
w
w
"}
(15,1,1) = {"
a
a
a
a
c
d
o
o
o
o
o
o
r
o
o
o
o
w
w
w
w
C
w
w
y
w
"}
(16,1,1) = {"
a
a
a
a
c
c
p
q
l
l
l
o
l
l
l
p
o
w
w
w
w
w
C
w
w
w
"}
(17,1,1) = {"
a
a
a
a
c
c
k
k
l
l
l
o
l
l
l
v
o
w
w
w
w
w
w
w
C
C
"}
(18,1,1) = {"
a
a
a
a
c
l
l
r
l
l
l
r
l
l
l
p
o
w
w
w
w
w
C
w
w
w
"}
(19,1,1) = {"
a
a
a
a
c
l
l
r
l
l
l
o
l
l
l
l
o
w
w
w
w
C
w
w
w
w
"}
(20,1,1) = {"
a
a
a
a
c
m
m
k
k
q
s
o
l
l
u
l
o
w
w
w
w
w
w
w
A
A
"}
(21,1,1) = {"
c
a
a
c
c
l
l
k
o
o
o
o
o
o
o
o
o
w
w
w
w
w
w
A
A
A
"}
(22,1,1) = {"
c
c
c
c
c
m
m
k
n
n
n
n
n
n
n
n
n
w
w
w
w
w
A
A
A
A
"}
