//MAP CONVERTED BY dmm2tgm.py THIS HEADER COMMENT PREVENTS RECONVERSION, DO NOT REMOVE
"al" = (
/obj/structure/flora/jungle/vines{
	icon_state = "light_2";
	icon_tag = "light"
	},
/obj/structure/flora/jungle/vines/heavy{
	icon_state = "heavy_6";
	icon_tag = "heavy";
	pixel_x = 0
	},
/turf/open/gm/grass,
/area/lv624/ground/jungle1)
"br" = (
/obj/structure/flora/bush/ausbushes/var3/ywflowers,
/turf/open/floor{
	dir = 4;
	icon_state = "whiteyellowfull"
	},
/area/lv624/ground/jungle1)
"cC" = (
/obj/structure/flora/jungle/vines,
/turf/closed/wall/strata_ice/jungle,
/area/lv624/ground/jungle1)
"eR" = (
/obj/structure/flora/jungle/vines/heavy{
	icon_state = "heavy_6";
	pixel_x = 0;
	pixel_y = 0
	},
/turf/closed/wall/mineral/sandstone,
/area/lv624/ground/jungle1)
"gO" = (
/obj/structure/flora/jungle/vines{
	icon_state = "light_3";
	icon_tag = "light"
	},
/turf/open/gm/grass,
/area/lv624/ground/jungle1)
"gU" = (
/obj/structure/flora/jungle/vines/heavy{
	icon_state = "heavy_6";
	pixel_x = 0;
	pixel_y = 26
	},
/obj/structure/flora/jungle/vines{
	icon_state = "light_2";
	pixel_y = -22
	},
/turf/open/floor{
	dir = 4;
	icon_state = "whiteyellowfull"
	},
/area/lv624/ground/jungle1)
"kd" = (
/obj/structure/flora/jungle/planttop1,
/turf/open/gm/grass,
/area/lv624/ground/jungle1)
"lV" = (
/obj/structure/flora/jungle/vines/heavy{
	icon_state = "heavy_6";
	pixel_x = 0;
	pixel_y = 26
	},
/obj/structure/flora/jungle/vines{
	icon_state = "light_3"
	},
/turf/closed/wall/strata_ice/jungle,
/area/lv624/ground/jungle1)
"nI" = (
/obj/structure/flora/jungle/vines/heavy{
	icon_state = "heavy_6";
	pixel_x = 0
	},
/turf/open/gm/grass,
/area/lv624/ground/jungle1)
"rA" = (
/obj/structure/flora/jungle/vines/heavy{
	icon_state = "heavy_6";
	pixel_x = 0;
	pixel_y = 26
	},
/turf/closed/wall/strata_ice/jungle,
/area/lv624/ground/jungle1)
"uk" = (
/obj/structure/flora/jungle/vines/heavy{
	icon_state = "heavy_6";
	pixel_x = 0;
	pixel_y = 26
	},
/turf/closed/wall/mineral/sandstone,
/area/lv624/ground/jungle1)
"un" = (
/obj/structure/flora/bush/ausbushes/reedbush,
/turf/open/floor{
	dir = 4;
	icon_state = "whiteyellowfull"
	},
/area/lv624/ground/jungle1)
"ur" = (
/obj/structure/flora/jungle/vines{
	icon_state = "light_2";
	icon_tag = "light_2"
	},
/turf/open/gm/grass,
/area/lv624/ground/jungle1)
"wQ" = (
/obj/structure/flora/jungle/vines/heavy{
	pixel_x = -28
	},
/turf/open/gm/grass,
/area/lv624/ground/jungle1)
"yg" = (
/obj/structure/flora/jungle/vines/heavy{
	icon_state = "heavy_6";
	pixel_x = 0;
	pixel_y = 26
	},
/obj/structure/flora/jungle/vines{
	icon_state = "light_3"
	},
/turf/open/floor{
	dir = 4;
	icon_state = "whiteyellowfull"
	},
/area/lv624/ground/jungle1)
"zg" = (
/obj/structure/flora/jungle/vines{
	icon_state = "light_3";
	icon_tag = "light"
	},
/turf/closed/wall/strata_ice/jungle,
/area/lv624/ground/jungle1)
"Be" = (
/obj/structure/flora/jungle/vines/heavy,
/turf/open/floor{
	dir = 4;
	icon_state = "whiteyellowfull"
	},
/area/lv624/ground/jungle1)
"CW" = (
/obj/structure/flora/jungle/vines/heavy{
	icon_state = "heavy_6";
	pixel_x = 0;
	pixel_y = 26
	},
/obj/effect/decal/cleanable/cobweb,
/turf/open/gm/dirt,
/area/lv624/ground/jungle1)
"EZ" = (
/obj/structure/flora/jungle/vines{
	icon_state = "light_3"
	},
/turf/open/floor{
	dir = 4;
	icon_state = "whiteyellowfull"
	},
/area/lv624/ground/jungle1)
"LV" = (
/turf/open/gm/grass,
/area/lv624/ground/jungle1)
"LW" = (
/turf/closed/wall/strata_ice/jungle,
/area/lv624/ground/jungle1)
"NU" = (
/obj/structure/flora/jungle/vines/heavy{
	icon_state = "heavy_6";
	pixel_x = 0;
	pixel_y = 26
	},
/turf/open/gm/dirt,
/area/lv624/ground/jungle1)
"Tl" = (
/obj/structure/flora/jungle/plantbot1,
/turf/open/gm/grass,
/area/lv624/ground/jungle1)
"Uc" = (
/obj/structure/flora/jungle/vines/heavy{
	icon_state = "heavy_6";
	pixel_x = 0;
	pixel_y = 26
	},
/turf/open/floor{
	dir = 4;
	icon_state = "whiteyellowfull"
	},
/area/lv624/ground/jungle1)
"VR" = (
/obj/effect/landmark{
	name = "yautja_teleport_loc"
	},
/turf/open/gm/grass,
/area/lv624/ground/jungle1)
"Wl" = (
/turf/closed/wall/mineral/sandstone,
/area/lv624/ground/jungle1)
"Wp" = (
/obj/structure/flora/jungle/vines{
	icon_state = "light_2";
	pixel_y = -22
	},
/turf/open/gm/dirtgrassborder,
/area/lv624/ground/jungle1)
"Wr" = (
/obj/structure/flora/jungle/vines{
	icon_state = "light_2";
	icon_tag = "light"
	},
/turf/closed/wall/strata_ice/jungle,
/area/lv624/ground/jungle1)
"Wt" = (
/obj/structure/flora/jungle/vines{
	icon_state = "light_2";
	pixel_y = -22
	},
/turf/closed/wall/mineral/sandstone,
/area/lv624/ground/jungle1)
"WQ" = (
/turf/open/gm/dirtgrassborder{
	dir = 4
	},
/area/lv624/ground/jungle1)
"Xl" = (
/turf/open/gm/dirt,
/area/lv624/ground/jungle1)
"Xy" = (
/turf/open/floor{
	dir = 4;
	icon_state = "whiteyellowfull"
	},
/area/lv624/ground/jungle1)
"Xz" = (
/obj/effect/landmark{
	name = "monkey_spawn"
	},
/turf/open/gm/dirt,
/area/lv624/ground/jungle1)
"XB" = (
/obj/structure/flora/jungle/vines,
/turf/open/gm/grass,
/area/lv624/ground/jungle1)
"XN" = (
/obj/structure/flora/jungle/vines{
	icon_state = "light_2";
	icon_tag = "light"
	},
/turf/open/gm/grass,
/area/lv624/ground/jungle1)
"XR" = (
/obj/structure/flora/jungle/vines/heavy{
	icon_state = "heavy_6";
	pixel_x = 0
	},
/turf/closed/wall/strata_ice/jungle,
/area/lv624/ground/jungle1)
"XS" = (
/obj/structure/flora/jungle/vines/heavy,
/turf/closed/wall/mineral/sandstone,
/area/lv624/ground/jungle1)
"Ya" = (
/obj/effect/landmark/lv624/xeno_tunnel,
/turf/open/gm/grass,
/area/lv624/ground/jungle1)
"Yr" = (
/turf/open/gm/grass{
	icon_state = "grass2"
	},
/area/lv624/ground/jungle1)
"Yz" = (
/obj/structure/flora/jungle/vines/heavy{
	icon_state = "heavy_6";
	pixel_x = 0;
	pixel_y = 24
	},
/turf/closed/wall/strata_ice/jungle,
/area/lv624/ground/jungle1)
"YD" = (
/obj/structure/flora/jungle/vines/heavy{
	icon_state = "heavy_6";
	icon_tag = "heavy";
	pixel_x = 0
	},
/turf/open/gm/grass,
/area/lv624/ground/jungle1)
"Ze" = (
/turf/open/gm/dirtgrassborder{
	dir = 1
	},
/area/lv624/ground/jungle1)
"Zi" = (
/obj/structure/flora/jungle/vines/heavy{
	icon_state = "heavy_6";
	pixel_x = 0;
	pixel_y = 24
	},
/obj/structure/flora/jungle/vines,
/turf/open/gm/grass,
/area/lv624/ground/jungle1)
"Zp" = (
/obj/structure/flora/bush/ausbushes/var3/sparsegrass,
/turf/open/gm/grass,
/area/lv624/ground/jungle1)

(1,1,1) = {"
LV
nI
gO
LW
LW
nI
ur
XB
XR
cC
LV
LV
LV
LV
"}
(2,1,1) = {"
gO
zg
gO
LW
LW
al
gO
gO
LV
LV
LV
LV
LV
gO
"}
(3,1,1) = {"
nI
LW
LW
LW
gO
Wl
Wl
WQ
WQ
XS
nI
nI
Yr
LW
"}
(4,1,1) = {"
cC
LW
Wr
XN
YD
Wl
CW
Xl
Xl
eR
XS
XS
LW
LW
"}
(5,1,1) = {"
LW
YD
YD
LV
gO
Wl
EZ
Xl
Xy
Xy
EZ
Wl
Yz
LW
"}
(6,1,1) = {"
LW
LW
XN
LV
LV
Wl
Uc
Xy
Xy
Xy
un
Wl
rA
LW
"}
(7,1,1) = {"
LV
gO
YD
LV
LV
Wt
gU
Xz
Xy
Xl
Xl
Xl
Ze
LV
"}
(8,1,1) = {"
LV
LV
LV
LV
LV
Wl
EZ
Xy
Xy
Xy
Xl
Xl
Ze
LV
"}
(9,1,1) = {"
LV
LW
kd
Tl
LW
Wl
yg
Xy
Xl
br
EZ
Wl
Zi
LV
"}
(10,1,1) = {"
LW
LW
LV
LV
LV
Wp
EZ
Xy
Xy
EZ
Be
Wl
lV
LV
"}
(11,1,1) = {"
LV
LV
Zp
LV
LV
Wp
EZ
Xy
Xy
EZ
uk
Wl
XB
LV
"}
(12,1,1) = {"
LV
LV
LV
LW
LV
Wp
NU
yg
EZ
Xl
Ze
wQ
LV
LV
"}
(13,1,1) = {"
LV
LV
LW
LW
LW
Wl
Wl
Wl
Wl
Wl
LV
LV
LV
LV
"}
(14,1,1) = {"
LW
LW
LW
LW
LW
LW
LW
Ya
LV
LV
LV
VR
LV
LW
"}
(15,1,1) = {"
LW
LW
LW
LW
LW
LW
LW
LW
LV
LV
LV
LV
LW
LW
"}
