//MAP CONVERTED BY dmm2tgm.py THIS HEADER COMMENT PREVENTS RECONVERSION, DO NOT REMOVE
"aa" = (
/turf/closed/wall/rock/brown,
/area/lv624/ground/caves/central2)
"ab" = (
/turf/open/gm/grass,
/area/lv624/ground/caves/central2)
"ac" = (
/obj/structure/flora/jungle/planttop1,
/turf/open/gm/grass,
/area/lv624/ground/caves/central2)
"ad" = (
/obj/structure/flora/jungle/plantbot1,
/turf/open/gm/grass,
/area/lv624/ground/caves/central2)
"ae" = (
/turf/closed/wall/strata_ice/jungle,
/area/lv624/ground/caves/central2)
"af" = (
/turf/open/gm/dirtgrassborder{
	icon_state = "grassdirt_corner"
	},
/area/lv624/ground/caves/central2)
"ag" = (
/turf/open/gm/dirtgrassborder,
/area/lv624/ground/caves/central2)
"ah" = (
/turf/closed/wall/wood,
/area/lv624/ground/caves/central2)
"ai" = (
/obj/structure/window_frame/wood,
/turf/open/floor/wood,
/area/lv624/ground/caves/central2)
"aj" = (
/turf/open/gm/dirtgrassborder{
	dir = 1;
	icon_state = "grassdirt_corner"
	},
/area/lv624/ground/caves/central2)
"ak" = (
/turf/open/gm/dirtgrassborder{
	dir = 4
	},
/area/lv624/ground/caves/central2)
"al" = (
/turf/open/gm/dirt,
/area/lv624/ground/caves/central2)
"am" = (
/obj/structure/bed/alien,
/turf/open/floor/wood,
/area/lv624/ground/caves/central2)
"an" = (
/obj/structure/closet/cabinet,
/turf/open/floor/wood,
/area/lv624/ground/caves/central2)
"ao" = (
/turf/open/floor/wood,
/area/lv624/ground/caves/central2)
"ap" = (
/obj/structure/table/woodentable/poor,
/obj/item/tool/candle,
/obj/item/tool/match{
	pixel_x = 6;
	pixel_y = 3
	},
/obj/item/explosive/grenade/HE/m15,
/obj/item/weapon/gun/shotgun/pump/cmb,
/obj/item/ammo_magazine/shotgun/buckshot,
/turf/open/floor/wood,
/area/lv624/ground/caves/central2)
"aq" = (
/obj/structure/table/woodentable/poor,
/obj/item/explosive/grenade/HE/m15,
/obj/item/weapon/gun/shotgun/pump/cmb,
/obj/item/ammo_magazine/shotgun/buckshot,
/turf/open/floor/wood,
/area/lv624/ground/caves/central2)
"ar" = (
/turf/open/gm/dirtgrassborder{
	dir = 4;
	icon_state = "grassdirt_corner2"
	},
/area/lv624/ground/caves/central2)
"as" = (
/obj/structure/flora/bush/ausbushes/var3/fullgrass,
/turf/open/gm/dirt,
/area/lv624/ground/caves/central2)
"at" = (
/turf/open/gm/dirtgrassborder{
	icon_state = "grassdirt_corner2"
	},
/area/lv624/ground/caves/central2)
"au" = (
/obj/structure/barricade/metal{
	dir = 4
	},
/turf/open/gm/grass,
/area/lv624/ground/caves/central2)
"av" = (
/obj/structure/curtain/red,
/turf/open/floor/wood,
/area/lv624/ground/caves/central2)
"aw" = (
/turf/open/gm/coast{
	icon_state = "beachcorner"
	},
/area/lv624/ground/caves/central2)
"ax" = (
/turf/open/gm/coast,
/area/lv624/ground/caves/central2)
"ay" = (
/turf/open/gm/coast{
	dir = 1;
	icon_state = "beachcorner"
	},
/area/lv624/ground/caves/central2)
"az" = (
/turf/open/gm/coast{
	dir = 4
	},
/area/lv624/ground/caves/central2)
"aA" = (
/turf/open/gm/river,
/area/lv624/ground/caves/central2)
"aB" = (
/turf/open/gm/coast{
	dir = 1;
	icon_state = "beachcorner2"
	},
/area/lv624/ground/caves/central2)
"aC" = (
/turf/open/gm/coast{
	dir = 2;
	icon_state = "beachcorner2"
	},
/area/lv624/ground/caves/central2)
"aD" = (
/turf/open/gm/dirtgrassborder{
	dir = 8
	},
/area/lv624/ground/caves/central2)
"aE" = (
/turf/open/gm/coast{
	tag = "icon-beach (SOUTHEAST)";
	icon_state = "beach";
	dir = 6
	},
/area/lv624/ground/caves/central2)
"aF" = (
/obj/structure/flora/jungle/plantbot1{
	icon_state = "alienplant1";
	luminosity = 2
	},
/turf/open/gm/river,
/area/lv624/ground/caves/central2)
"aG" = (
/obj/structure/flora/bush/ausbushes/reedbush,
/turf/open/gm/river,
/area/lv624/ground/caves/central2)
"aH" = (
/obj/effect/landmark/survivor_spawner/lv624_skylight{
	pixel_x = -1
	},
/turf/open/gm/grass,
/area/lv624/ground/caves/central2)
"aI" = (
/obj/structure/table/woodentable/poor,
/obj/item/weapon/gun/shotgun/pump/cmb,
/obj/item/ammo_magazine/revolver/small,
/obj/item/ammo_magazine/revolver/small,
/turf/open/floor/wood,
/area/lv624/ground/caves/central2)
"aJ" = (
/obj/structure/table/woodentable/poor,
/obj/item/device/flashlight/lantern,
/obj/item/weapon/gun/shotgun/pump/cmb,
/obj/item/ammo_magazine/revolver/small,
/obj/item/ammo_magazine/revolver/small,
/turf/open/floor/wood,
/area/lv624/ground/caves/central2)
"aK" = (
/obj/item/weapon/gun/revolver/small,
/turf/open/gm/dirtgrassborder,
/area/lv624/ground/caves/central2)
"aL" = (
/obj/structure/barricade/metal{
	dir = 4
	},
/turf/open/gm/dirtgrassborder,
/area/lv624/ground/caves/central2)
"aM" = (
/obj/structure/barricade/metal{
	dir = 4
	},
/turf/open/gm/dirt,
/area/lv624/ground/caves/central2)
"aN" = (
/obj/item/weapon/gun/revolver/small,
/turf/open/gm/dirt,
/area/lv624/ground/caves/central2)
"aO" = (
/obj/structure/barricade/metal{
	dir = 8
	},
/turf/open/gm/grass,
/area/lv624/ground/caves/central2)
"aP" = (
/obj/structure/barricade/metal{
	dir = 8
	},
/obj/structure/barricade/metal,
/turf/open/gm/grass,
/area/lv624/ground/caves/central2)
"aQ" = (
/obj/structure/barricade/metal,
/turf/open/gm/grass,
/area/lv624/ground/caves/central2)
"aR" = (
/obj/structure/barricade/metal,
/turf/open/gm/dirtgrassborder{
	icon_state = "grassdirt_corner"
	},
/area/lv624/ground/caves/central2)
"aS" = (
/obj/structure/barricade/metal,
/turf/open/gm/dirtgrassborder,
/area/lv624/ground/caves/central2)
"aT" = (
/obj/structure/barricade/metal,
/turf/open/gm/dirtgrassborder{
	icon_state = "grassdirt_corner2"
	},
/area/lv624/ground/caves/central2)
"aU" = (
/obj/structure/barricade/metal,
/turf/open/gm/dirt,
/area/lv624/ground/caves/central2)
"aV" = (
/obj/structure/barricade/plasteel,
/turf/open/gm/dirt,
/area/lv624/ground/caves/central2)
"aW" = (
/obj/structure/barricade/metal{
	dir = 4
	},
/obj/structure/barricade/metal,
/turf/open/gm/dirt,
/area/lv624/ground/caves/central2)
"aX" = (
/obj/item/storage/box/m94,
/obj/item/storage/box/m94,
/obj/item/storage/box/m94,
/obj/item/storage/box/m94,
/turf/open/gm/dirtgrassborder{
	icon_state = "grassdirt_corner2"
	},
/area/lv624/ground/caves/central2)
"aY" = (
/obj/structure/barricade/metal{
	dir = 8
	},
/obj/structure/barricade/metal,
/turf/open/gm/dirtgrassborder,
/area/lv624/ground/caves/central2)
"aZ" = (
/obj/structure/barricade/metal,
/obj/structure/barricade/metal{
	dir = 4
	},
/turf/open/gm/dirt,
/area/lv624/ground/caves/central2)
"ba" = (
/obj/item/storage/toolbox/emergency,
/turf/open/floor/wood,
/area/lv624/ground/caves/central2)
"bb" = (
/obj/item/storage/toolbox/mechanical,
/turf/open/floor/wood,
/area/lv624/ground/caves/central2)
"bc" = (
/obj/item/device/flashlight/on,
/turf/open/gm/grass,
/area/lv624/ground/caves/central2)
"bd" = (
/obj/item/storage/box/m56d_hmg,
/turf/open/floor/wood,
/area/lv624/ground/caves/central2)
"be" = (
/obj/item/storage/firstaid/regular,
/turf/open/gm/grass,
/area/lv624/ground/caves/central2)
"bf" = (
/obj/item/storage/firstaid/adv,
/turf/open/gm/dirt,
/area/lv624/ground/caves/central2)
"bg" = (
/obj/item/weapon/gun/shotgun/pump/cmb,
/turf/open/gm/grass,
/area/lv624/ground/caves/central2)

(1,1,1) = {"
aa
aa
aa
aa
aa
aa
aa
aa
aa
aa
aa
aa
aa
aa
al
"}
(2,1,1) = {"
aa
aa
aa
aa
aa
aa
aa
aa
aa
aa
aa
aa
aa
aa
aD
"}
(3,1,1) = {"
aa
aa
aa
aa
aa
aa
aa
aa
aa
aa
ae
ab
ab
ab
ab
"}
(4,1,1) = {"
aa
aa
aa
aa
aa
aa
aa
aa
aa
ae
ae
ab
ab
ab
ab
"}
(5,1,1) = {"
aa
aa
aa
aa
aa
aa
aa
aa
ae
ae
ab
ab
ab
ab
ab
"}
(6,1,1) = {"
aa
aa
aa
aa
aa
aa
aa
ae
ae
ae
ab
ab
ab
ab
ab
"}
(7,1,1) = {"
aa
aa
aa
aa
aa
aa
ae
ae
ae
ab
ab
ab
ab
ab
ab
"}
(8,1,1) = {"
aa
aa
aa
aa
aa
ae
ae
ae
ae
ab
ab
ab
ab
ab
ab
"}
(9,1,1) = {"
aa
aa
aa
aa
aa
ae
ae
ae
ae
ab
ab
af
ak
ak
ak
"}
(10,1,1) = {"
aa
aa
aa
aa
ae
ae
ae
ae
ae
ab
ab
ag
al
al
al
"}
(11,1,1) = {"
aa
aa
aa
ab
ab
bc
ae
ae
ae
aO
aO
aY
al
al
al
"}
(12,1,1) = {"
aa
aa
ab
aH
aH
aH
aH
aH
ab
aP
ab
aS
al
as
al
"}
(13,1,1) = {"
aa
aa
ab
aH
aH
aH
aH
aH
ab
aQ
af
aT
al
al
aw
"}
(14,1,1) = {"
aa
aa
ab
ab
ab
ab
ab
ab
ab
aR
at
aU
al
al
ax
"}
(15,1,1) = {"
aa
ah
ah
ah
ai
ah
ah
bg
ab
aS
al
aU
al
al
ax
"}
(16,1,1) = {"
aa
ah
am
ao
ao
aI
ah
be
af
aT
al
aU
al
al
ax
"}
(17,1,1) = {"
aa
ah
an
ao
ao
aJ
ah
be
ag
aU
al
aU
aw
az
aE
"}
(18,1,1) = {"
aa
ah
ba
ao
ao
ao
av
ak
aX
aV
al
aU
ax
aA
aA
"}
(19,1,1) = {"
aa
ah
ap
ao
ao
bd
ah
bf
al
aU
al
aU
ax
aA
aA
"}
(20,1,1) = {"
aa
ah
aq
ao
ao
bb
ah
bf
al
aU
al
aU
ax
aA
aA
"}
(21,1,1) = {"
aa
ah
ah
ah
ai
ah
ah
as
aN
aU
al
aU
ay
aB
aA
"}
(22,1,1) = {"
aa
ab
ab
ab
ab
ag
al
al
al
aU
al
aU
al
ax
aF
"}
(23,1,1) = {"
aa
ab
ab
ab
ab
aK
al
al
al
aU
al
aU
al
ax
aA
"}
(24,1,1) = {"
aa
aa
au
au
au
aL
aM
aM
aM
aW
al
aU
al
ax
aA
"}
(25,1,1) = {"
aa
aa
ab
ab
ab
ag
al
al
al
al
al
aU
al
ax
aA
"}
(26,1,1) = {"
aa
au
au
au
au
aL
aM
aM
aM
aM
aM
aZ
al
ax
aA
"}
(27,1,1) = {"
aa
ab
ab
ab
ab
ag
al
al
al
al
al
al
al
ax
aG
"}
(28,1,1) = {"
aa
ab
ac
ad
ab
ag
al
al
al
al
al
al
al
ax
aA
"}
(29,1,1) = {"
aa
ab
ab
ab
ab
ag
al
al
al
al
al
al
al
ax
aA
"}
(30,1,1) = {"
aa
aa
ab
ab
ab
ag
al
al
al
al
al
al
al
ax
aA
"}
(31,1,1) = {"
aa
aa
ab
ab
ab
ag
al
al
al
al
al
al
al
ax
aA
"}
(32,1,1) = {"
aa
aa
ab
ab
ab
ag
al
al
al
as
al
al
aw
aC
aA
"}
(33,1,1) = {"
aa
aa
ab
ab
ab
ag
al
al
al
al
al
al
ax
aA
aA
"}
(34,1,1) = {"
aa
aa
ab
ab
ab
aj
ar
al
al
al
al
al
ax
aA
aA
"}
(35,1,1) = {"
aa
aa
ab
ab
ab
ab
aj
ar
al
al
al
al
ax
aA
aA
"}
(36,1,1) = {"
aa
aa
ab
ab
ab
ab
ab
ag
al
al
al
al
ay
aB
aA
"}
(37,1,1) = {"
aa
aa
aa
ab
ab
ac
ad
aj
ar
al
al
al
as
ax
aA
"}
(38,1,1) = {"
aa
aa
aa
ab
ab
ab
ab
ab
ag
al
al
al
al
ax
aA
"}
(39,1,1) = {"
aa
aa
aa
aa
ab
ab
ab
af
at
al
al
al
al
ax
aA
"}
(40,1,1) = {"
aa
aa
aa
aa
aa
ab
ab
ag
al
al
al
al
al
ax
aA
"}
