//MAP CONVERTED BY dmm2tgm.py THIS HEADER COMMENT PREVENTS RECONVERSION, DO NOT REMOVE
"a" = (
/obj/structure/machinery/door_control{
	id = "eelz_shutters";
	pixel_y = -22
	},
/turf/open/floor/shiva/radiator_tile,
/area/shiva/exterior/lz2_fortress)
"c" = (
/obj/structure/machinery/door_control{
	id = "eelz_shutters";
	pixel_y = 22
	},
/turf/open/floor/shiva/north,
/area/shiva/exterior/lz2_fortress)
"d" = (
/turf/open/auto_turf/snow/layer1,
/area/shiva/exterior/cp_lz2)
"h" = (
/obj/item/lightstick/red/spoke/planted{
	layer = 3.1;
	pixel_x = -13;
	pixel_y = 25
	},
/turf/open/auto_turf/snow/layer1,
/area/shiva/exterior/cp_lz2)
"k" = (
/obj/item/lightstick/red/spoke/planted{
	layer = 2.99;
	pixel_x = 12;
	pixel_y = 28
	},
/turf/open/floor/shiva/north,
/area/shiva/exterior/lz2_fortress)
"l" = (
/obj/item/lightstick/red/spoke/planted{
	pixel_x = 12;
	pixel_y = 25
	},
/turf/open/floor/shiva/north,
/area/shiva/exterior/lz2_fortress)
"m" = (
/obj/structure/flora/bush/snow{
	icon_state = "snowgrassbb_1"
	},
/turf/open/auto_turf/snow/layer2,
/area/shiva/exterior/cp_lz2)
"n" = (
/obj/item/lightstick/red/spoke/planted{
	layer = 2.99;
	pixel_x = -13;
	pixel_y = 28
	},
/turf/open/auto_turf/snow/layer0,
/area/shiva/exterior/cp_lz2)
"s" = (
/obj/structure/machinery/door_control{
	id = "eelz_shutters";
	pixel_y = 22
	},
/turf/open/floor/shiva/radiator_tile,
/area/shiva/exterior/lz2_fortress)
"u" = (
/turf/open/floor/shiva/floor3,
/area/shiva/exterior/lz2_fortress)
"v" = (
/turf/open/auto_turf/snow/layer0,
/area/shiva/exterior/cp_lz2)
"x" = (
/obj/structure/machinery/door_control{
	id = "elz_shutters";
	pixel_y = 22
	},
/turf/open/floor/shiva/north,
/area/shiva/exterior/lz2_fortress)
"D" = (
/turf/open/floor/shiva/north,
/area/shiva/exterior/lz2_fortress)
"F" = (
/obj/structure/machinery/door_control{
	id = "elz_shutters";
	pixel_y = -22
	},
/turf/open/floor/shiva/north,
/area/shiva/exterior/lz2_fortress)
"J" = (
/turf/open/floor/shiva/multi_tiles/east,
/area/shiva/exterior/lz2_fortress)
"Q" = (
/obj/structure/machinery/door/poddoor/shutters/almayer{
	density = 0;
	dir = 4;
	id = "eelz_shutters";
	name = "\improper Landing Zone Shutters"
	},
/turf/open/floor/plating/plating_catwalk/shiva,
/area/shiva/exterior/lz2_fortress)
"R" = (
/obj/structure/machinery/door_control{
	id = "elz_shutters";
	pixel_y = 22
	},
/turf/open/floor/shiva/radiator_tile,
/area/shiva/exterior/lz2_fortress)
"S" = (
/obj/structure/machinery/door_control{
	id = "eelz_shutters";
	pixel_y = -22
	},
/turf/open/floor/shiva/north,
/area/shiva/exterior/lz2_fortress)
"U" = (
/turf/closed/wall/shiva/prefabricated/reinforced/hull,
/area/shiva/exterior/lz2_fortress)
"V" = (
/obj/structure/machinery/door/poddoor/shutters/almayer{
	density = 0;
	dir = 4;
	id = "elz_shutters";
	name = "\improper Landing Zone Shutters"
	},
/turf/open/floor/plating/plating_catwalk/shiva,
/area/shiva/exterior/lz2_fortress)
"Z" = (
/obj/structure/machinery/door_control{
	id = "elz_shutters";
	pixel_y = -22
	},
/turf/open/floor/shiva/radiator_tile,
/area/shiva/exterior/lz2_fortress)

(1,1,1) = {"
D
D
k
u
u
D
l
D
"}
(2,1,1) = {"
U
U
R
J
J
Z
U
U
"}
(3,1,1) = {"
U
U
V
V
V
V
U
U
"}
(4,1,1) = {"
U
U
x
D
D
F
U
U
"}
(5,1,1) = {"
U
U
c
D
D
S
U
U
"}
(6,1,1) = {"
U
U
Q
Q
Q
Q
U
U
"}
(7,1,1) = {"
U
U
s
J
J
a
U
U
"}
(8,1,1) = {"
d
d
n
v
v
v
h
m
"}
