//MAP CONVERTED BY dmm2tgm.py THIS HEADER COMMENT PREVENTS RECONVERSION, DO NOT REMOVE
"bi" = (
/turf/closed/wall/abyssal/standard/unmeltable,
/area/abyssal/interior/maintenance/west)
"cs" = (
/obj/effect/decal/warning_stripes{
	icon_state = "E";
	layer = 3.33;
	pixel_x = 2
	},
/obj/effect/decal/hybrisa/dirt_2,
/obj/structure/sign/conam{
	pixel_x = 32
	},
/obj/structure/flora/pottedplant{
	icon_state = "pottedplant_22";
	layer = 2.8;
	pixel_y = 1
	},
/turf/open/floor/elevatorshaft,
/area/abyssal/interior/bunker)
"cP" = (
/obj/effect/decal/hybrisa/dirt_2,
/obj/effect/decal/hybrisa/lattice,
/obj/effect/hybrisa/misc/fake/wire/blue{
	dir = 4;
	pixel_y = -8
	},
/turf/open/floor/engine,
/area/abyssal/interior/maintenance/west)
"dU" = (
/obj/effect/decal/hybrisa/lattice,
/turf/open/space/basic,
/area/abyssal/oob)
"fv" = (
/obj/effect/decal/warning_stripes{
	icon_state = "S";
	layer = 3.3
	},
/obj/effect/decal/hybrisa/dirt_2,
/obj/effect/decal/cleanable/dirt/alt_dirt{
	color = "#140400";
	pixel_y = 8;
	pixel_x = 16
	},
/obj/structure/closet/walllocker/emerglocker/south,
/turf/open/floor/elevatorshaft,
/area/abyssal/interior/bunker)
"go" = (
/obj/structure/pipes/standard/simple/hidden/cyan{
	dir = 4
	},
/obj/structure/machinery/door/firedoor/border_only/almayer{
	dir = 2
	},
/obj/effect/decal/hybrisa/lattice,
/obj/structure/machinery/door/airlock/almayer/engineering/glass/colony{
	autoname = 1;
	req_one_access = null
	},
/turf/open/floor/engine,
/area/abyssal/interior/bunker)
"gU" = (
/obj/structure/machinery/door/airlock/prison_hatch/autoname{
	dir = 1
	},
/obj/effect/decal/hybrisa/lattice,
/obj/structure/machinery/door/firedoor/border_only/almayer{
	dir = 2
	},
/obj/structure/pipes/standard/simple/hidden/cyan,
/turf/open/floor/engine,
/area/abyssal/interior/bunker)
"hk" = (
/obj/structure/pipes/standard/simple/hidden/cyan{
	dir = 4
	},
/obj/effect/decal/hybrisa/dirt_2,
/turf/open/floor/hybrisa/tile/blacktileshiny,
/area/abyssal/interior/bunker)
"hF" = (
/obj/effect/decal/hybrisa/dirt_2,
/obj/effect/decal/floor_symbol/con_am/left,
/obj/effect/decal/hybrisa/dirt_2,
/turf/open/floor/hybrisa/tile/blacktileshiny,
/area/abyssal/interior/bunker)
"iN" = (
/obj/structure/surface/table/reinforced/black,
/obj/effect/decal/hybrisa/dirt_2,
/obj/item/trash/ceramic_plate,
/obj/structure/pipes/standard/simple/hidden/cyan,
/obj/item/clothing/accessory/patch/conam_patch,
/turf/open/floor/hybrisa/tile/blacktileshiny,
/area/abyssal/interior/bunker)
"jc" = (
/obj/effect/decal/warning_stripes{
	icon_state = "S";
	layer = 3.3
	},
/obj/effect/decal/hybrisa/dirt_2,
/obj/structure/pipes/standard/simple/hidden/cyan,
/turf/open/floor/elevatorshaft,
/area/abyssal/interior/bunker)
"jK" = (
/obj/structure/sign/safety/maint{
	pixel_y = 32;
	pixel_x = 8
	},
/obj/effect/decal/warning_stripes{
	icon_state = "N";
	layer = 3.33;
	pixel_y = 1
	},
/obj/effect/decal/warning_stripes{
	icon_state = "E";
	layer = 3.33;
	pixel_x = 2
	},
/obj/structure/closet/firecloset,
/obj/effect/decal/hybrisa/dirt_2,
/obj/effect/landmark/objective_landmark/science,
/obj/structure/sign/poster/safety{
	pixel_y = 31;
	pixel_x = 15
	},
/turf/open/floor/elevatorshaft,
/area/abyssal/interior/bunker)
"lk" = (
/obj/effect/decal/hybrisa/dirt_2,
/obj/structure/pipes/standard/simple/hidden/cyan,
/turf/open/floor/hybrisa/tile/blacktileshiny,
/area/abyssal/interior/bunker)
"lx" = (
/obj/effect/decal/warning_stripes{
	icon_state = "N";
	layer = 3.33;
	pixel_y = 1
	},
/obj/effect/decal/hybrisa/dirt_2,
/turf/open/floor/elevatorshaft,
/area/abyssal/interior/bunker)
"mB" = (
/obj/effect/decal/hybrisa/dirt_2,
/obj/effect/decal/cleanable/dirt/alt_dirt{
	color = "#140400";
	pixel_y = 8;
	pixel_x = 16
	},
/obj/structure/bed/chair{
	dir = 8
	},
/turf/open/floor/hybrisa/tile/blacktileshiny,
/area/abyssal/interior/bunker)
"nb" = (
/obj/structure/window/framed/abyssal/standard/hull,
/turf/open/floor/engine,
/area/abyssal/interior/bunker)
"nF" = (
/obj/effect/decal/hybrisa/dirt_2,
/obj/item/trash/cigbutt,
/obj/structure/pipes/standard/manifold/hidden/cyan{
	dir = 1
	},
/turf/open/floor/hybrisa/tile/blacktileshiny,
/area/abyssal/interior/bunker)
"ot" = (
/obj/effect/decal/warning_stripes{
	icon_state = "N";
	layer = 3.33;
	pixel_y = 1
	},
/obj/effect/decal/warning_stripes{
	icon_state = "W";
	layer = 2.5
	},
/obj/structure/machinery/light/blue{
	dir = 8
	},
/obj/structure/closet/emcloset,
/obj/effect/decal/hybrisa/dirt_2,
/obj/structure/machinery/power/apc/power/north,
/obj/effect/landmark/objective_landmark/science,
/turf/open/floor/elevatorshaft,
/area/abyssal/interior/bunker)
"ou" = (
/obj/structure/machinery/door/airlock/prison_hatch/autoname{
	dir = 1
	},
/obj/effect/decal/hybrisa/lattice,
/obj/structure/machinery/door/firedoor/border_only/almayer{
	dir = 2
	},
/turf/open/floor/engine,
/area/abyssal/interior/bunker)
"pc" = (
/obj/effect/decal/hybrisa/dirt_2,
/obj/effect/hybrisa/misc/fake/wire/blue{
	dir = 4;
	pixel_y = -8
	},
/turf/open/floor/engine,
/area/abyssal/interior/maintenance/west)
"pY" = (
/obj/structure/pipes/standard/simple/hidden/cyan,
/obj/effect/decal/hybrisa/lattice,
/obj/effect/decal/hybrisa/dirt_2,
/turf/open/floor/engine,
/area/abyssal/interior/maintenance/west)
"sq" = (
/obj/effect/decal/warning_stripes{
	icon_state = "S";
	layer = 3.3
	},
/obj/effect/decal/hybrisa/dirt_2,
/obj/structure/largecrate/random/case/small,
/obj/structure/largecrate/random/mini/small_case{
	pixel_y = 9
	},
/turf/open/floor/elevatorshaft,
/area/abyssal/interior/bunker)
"sy" = (
/obj/effect/decal/hybrisa/dirt_2,
/obj/effect/decal/cleanable/dirt/alt_dirt,
/turf/open/floor/hybrisa/tile/blacktileshiny,
/area/abyssal/interior/bunker)
"sH" = (
/obj/structure/machinery/door/firedoor/border_only/almayer{
	dir = 2
	},
/obj/effect/decal/hybrisa/lattice,
/obj/structure/machinery/door/airlock/almayer/engineering/glass/colony{
	autoname = 1;
	req_one_access = null
	},
/turf/open/floor/engine,
/area/abyssal/interior/bunker)
"tn" = (
/obj/effect/decal/hybrisa/dirt_2,
/obj/effect/decal/large_stain,
/obj/structure/machinery/optable{
	name = "Emergency Operating Table";
	desc = "A backup OR table, as a precaution if the crew were cut off from the medbay in an emergency. Unlikely this table has been sterile in years."
	},
/turf/open/floor/hybrisa/tile/blacktileshiny,
/area/abyssal/interior/bunker)
"tN" = (
/obj/structure/pipes/standard/simple/hidden/cyan{
	dir = 4
	},
/obj/effect/decal/warning_stripes{
	icon_state = "E";
	layer = 3.33;
	pixel_x = 2
	},
/obj/effect/decal/hybrisa/dirt_2,
/obj/effect/decal/strata_decals/grime/grime2{
	dir = 8
	},
/turf/open/floor/elevatorshaft,
/area/abyssal/interior/bunker)
"uD" = (
/obj/structure/surface/table/reinforced/black,
/obj/effect/decal/hybrisa/dirt_2,
/obj/effect/decal/cleanable/dirt/alt_dirt{
	color = "#140400";
	pixel_y = 8;
	pixel_x = 16
	},
/obj/structure/pipes/standard/simple/hidden/cyan,
/obj/effect/spawner/random/toolbox{
	layer = 4;
	pixel_x = 1;
	pixel_y = 6
	},
/turf/open/floor/hybrisa/tile/blacktileshiny,
/area/abyssal/interior/bunker)
"uH" = (
/obj/effect/decal/hybrisa/dirt_2,
/obj/item/trash/cigbutt,
/obj/effect/decal/cleanable/dirt/alt_dirt{
	color = "#140400";
	pixel_y = 8;
	pixel_x = 16
	},
/turf/open/floor/hybrisa/tile/blacktileshiny,
/area/abyssal/interior/bunker)
"vP" = (
/obj/structure/surface/table/reinforced/black,
/obj/effect/decal/hybrisa/dirt_2,
/obj/effect/decal/cleanable/dirt/alt_dirt{
	color = "#140400";
	pixel_y = 8;
	pixel_x = 16
	},
/obj/effect/landmark/map_item,
/turf/open/floor/hybrisa/tile/blacktileshiny,
/area/abyssal/interior/bunker)
"vY" = (
/obj/structure/surface/table/reinforced/black,
/obj/effect/decal/hybrisa/dirt_2,
/obj/effect/decal/cleanable/dirt/alt_dirt{
	color = "#140400";
	pixel_y = 8;
	pixel_x = 16
	},
/obj/item/tool/pen/blue{
	pixel_x = 8;
	pixel_y = 5
	},
/obj/item/paper_bin/wy{
	pixel_x = -2;
	pixel_y = 3
	},
/turf/open/floor/hybrisa/tile/blacktileshiny,
/area/abyssal/interior/bunker)
"wt" = (
/obj/structure/machinery/door/airlock/prison_hatch/autoname{
	dir = 1
	},
/obj/effect/decal/hybrisa/lattice,
/obj/structure/machinery/door/firedoor/border_only/almayer{
	dir = 2
	},
/obj/effect/hybrisa/misc/fake/wire/blue{
	pixel_x = -4
	},
/turf/open/floor/engine,
/area/abyssal/interior/bunker)
"xS" = (
/obj/effect/decal/cleanable/dirt/alt_dirt{
	color = "#140400";
	pixel_y = 8;
	pixel_x = 16
	},
/obj/structure/bed/chair{
	dir = 8
	},
/turf/open/floor/hybrisa/tile/blacktileshiny,
/area/abyssal/interior/bunker)
"yh" = (
/obj/effect/decal/warning_stripes{
	icon_state = "E";
	layer = 3.33;
	pixel_x = 2
	},
/obj/effect/decal/hybrisa/dirt_2,
/turf/open/floor/elevatorshaft,
/area/abyssal/interior/bunker)
"yY" = (
/obj/effect/decal/hybrisa/dirt_2,
/obj/structure/largecrate/supply/supplies/wy_emergency_food,
/turf/open/floor/hybrisa/tile/blacktileshiny,
/area/abyssal/interior/bunker)
"zI" = (
/obj/effect/decal/hybrisa/dirt_2,
/obj/item/trash/cigbutt,
/obj/effect/decal/cleanable/dirt/alt_dirt{
	color = "#140400";
	pixel_y = 8;
	pixel_x = 16
	},
/obj/structure/pipes/standard/manifold/hidden/cyan{
	dir = 1
	},
/turf/open/floor/hybrisa/tile/blacktileshiny,
/area/abyssal/interior/bunker)
"zQ" = (
/obj/effect/decal/warning_stripes{
	icon_state = "S";
	layer = 3.3
	},
/obj/effect/decal/hybrisa/dirt_2,
/obj/structure/closet/secure_closet/surgical{
	pixel_y = -28;
	pixel_x = -1;
	req_access = null
	},
/turf/open/floor/elevatorshaft,
/area/abyssal/interior/bunker)
"Aj" = (
/obj/effect/decal/hybrisa/dirt_2,
/obj/structure/bed/chair{
	can_buckle = 0;
	dir = 4;
	pixel_x = 2;
	pixel_y = 6
	},
/obj/effect/decal/strata_decals/grime/grime2{
	dir = 8
	},
/turf/open/floor/hybrisa/tile/blacktileshiny,
/area/abyssal/interior/bunker)
"BI" = (
/obj/effect/decal/warning_stripes{
	icon_state = "S";
	layer = 3.3
	},
/obj/effect/decal/warning_stripes{
	icon_state = "W";
	layer = 2.5
	},
/obj/effect/decal/hybrisa/dirt_2,
/turf/open/floor/elevatorshaft,
/area/abyssal/interior/bunker)
"Cd" = (
/obj/effect/decal/hybrisa/dirt_2,
/obj/effect/decal/cleanable/dirt/alt_dirt{
	color = "#140400";
	pixel_y = 8;
	pixel_x = 16
	},
/obj/structure/bed/chair,
/turf/open/floor/hybrisa/tile/blacktileshiny,
/area/abyssal/interior/bunker)
"CF" = (
/obj/effect/decal/hybrisa/dirt_2,
/obj/structure/pipes/vents/scrubber,
/turf/open/floor/hybrisa/tile/blacktileshiny,
/area/abyssal/interior/bunker)
"Df" = (
/obj/structure/sign/safety/maint{
	pixel_y = -32;
	pixel_x = 8
	},
/obj/effect/decal/warning_stripes{
	icon_state = "S";
	layer = 3.3
	},
/obj/structure/machinery/light/blue,
/obj/effect/decal/hybrisa/dirt_2,
/turf/open/floor/elevatorshaft,
/area/abyssal/interior/bunker)
"DB" = (
/obj/effect/decal/warning_stripes{
	icon_state = "N";
	layer = 3.33;
	pixel_y = 1
	},
/obj/effect/decal/hybrisa/dirt_2,
/obj/item/toy/deck{
	pixel_x = -8
	},
/obj/structure/sign/poster/conam{
	pixel_y = 31
	},
/obj/structure/surface/rack,
/obj/item/toy/dice/d20{
	pixel_x = -8;
	pixel_y = 5
	},
/obj/item/toy/dice{
	pixel_x = 3
	},
/obj/item/paper/colonial_grunts,
/obj/item/toy/deck/uno{
	pixel_x = -9;
	pixel_y = 9
	},
/turf/open/floor/elevatorshaft,
/area/abyssal/interior/bunker)
"Ec" = (
/obj/effect/decal/warning_stripes{
	icon_state = "W";
	layer = 2.5
	},
/obj/effect/decal/hybrisa/dirt_2,
/turf/open/floor/elevatorshaft,
/area/abyssal/interior/bunker)
"Ei" = (
/obj/effect/decal/warning_stripes{
	icon_state = "E";
	layer = 3.33;
	pixel_x = 2
	},
/obj/effect/decal/hybrisa/dirt_2,
/obj/effect/decal/strata_decals/grime/grime3{
	dir = 4;
	pixel_x = -6;
	pixel_y = 6
	},
/turf/open/floor/elevatorshaft,
/area/abyssal/interior/bunker)
"FJ" = (
/obj/effect/decal/warning_stripes{
	icon_state = "E";
	layer = 3.33;
	pixel_x = 2
	},
/obj/effect/decal/warning_stripes{
	icon_state = "S";
	layer = 3.3
	},
/obj/effect/decal/hybrisa/dirt_2,
/obj/structure/largecrate/supply/supplies/tables_racks,
/turf/open/floor/elevatorshaft,
/area/abyssal/interior/bunker)
"GX" = (
/obj/effect/decal/warning_stripes{
	icon_state = "S";
	layer = 3.3
	},
/obj/effect/decal/hybrisa/dirt_2,
/obj/effect/decal/cleanable/dirt/alt_dirt{
	color = "#140400";
	pixel_y = 8;
	pixel_x = 16
	},
/turf/open/floor/elevatorshaft,
/area/abyssal/interior/bunker)
"GZ" = (
/obj/effect/decal/hybrisa/dirt_2,
/obj/effect/decal/large_stain,
/turf/open/floor/hybrisa/tile/blacktileshiny,
/area/abyssal/interior/bunker)
"HJ" = (
/obj/effect/decal/hybrisa/dirt_2,
/obj/structure/prop/misc/lit_cable,
/obj/structure/pipes/standard/simple/hidden/cyan,
/obj/structure/bed/chair,
/turf/open/floor/hybrisa/tile/blacktileshiny,
/area/abyssal/interior/bunker)
"Iy" = (
/obj/effect/decal/warning_stripes{
	icon_state = "N";
	layer = 3.33;
	pixel_y = 1
	},
/obj/effect/decal/hybrisa/dirt_2,
/obj/effect/decal/cleanable/dirt/alt_dirt{
	color = "#140400";
	pixel_y = 8;
	pixel_x = 16
	},
/turf/open/floor/elevatorshaft,
/area/abyssal/interior/bunker)
"IQ" = (
/obj/item/trash/cigbutt,
/obj/effect/decal/cleanable/dirt/alt_dirt{
	color = "#140400";
	pixel_y = 8;
	pixel_x = 16
	},
/obj/effect/decal/strata_decals/grime/grime3{
	dir = 4;
	pixel_x = -6;
	pixel_y = 12
	},
/obj/effect/decal/floor_symbol/con_am/right,
/obj/effect/decal/hybrisa/dirt_2,
/turf/open/floor/hybrisa/tile/blacktileshiny,
/area/abyssal/interior/bunker)
"JS" = (
/obj/effect/decal/warning_stripes{
	icon_state = "N";
	layer = 3.33;
	pixel_y = 1
	},
/obj/effect/decal/hybrisa/dirt_2,
/obj/structure/sign/poster/kellandmining{
	pixel_y = 32;
	pixel_x = 8
	},
/obj/structure/sign/poster/conam{
	pixel_y = 37;
	pixel_x = -6
	},
/turf/open/floor/elevatorshaft,
/area/abyssal/interior/bunker)
"LA" = (
/obj/effect/decal/warning_stripes{
	icon_state = "W";
	layer = 2.5
	},
/obj/effect/decal/hybrisa/dirt_2,
/obj/item/reagent_container/glass/bucket/janibucket,
/obj/structure/surface/rack,
/obj/item/tool/crowbar/red{
	pixel_x = -4
	},
/obj/item/tool/weldingtool/screen{
	pixel_x = 8;
	pixel_y = 6
	},
/obj/item/tool/wirecutters,
/turf/open/floor/elevatorshaft,
/area/abyssal/interior/bunker)
"LJ" = (
/obj/structure/pipes/standard/manifold/hidden/cyan{
	dir = 8
	},
/obj/effect/decal/warning_stripes{
	icon_state = "N";
	layer = 3.33;
	pixel_y = 1
	},
/obj/effect/decal/hybrisa/dirt_2,
/turf/open/floor/elevatorshaft,
/area/abyssal/interior/bunker)
"LM" = (
/obj/structure/pipes/standard/simple/hidden/cyan{
	dir = 4
	},
/obj/effect/decal/warning_stripes{
	icon_state = "NW-out";
	pixel_y = 1
	},
/obj/effect/decal/hybrisa/dirt_2,
/obj/effect/decal/strata_decals/grime/grime3{
	dir = 4;
	pixel_x = -6;
	pixel_y = 12
	},
/turf/open/floor/elevatorshaft,
/area/abyssal/interior/bunker)
"Mc" = (
/obj/effect/decal/warning_stripes{
	icon_state = "S";
	layer = 3.3
	},
/obj/effect/decal/hybrisa/dirt_2,
/turf/open/floor/elevatorshaft,
/area/abyssal/interior/bunker)
"Mk" = (
/obj/effect/decal/hybrisa/dirt_2,
/obj/effect/decal/cleanable/dirt/alt_dirt{
	color = "#140400";
	pixel_y = 8;
	pixel_x = 16
	},
/turf/open/floor/hybrisa/tile/blacktileshiny,
/area/abyssal/interior/bunker)
"MW" = (
/obj/structure/sign/safety/rad_shield{
	pixel_x = 8
	},
/turf/closed/wall/abyssal/standard/reinforced,
/area/abyssal/interior/bunker)
"OK" = (
/obj/effect/decal/warning_stripes{
	icon_state = "E";
	layer = 3.33;
	pixel_x = 2
	},
/obj/effect/decal/hybrisa/dirt_2,
/obj/effect/decal/strata_decals/grime/grime3{
	dir = 4
	},
/obj/item/device/radio/intercom{
	freerange = 1;
	pixel_x = 30
	},
/turf/open/floor/elevatorshaft,
/area/abyssal/interior/bunker)
"Pr" = (
/obj/structure/sign/safety/maint{
	pixel_x = -24
	},
/obj/effect/decal/warning_stripes{
	icon_state = "S";
	layer = 3.3
	},
/obj/effect/decal/warning_stripes{
	icon_state = "W";
	layer = 2.5
	},
/obj/effect/decal/hybrisa/dirt_2,
/obj/effect/decal/strata_decals/grime/grime3{
	pixel_y = 12
	},
/turf/open/floor/elevatorshaft,
/area/abyssal/interior/bunker)
"QD" = (
/obj/effect/decal/warning_stripes{
	icon_state = "N";
	layer = 3.33;
	pixel_y = 1
	},
/obj/effect/decal/warning_stripes{
	icon_state = "W";
	layer = 2.5
	},
/obj/effect/decal/hybrisa/dirt_2,
/obj/structure/sign/safety/nonpress_0g{
	pixel_x = -16
	},
/obj/structure/machinery/alarm{
	pixel_y = 24
	},
/obj/structure/prop/static_tank/water,
/turf/open/floor/elevatorshaft,
/area/abyssal/interior/bunker)
"RY" = (
/obj/effect/decal/hybrisa/dirt_2,
/obj/item/trash/cigbutt,
/obj/structure/pipes/standard/simple/hidden/cyan{
	dir = 9
	},
/turf/open/floor/hybrisa/tile/blacktileshiny,
/area/abyssal/interior/bunker)
"Tf" = (
/obj/effect/decal/warning_stripes{
	icon_state = "N";
	layer = 3.33;
	pixel_y = 1
	},
/obj/effect/decal/hybrisa/dirt_2,
/obj/structure/machinery/computer3{
	pixel_y = 11;
	density = 0;
	unacidable = 1;
	explo_proof = 1;
	layer = 2.99
	},
/obj/item/prop{
	icon = 'icons/obj/structures/machinery/computer3.dmi';
	icon_state = "crew";
	name = "Console Screen";
	pixel_y = 10;
	explo_proof = 1;
	unacidable = 1;
	light_range = 2;
	light_color = "#00FFFF";
	light_on = 1;
	anchored = 1
	},
/turf/open/floor/elevatorshaft,
/area/abyssal/interior/bunker)
"Tp" = (
/obj/effect/decal/hybrisa/dirt_2,
/turf/open/floor/hybrisa/tile/blacktileshiny,
/area/abyssal/interior/bunker)
"UI" = (
/obj/effect/decal/hybrisa/dirt_2,
/obj/effect/decal/cleanable/dirt/alt_dirt{
	color = "#140400";
	pixel_y = 8;
	pixel_x = 16
	},
/obj/structure/pipes/vents/pump,
/turf/open/floor/hybrisa/tile/blacktileshiny,
/area/abyssal/interior/bunker)
"UR" = (
/turf/closed/wall/abyssal/standard/reinforced,
/area/abyssal/interior/bunker)
"We" = (
/obj/structure/machinery/door/firedoor/border_only/almayer{
	dir = 2
	},
/obj/effect/decal/hybrisa/lattice,
/obj/structure/machinery/door/airlock/almayer/engineering/glass/colony{
	dir = 2;
	autoname = 1;
	req_one_access = null
	},
/turf/open/floor/engine,
/area/abyssal/interior/bunker)
"Wl" = (
/obj/structure/pipes/standard/simple/hidden/cyan{
	dir = 4
	},
/obj/structure/sign/safety/maint{
	pixel_y = 32;
	pixel_x = 8
	},
/obj/effect/decal/warning_stripes{
	icon_state = "N";
	layer = 3.33;
	pixel_y = 1
	},
/obj/effect/decal/hybrisa/dirt_2,
/turf/open/floor/elevatorshaft,
/area/abyssal/interior/bunker)
"Xf" = (
/obj/effect/decal/hybrisa/dirt_2,
/obj/structure/pipes/standard/simple/hidden/cyan,
/obj/effect/decal/floor_symbol/con_am,
/turf/open/floor/hybrisa/tile/blacktileshiny,
/area/abyssal/interior/bunker)
"Xh" = (
/obj/effect/decal/hybrisa/dirt_2,
/obj/item/trash/cigbutt,
/mob/living/simple_animal/cat/blackcat{
	dir = 8;
	name = "Sebastian"
	},
/turf/open/floor/hybrisa/tile/blacktileshiny,
/area/abyssal/interior/bunker)
"Xo" = (
/obj/effect/decal/hybrisa/dirt_2,
/obj/effect/hybrisa/misc/fake/wire/blue{
	dir = 4;
	pixel_y = -8
	},
/obj/effect/hybrisa/misc/fake/wire/red{
	pixel_x = 4;
	layer = 2.5
	},
/turf/open/floor/engine,
/area/abyssal/interior/maintenance/west)
"XG" = (
/obj/effect/decal/warning_stripes{
	icon_state = "SW-out";
	layer = 2.5
	},
/obj/effect/decal/hybrisa/dirt_2,
/obj/effect/decal/cleanable/dirt/alt_dirt{
	color = "#140400";
	pixel_y = 8;
	pixel_x = 16
	},
/obj/structure/bed/chair{
	can_buckle = 0;
	dir = 4;
	pixel_x = 2;
	pixel_y = 6
	},
/turf/open/floor/elevatorshaft,
/area/abyssal/interior/bunker)
"YU" = (
/turf/closed/wall/abyssal/standard/unmeltable,
/area/abyssal/interior/bunker)

(1,1,1) = {"
dU
YU
YU
nb
nb
nb
YU
YU
Xo
"}
(2,1,1) = {"
dU
YU
QD
LA
Ec
Ec
Pr
ou
cP
"}
(3,1,1) = {"
bi
YU
DB
yY
CF
tn
GX
MW
cP
"}
(4,1,1) = {"
pY
gU
LJ
lk
RY
Tp
zQ
UR
pc
"}
(5,1,1) = {"
UR
UR
Wl
sy
Tp
Mk
fv
UR
UR
"}
(6,1,1) = {"
UR
ot
LM
hF
Mk
Aj
XG
BI
MW
"}
(7,1,1) = {"
We
Iy
zI
Xf
HJ
iN
uD
jc
gU
"}
(8,1,1) = {"
UR
JS
hk
IQ
Cd
vY
vP
Df
UR
"}
(9,1,1) = {"
UR
Tf
hk
GZ
Tp
xS
mB
Mc
UR
"}
(10,1,1) = {"
wt
lx
nF
lk
UI
Xh
uH
sq
UR
"}
(11,1,1) = {"
UR
jK
tN
cs
OK
Ei
yh
FJ
UR
"}
(12,1,1) = {"
UR
MW
go
UR
UR
MW
sH
UR
UR
"}
