//MAP CONVERTED BY dmm2tgm.py THIS HEADER COMMENT PREVENTS RECONVERSION, DO NOT REMOVE
"a" = (
/turf/open/mars_cave{
	icon_state = "mars_cave_2";
	tag = "icon-mars_cave_2"
	},
/area/bigredv2/caves_lambda)
"b" = (
/turf/closed/wall/solaris/rock,
/area/bigredv2/caves)
"c" = (
/obj/effect/glowshroom,
/turf/open/auto_turf/br_caves/layer1,
/area/bigredv2/caves_lambda)
"g" = (
/obj/effect/landmark/structure_spawner/setup/distress/xeno_weed_node,
/turf/open/auto_turf/br_caves/layer1,
/area/bigredv2/caves_lambda)
"N" = (
/turf/open/auto_turf/br_caves/layer1,
/area/bigredv2/caves_lambda)

(1,1,1) = {"
N
N
N
N
N
a
b
b
b
b
b
b
b
b
b
"}
(2,1,1) = {"
b
N
g
N
b
b
b
b
b
b
b
b
b
b
b
"}
(3,1,1) = {"
b
N
N
N
N
b
b
b
b
b
b
b
b
b
N
"}
(4,1,1) = {"
b
N
N
N
c
N
N
N
b
b
b
b
b
N
N
"}
(5,1,1) = {"
b
b
N
N
N
N
N
N
N
b
b
b
b
N
N
"}
(6,1,1) = {"
b
b
b
N
N
N
g
N
c
N
b
b
a
N
N
"}
(7,1,1) = {"
b
b
b
b
N
N
N
N
N
N
N
b
N
g
N
"}
(8,1,1) = {"
b
b
b
b
b
N
N
N
N
g
N
N
N
N
N
"}
(9,1,1) = {"
b
b
c
c
b
N
c
N
N
c
N
N
N
N
N
"}
(10,1,1) = {"
b
c
N
N
c
N
N
b
b
b
b
b
N
N
N
"}
(11,1,1) = {"
b
c
N
N
N
g
N
b
b
b
b
b
b
N
N
"}
(12,1,1) = {"
b
c
N
c
N
c
N
c
b
b
b
b
b
b
N
"}
(13,1,1) = {"
b
b
c
c
c
N
c
N
b
b
b
b
b
b
b
"}
(14,1,1) = {"
b
b
b
b
c
c
b
b
b
b
b
b
b
b
b
"}
(15,1,1) = {"
b
b
b
b
b
b
b
b
b
b
b
b
b
b
b
"}
