//MAP CONVERTED BY dmm2tgm.py THIS HEADER COMMENT PREVENTS RECONVERSION, DO NOT REMOVE
"a" = (
/turf/open/floor/plating,
/area/bigredv2/outside/space_port_lz2)
"v" = (
/obj/effect/landmark/hunter_primary,
/turf/open/floor/plating,
/area/bigredv2/outside/space_port_lz2)

(1,1,1) = {"
a
v
a
"}
(2,1,1) = {"
a
a
a
"}
(3,1,1) = {"
a
a
a
"}
