//MAP CONVERTED BY dmm2tgm.py THIS HEADER COMMENT PREVENTS RECONVERSION, DO NOT REMOVE
"a" = (
/turf/template_noop,
/area/template_noop)
"c" = (
/obj/structure/sign/safety/medical{
	pixel_y = 32
	},
/obj/effect/decal/cleanable/dirt,
/turf/open/floor/asteroidfloor/north,
/area/bigredv2/outside/c)
"d" = (
/obj/structure/pipes/standard/simple/hidden/green,
/turf/open/floor/asteroidfloor/north,
/area/bigredv2/outside/c)
"e" = (
/obj/effect/decal/cleanable/blood,
/turf/open/floor/asteroidfloor/north,
/area/bigredv2/outside/c)
"f" = (
/obj/structure/sign/safety/medical{
	pixel_y = 32
	},
/turf/open/floor/asteroidfloor/north,
/area/bigredv2/outside/c)
"h" = (
/obj/effect/decal/cleanable/dirt,
/turf/open/floor/asteroidfloor/north,
/area/bigredv2/outside/c)
"i" = (
/obj/structure/pipes/standard/simple/hidden/green,
/obj/effect/decal/cleanable/blood,
/turf/open/floor/asteroidfloor/north,
/area/bigredv2/outside/c)
"l" = (
/turf/open/floor/asteroidfloor/north,
/area/bigredv2/outside/c)
"m" = (
/obj/effect/decal/cleanable/dirt,
/obj/effect/decal/cleanable/blood/oil,
/obj/structure/stairs/perspective{
	dir = 5;
	icon_state = "p_stair_full"
	},
/turf/open/floor/asteroidfloor/north,
/area/bigredv2/outside/c)
"n" = (
/obj/structure/stairs/perspective{
	dir = 9;
	icon_state = "p_stair_full"
	},
/turf/open/floor/asteroidfloor/north,
/area/bigredv2/outside/c)
"w" = (
/obj/structure/pipes/standard/simple/hidden/green,
/obj/structure/stairs/perspective{
	dir = 1;
	icon_state = "p_stair_full"
	},
/turf/open/floor/asteroidfloor/north,
/area/bigredv2/outside/c)
"R" = (
/turf/closed/wall/solaris/reinforced,
/area/bigredv2/outside/admin_building)
"S" = (
/obj/structure/pipes/standard/simple/hidden/green,
/obj/structure/machinery/door/airlock/multi_tile/almayer/comdoor/colony{
	name = "\improper Operations"
	},
/turf/open/floor/white,
/area/bigredv2/outside/admin_building)
"T" = (
/turf/open/floor/white,
/area/bigredv2/outside/admin_building)
"X" = (
/obj/structure/stairs/perspective{
	dir = 1;
	icon_state = "p_stair_full"
	},
/turf/open/floor/asteroidfloor/north,
/area/bigredv2/outside/c)

(1,1,1) = {"
a
a
l
l
l
R
"}
(2,1,1) = {"
a
a
c
h
n
R
"}
(3,1,1) = {"
a
a
d
i
w
S
"}
(4,1,1) = {"
a
a
e
l
X
T
"}
(5,1,1) = {"
a
a
f
l
m
R
"}
(6,1,1) = {"
a
a
l
l
l
R
"}
