//MAP CONVERTED BY dmm2tgm.py THIS HEADER COMMENT PREVENTS RECONVERSION, DO NOT REMOVE
"a" = (
/turf/open/auto_turf/lv_sand/layer0,
/area/lazarus/landing_zones/lz2)
"c" = (
/obj/structure/flora/bush/ausbushes/var3/sparsegrass,
/turf/open/auto_turf/lv_sand/layer0,
/area/lazarus/ground/jungle/west_jungle)
"j" = (
/turf/open/auto_turf/lv_sand/layer0,
/area/lazarus/ground/jungle/west_jungle)
"k" = (
/obj/effect/decal/lv_decals/red_mud_corner{
	dir = 4
	},
/turf/open/floor/prison/cell_stripe/east,
/area/lazarus/landing_zones/lz2)
"l" = (
/obj/effect/decal/lv_decals/red_mud_corner{
	dir = 1
	},
/obj/structure/barricade/handrail/wire,
/obj/structure/barricade/handrail/wire{
	layer = 3.1;
	dir = 4
	},
/turf/open/floor/prison/floor_plate,
/area/lazarus/landing_zones/lz2)
"m" = (
/obj/structure/flora/jungle/vines/blue/light_1,
/turf/closed/wall/strata_ice/jungle,
/area/strata/interior/out_of_bounds)
"n" = (
/obj/structure/flora/bush/ausbushes/var3/sunnybush,
/turf/open/auto_turf/lv_grass/layer1,
/area/lazarus/landing_zones/lz2)
"p" = (
/turf/closed/wall/strata_ice/jungle,
/area/strata/interior/out_of_bounds)
"q" = (
/obj/structure/machinery/door/airlock/light_grey_lv/glass/autoname{
	dir = 2;
	name = "\improper Jungle Checkpoint"
	},
/turf/open/floor/prison/floor_plate,
/area/lazarus/landing_zones/lz2)
"r" = (
/turf/open/floor/plating,
/area/lazarus/landing_zones/lz2)
"s" = (
/obj/structure/barricade/handrail/wire{
	layer = 3.5;
	dir = 1
	},
/obj/effect/decal/lv_decals/red_mud_corner{
	dir = 10
	},
/turf/open/floor/prison/floor_plate,
/area/lazarus/ground/jungle/west_jungle)
"t" = (
/turf/open/gm/dirt/brown/variant_5/west,
/area/lazarus/ground/jungle/west_jungle)
"u" = (
/turf/closed/wall/lv_outpost/reinforced,
/area/lazarus/landing_zones/lz2)
"v" = (
/obj/effect/decal/lv_decals/red_mud_corner,
/turf/open/floor/prison/cell_stripe,
/area/lazarus/landing_zones/lz2)
"x" = (
/turf/open/floor/brown_dirt/random_rocks_alt{
	dir = 6
	},
/area/lazarus/landing_zones/lz2)
"A" = (
/obj/effect/decal/lv_decals/red_mud_corner{
	dir = 1
	},
/turf/open/floor/prison/cell_stripe/north,
/area/lazarus/landing_zones/lz2)
"C" = (
/obj/structure/flora/jungle/vines/blue/light_1,
/turf/open/auto_turf/lv_grass/layer1,
/area/lazarus/ground/jungle/west_jungle)
"E" = (
/turf/open/auto_turf/lv_grass/layer1,
/area/lazarus/landing_zones/lz2)
"G" = (
/obj/structure/barricade/handrail/wire,
/obj/structure/barricade/handrail/wire{
	dir = 8;
	layer = 4
	},
/obj/effect/decal/lv_decals/red_mud_corner{
	dir = 1
	},
/turf/open/floor/prison/floor_plate,
/area/lazarus/landing_zones/lz2)
"K" = (
/obj/structure/window/framed/lv_colony/reinforced,
/turf/open/floor/plating/prison,
/area/lazarus/landing_zones/lz2)
"L" = (
/obj/structure/machinery/floodlight/landing{
	light_color = "#dae2ff"
	},
/obj/effect/decal/lv_decals/red_mud_corner{
	dir = 6
	},
/turf/open/floor/plating/prison,
/area/lazarus/landing_zones/lz2)
"M" = (
/obj/effect/sentry_landmark/lz_2/top_left,
/turf/open/auto_turf/lv_sand/layer0,
/area/lazarus/landing_zones/lz2)
"O" = (
/turf/closed/wall/lv_outpost/reinforced,
/area/lazarus/comms/lz2_north)
"Q" = (
/obj/structure/flora/bush/ausbushes/var3/fullgrass,
/turf/open/auto_turf/lv_sand/layer0,
/area/lazarus/ground/jungle/west_jungle)
"V" = (
/turf/open/gm/dirt/brown/variant_5/south,
/area/lazarus/ground/jungle/west_jungle)
"X" = (
/obj/effect/decal/lv_decals/red_mud_corner,
/turf/open/floor/prison/cell_stripe,
/area/lazarus/ground/jungle/west_jungle)
"Y" = (
/obj/structure/barricade/handrail/wire{
	dir = 8;
	layer = 4
	},
/obj/structure/barricade/handrail/wire{
	layer = 3.5;
	dir = 1
	},
/obj/effect/decal/lv_decals/red_mud_corner{
	dir = 6
	},
/turf/open/floor/prison/floor_plate,
/area/lazarus/ground/jungle/west_jungle)
"Z" = (
/turf/open/gm/dirt/brown/variant_5/south,
/area/lazarus/landing_zones/lz2)

(1,1,1) = {"
c
Q
p
p
p
m
C
"}
(2,1,1) = {"
j
c
u
E
E
m
m
"}
(3,1,1) = {"
t
Y
K
G
x
E
p
"}
(4,1,1) = {"
V
X
q
A
M
x
n
"}
(5,1,1) = {"
j
s
K
l
Z
a
a
"}
(6,1,1) = {"
O
O
u
E
x
L
k
"}
(7,1,1) = {"
O
m
m
E
a
v
r
"}
