//MAP CONVERTED BY dmm2tgm.py THIS HEADER COMMENT PREVENTS RECONVERSION, DO NOT REMOVE
"au" = (
/obj/item/tool/pickaxe,
/turf/open/gm/dirt,
/area/lv624/ground/caves/sand_temple)
"bd" = (
/obj/structure/surface/table,
/obj/item/weapon/melee/twohanded/spear,
/turf/open/gm/dirt,
/area/lv624/ground/caves/sand_temple)
"bS" = (
/turf/closed/wall/rock/brown,
/area/lv624/ground/barrens/south_eastern_barrens)
"bT" = (
/obj/effect/alien/weeds/node,
/turf/open/gm/dirt,
/area/lv624/ground/caves/south_east_caves)
"ck" = (
/obj/effect/landmark/structure_spawner/xvx_hive/xeno_wall,
/obj/effect/landmark/structure_spawner/setup/distress/xeno_wall,
/turf/open/gm/dirt,
/area/lv624/ground/caves/south_east_caves)
"cJ" = (
/obj/structure/surface/table,
/obj/item/device/flashlight/lantern,

/turf/open/gm/dirt,
/area/lv624/ground/caves/sand_temple)
"cP" = (
/obj/structure/surface/table,
/obj/item/device/flashlight/lantern,
/obj/item/hunting_trap{
	desc = "A bizarre alien device used for trapping and killing prey.";
	name = "Alien Mine"
	},
/turf/open/gm/dirt,
/area/lv624/ground/caves/sand_temple)
"fg" = (
/obj/structure/showcase{
	desc = "An ancient, dusty tomb with strange alien writing. It's best not to touch it.";
	icon_state = "yaut";
	name = "alien sarcophagus"
	},
/turf/open/floor{
	dir = 4;
	icon_state = "whiteyellowfull"
	},
/area/lv624/ground/caves/sand_temple)
"fH" = (
/obj/effect/spider/stickyweb{
	dir = 4;
	icon_state = "cobweb1"
	},
/obj/effect/spider/stickyweb{
	icon_state = "cobweb1"
	},
/turf/open/gm/dirt,
/area/lv624/ground/caves/sand_temple)
"fP" = (
/obj/structure/showcase{
	desc = "An ancient, dusty tomb with strange alien writing. It's best not to touch it.";
	icon_state = "yaut";
	name = "alien sarcophagus"
	},
/obj/item/weapon/melee/twohanded/glaive/damaged,

/turf/open/floor{
	dir = 4;
	icon_state = "whiteyellowfull"
	},
/area/lv624/ground/caves/sand_temple)
"hg" = (
/turf/open/gm/dirt,
/area/lv624/ground/caves/south_east_caves)
"hU" = (
/obj/effect/landmark/yautja_teleport,
/turf/open/gm/dirt,
/area/lv624/ground/barrens/south_eastern_barrens)
"jd" = (
/turf/open/gm/dirtgrassborder{
	dir = 8
	},
/area/lv624/ground/barrens/south_eastern_barrens)
"jj" = (
/obj/structure/surface/table,
/obj/item/weapon/melee/unathiknife,
/turf/open/floor{
	dir = 4;
	icon_state = "whiteyellowfull"
	},
/area/lv624/ground/caves/sand_temple)
"jn" = (
/turf/open/gm/dirt,
/area/lv624/ground/caves/sand_temple)
"jZ" = (
/obj/structure/blocker/forcefield/vehicles,
/turf/open/floor{
	dir = 4;
	icon_state = "whiteyellowfull"
	},
/area/lv624/ground/caves/south_east_caves)
"kg" = (
/obj/structure/surface/table/reinforced/prison{
	color = "#6b675e"
	},
/obj/item/stack/sheet/mineral/sandstone{
	amount = 50
	},

/turf/open/floor{
	dir = 4;
	icon_state = "whiteyellowfull"
	},
/area/lv624/ground/caves/sand_temple)
"kP" = (
/obj/structure/kitchenspike,
/obj/effect/spider/stickyweb{
	dir = 8;
	icon_state = "cobweb1"
	},

/turf/open/floor{
	color = "#6b675e";
	dir = 4;
	icon_state = "whiteyellowfull"
	},
/area/lv624/ground/caves/sand_temple)
"lj" = (

/turf/open/gm/dirt,
/area/lv624/ground/barrens/south_eastern_barrens)
"lV" = (
/obj/structure/flora/bush/ausbushes/reedbush,
/turf/open/gm/dirt,
/area/lv624/ground/caves/sand_temple)
"mk" = (
/turf/open/gm/dirt,
/area/lv624/ground/barrens/north_east_barrens)
"mD" = (
/obj/effect/decal/remains/xeno,
/obj/structure/surface/table,
/obj/effect/landmark/good_item,
/turf/open/floor{
	dir = 4;
	icon_state = "whiteyellowfull"
	},
/area/lv624/ground/caves/sand_temple)
"nn" = (
/obj/effect/decal/remains/xeno,
/turf/open/gm/dirt,
/area/lv624/ground/caves/south_east_caves)
"nM" = (
/obj/structure/surface/table,
/obj/item/hunting_trap{
	desc = "A bizarre alien device used for trapping and killing prey.";
	name = "Alien Mine"
	},

/turf/open/floor{
	color = "#6b675e";
	dir = 4;
	icon_state = "whiteyellowfull"
	},
/area/lv624/ground/caves/sand_temple)
"nT" = (
/obj/structure/surface/table,
/obj/item/hunting_trap{
	desc = "A bizarre alien device used for trapping and killing prey.";
	name = "Alien Mine"
	},

/obj/effect/landmark/crap_item,
/turf/open/floor{
	color = "#6b675e";
	dir = 4;
	icon_state = "whiteyellowfull"
	},
/area/lv624/ground/caves/sand_temple)
"oq" = (
/obj/effect/spider/stickyweb{
	dir = 8;
	icon_state = "cobweb1"
	},
/turf/open/floor{
	color = "#6b675e";
	dir = 4;
	icon_state = "whiteyellowfull"
	},
/area/lv624/ground/caves/sand_temple)
"pK" = (
/obj/structure/showcase{
	desc = "An ancient, dusty tomb with strange alien writing. It's best not to touch it.";
	icon_state = "yaut";
	name = "alien sarcophagus"
	},

/turf/open/gm/dirt,
/area/lv624/ground/caves/sand_temple)
"ra" = (
/obj/effect/landmark/monkey_spawn,
/turf/open/gm/dirt,
/area/lv624/ground/caves/sand_temple)
"ru" = (
/obj/structure/surface/table,

/obj/effect/landmark/crap_item,
/turf/open/gm/dirt,
/area/lv624/ground/caves/sand_temple)
"sn" = (
/obj/effect/spider/stickyweb{
	icon_state = "cobweb1"
	},
/turf/open/gm/dirt,
/area/lv624/ground/caves/sand_temple)
"sS" = (
/obj/effect/landmark/monkey_spawn,
/turf/open/gm/dirt,
/area/lv624/ground/barrens/south_eastern_barrens)
"ti" = (
/obj/structure/blocker/forcefield/vehicles,
/obj/effect/landmark/structure_spawner/xvx_hive/xeno_wall,
/obj/effect/landmark/structure_spawner/setup/distress/xeno_wall,
/obj/structure/blocker/forcefield/vehicles,
/turf/open/gm/dirt,
/area/lv624/ground/caves/south_east_caves)
"to" = (
/obj/item/stack/sheet/mineral/sandstone{
	amount = 50
	},
/obj/structure/surface/table,
/obj/effect/spider/stickyweb{
	icon_state = "cobweb1"
	},
/turf/open/floor{
	dir = 4;
	icon_state = "whiteyellowfull"
	},
/area/lv624/ground/caves/sand_temple)
"tI" = (
/obj/structure/flora/bush/ausbushes/reedbush{
	pixel_x = 5;
	pixel_y = 12
	},
/turf/open/gm/dirt,
/area/lv624/ground/caves/sand_temple)
"wG" = (
/obj/structure/surface/table,
/obj/item/weapon/melee/harpoon,
/turf/open/gm/dirt,
/area/lv624/ground/caves/sand_temple)
"wW" = (
/obj/structure/machinery/door/airlock/sandstone{
	desc = "This strange temple is covered in runes. It looks extremely ancient.";
	icon_state = "door_locked";
	locked = 1;
	name = "Strange Temple"
	},
/turf/open/floor{
	dir = 4;
	icon_state = "whiteyellowfull"
	},
/area/lv624/ground/caves/sand_temple)
"xx" = (
/obj/effect/spider/stickyweb{
	icon_state = "cobweb2"
	},
/turf/open/floor{
	color = "#6b675e";
	dir = 4;
	icon_state = "whiteyellowfull"
	},
/area/lv624/ground/caves/sand_temple)
"yu" = (
/obj/structure/surface/table,

/obj/item/weapon/melee/twohanded/spear,
/turf/open/floor{
	color = "#6b675e";
	dir = 4;
	icon_state = "whiteyellowfull"
	},
/area/lv624/ground/caves/sand_temple)
"Ar" = (
/turf/closed/wall/rock/brown,
/area/lv624/ground/caves/south_east_caves)
"Bq" = (
/obj/structure/blocker/forcefield/vehicles,
/turf/closed/wall/mineral/sandstone,
/area/lv624/ground/caves/sand_temple)
"Cn" = (
/turf/closed/wall/strata_ice/jungle,
/area/lv624/ground/barrens/south_eastern_barrens)
"Cy" = (
/obj/effect/landmark/structure_spawner/xvx_hive/xeno_nest,
/obj/effect/landmark/structure_spawner/setup/distress/xeno_nest,
/obj/effect/alien/weeds/node,
/turf/open/gm/dirt,
/area/lv624/ground/caves/south_east_caves)
"CT" = (
/obj/effect/landmark/structure_spawner/xvx_hive/xeno_door,
/obj/structure/blocker/forcefield/vehicles,
/obj/effect/landmark/structure_spawner/setup/distress/xeno_door,
/turf/open/gm/dirt,
/area/lv624/ground/caves/sand_temple)
"Dh" = (
/turf/open/floor{
	dir = 4;
	icon_state = "whiteyellowfull"
	},
/area/lv624/ground/caves/sand_temple)
"Di" = (
/obj/structure/machinery/door/airlock/sandstone{
	desc = "This strange temple is covered in runes. It looks extremely ancient.";
	icon_state = "door_locked";
	locked = 1;
	name = "Strange Temple"
	},
/turf/open/gm/dirt,
/area/lv624/ground/caves/sand_temple)
"Dm" = (
/obj/structure/surface/table,
/obj/effect/spider/stickyweb{
	icon_state = "cobweb2"
	},

/obj/item/weapon/melee/twohanded/spear,
/turf/open/floor{
	color = "#6b675e";
	dir = 4;
	icon_state = "whiteyellowfull"
	},
/area/lv624/ground/caves/sand_temple)
"Ds" = (
/turf/closed/wall/mineral/sandstone,
/area/lv624/ground/caves/sand_temple)
"Dt" = (
/obj/structure/kitchenspike,
/turf/open/gm/dirt,
/area/lv624/ground/caves/sand_temple)
"Dx" = (
/obj/effect/decal/remains/xeno,
/turf/open/gm/dirt,
/area/lv624/ground/caves/sand_temple)
"DC" = (
/turf/closed/wall/rock/brown,
/area/lv624/ground/caves/sand_temple)
"DK" = (
/turf/open/gm/dirt,
/area/lv624/ground/barrens/south_eastern_barrens)
"EK" = (
/obj/effect/spider/stickyweb{
	dir = 8;
	icon_state = "cobweb1"
	},
/turf/open/gm/dirt,
/area/lv624/ground/caves/sand_temple)
"Fc" = (
/obj/structure/surface/table,
/obj/effect/landmark/crap_item,
/turf/open/gm/dirt,
/area/lv624/ground/caves/sand_temple)
"FK" = (
/obj/structure/surface/table,
/obj/item/stack/sheet/mineral/sandstone{
	amount = 50
	},

/turf/open/gm/dirt,
/area/lv624/ground/caves/sand_temple)
"FQ" = (
/obj/effect/spider/stickyweb,
/turf/open/gm/dirt,
/area/lv624/ground/caves/sand_temple)
"Gy" = (
/obj/structure/showcase{
	desc = "An ancient, dusty tomb with strange alien writing. It's best not to touch it.";
	icon_state = "yaut";
	name = "alien sarcophagus"
	},
/obj/effect/spider/stickyweb{
	icon_state = "cobweb2"
	},
/obj/item/weapon/melee/twohanded/spear,
/turf/open/gm/dirt,
/area/lv624/ground/caves/sand_temple)
"Hw" = (
/obj/structure/surface/table/reinforced/prison{
	color = "#6b675e"
	},
/obj/item/hunting_trap{
	desc = "A bizarre alien device used for trapping and killing prey.";
	name = "Alien Mine"
	},

/turf/open/floor{
	dir = 4;
	icon_state = "whiteyellowfull"
	},
/area/lv624/ground/caves/sand_temple)
"HB" = (
/obj/structure/surface/table,
/obj/item/stack/sheet/mineral/sandstone{
	amount = 50
	},

/turf/open/floor{
	color = "#6b675e";
	dir = 4;
	icon_state = "whiteyellowfull"
	},
/area/lv624/ground/caves/sand_temple)
"HG" = (
/obj/effect/landmark/hunter_primary,
/turf/open/gm/dirt,
/area/lv624/ground/caves/sand_temple)
"HM" = (
/obj/effect/spider/stickyweb,
/obj/item/hunting_trap{
	desc = "A bizarre alien device used for trapping and killing prey.";
	name = "Alien Mine"
	},
/turf/open/floor{
	dir = 4;
	icon_state = "whiteyellowfull"
	},
/area/lv624/ground/caves/sand_temple)
"HN" = (
/obj/structure/kitchenspike{
	icon_state = "spikebloody"
	},
/turf/open/gm/dirt,
/area/lv624/ground/caves/sand_temple)
"IN" = (
/obj/structure/window_frame/wood,
/turf/open/gm/dirt,
/area/lv624/ground/caves/sand_temple)
"Jx" = (
/obj/structure/kitchenspike,
/turf/open/floor{
	color = "#6b675e";
	dir = 4;
	icon_state = "whiteyellowfull"
	},
/area/lv624/ground/caves/sand_temple)
"JX" = (
/obj/structure/flora/bush/ausbushes/palebush{
	pixel_x = -6;
	pixel_y = -6
	},
/turf/open/gm/dirt,
/area/lv624/ground/caves/sand_temple)
"Kw" = (
/obj/structure/surface/table,
/turf/open/floor{
	dir = 4;
	icon_state = "whiteyellowfull"
	},
/area/lv624/ground/caves/sand_temple)
"KK" = (
/obj/effect/alien/weeds/node,
/turf/open/gm/dirt,
/area/lv624/ground/caves/sand_temple)
"La" = (
/obj/structure/flora/bush/ausbushes/grassybush,
/turf/open/gm/dirt,
/area/lv624/ground/caves/sand_temple)
"LZ" = (
/obj/effect/spider/stickyweb{
	dir = 8;
	icon_state = "cobweb1"
	},
/obj/effect/spider/stickyweb{
	dir = 1;
	icon_state = "cobweb1"
	},
/turf/open/floor{
	color = "#6b675e";
	dir = 4;
	icon_state = "whiteyellowfull"
	},
/area/lv624/ground/caves/sand_temple)
"MP" = (
/obj/effect/spider/stickyweb{
	dir = 8;
	icon_state = "cobweb1"
	},
/turf/open/floor{
	dir = 4;
	icon_state = "whiteyellowfull"
	},
/area/lv624/ground/caves/sand_temple)
"Nd" = (
/obj/effect/alien/weeds/node,
/turf/open/gm/dirt,
/area/lv624/ground/barrens/south_eastern_barrens)
"Nt" = (
/obj/effect/decal/remains/xeno,
/obj/structure/blocker/forcefield/vehicles,
/turf/open/gm/dirt,
/area/lv624/ground/caves/south_east_caves)
"Od" = (
/obj/structure/showcase{
	desc = "An ancient, dusty tomb with strange alien writing. It's best not to touch it.";
	icon_state = "yaut";
	name = "alien sarcophagus"
	},

/turf/open/floor{
	dir = 4;
	icon_state = "whiteyellowfull"
	},
/area/lv624/ground/caves/sand_temple)
"PF" = (
/obj/structure/surface/table,
/obj/item/hunting_trap{
	desc = "A bizarre alien device used for trapping and killing prey.";
	name = "Alien Mine"
	},
/turf/open/gm/dirt,
/area/lv624/ground/caves/sand_temple)
"Qd" = (
/obj/effect/landmark/structure_spawner/xvx_hive/xeno_nest,
/obj/effect/landmark/structure_spawner/setup/distress/xeno_nest,
/turf/open/gm/dirt,
/area/lv624/ground/caves/south_east_caves)
"QM" = (
/obj/structure/showcase{
	desc = "An ancient, dusty tomb with strange alien writing. It's best not to touch it.";
	icon_state = "yaut";
	name = "alien sarcophagus"
	},
/obj/effect/spider/stickyweb,

/turf/open/gm/dirt,
/area/lv624/ground/caves/sand_temple)
"Sj" = (
/obj/structure/surface/table,
/obj/item/device/flashlight/lantern,

/turf/open/floor{
	color = "#6b675e";
	dir = 4;
	icon_state = "whiteyellowfull"
	},
/area/lv624/ground/caves/sand_temple)
"Tr" = (
/obj/structure/flora/bush/ausbushes/palebush{
	pixel_x = 7;
	pixel_y = 15
	},
/turf/open/gm/dirt,
/area/lv624/ground/caves/sand_temple)
"TD" = (
/turf/open/floor{
	color = "#6b675e";
	dir = 4;
	icon_state = "whiteyellowfull"
	},
/area/lv624/ground/caves/sand_temple)
"Uc" = (

/turf/open/gm/dirt,
/area/lv624/ground/caves/sand_temple)
"Uf" = (
/obj/structure/surface/table,
/obj/item/device/flashlight/lantern,
/turf/open/floor{
	dir = 4;
	icon_state = "whiteyellowfull"
	},
/area/lv624/ground/caves/sand_temple)
"Vg" = (
/obj/effect/landmark/crap_item,
/turf/open/gm/dirt,
/area/lv624/ground/caves/sand_temple)
"Vq" = (
/turf/open/floor{
	dir = 4;
	icon_state = "whiteyellowfull"
	},
/area/lv624/ground/caves/south_east_caves)
"VD" = (
/obj/structure/surface/table,
/obj/item/stack/sheet/mineral/sandstone{
	amount = 50
	},
/obj/effect/spider/stickyweb{
	dir = 1;
	icon_state = "cobweb1"
	},

/turf/open/floor{
	color = "#6b675e";
	dir = 4;
	icon_state = "whiteyellowfull"
	},
/area/lv624/ground/caves/sand_temple)
"VJ" = (
/obj/structure/surface/table,
/turf/open/floor{
	color = "#6b675e";
	dir = 4;
	icon_state = "whiteyellowfull"
	},
/area/lv624/ground/caves/sand_temple)
"VL" = (
/obj/structure/kitchenspike,

/turf/open/floor{
	dir = 4;
	icon_state = "whiteyellowfull"
	},
/area/lv624/ground/caves/sand_temple)
"Wh" = (
/obj/structure/showcase{
	desc = "An ancient, dusty tomb with strange alien writing. It's best not to touch it.";
	icon_state = "yaut";
	name = "alien sarcophagus"
	},
/obj/effect/spider/stickyweb{
	icon_state = "cobweb2"
	},
/turf/open/floor{
	dir = 4;
	icon_state = "whiteyellowfull"
	},
/area/lv624/ground/caves/sand_temple)
"Ws" = (
/obj/structure/surface/table,
/obj/item/weapon/melee/twohanded/spear,
/turf/open/floor{
	color = "#6b675e";
	dir = 4;
	icon_state = "whiteyellowfull"
	},
/area/lv624/ground/caves/sand_temple)
"Wx" = (
/obj/effect/spider/stickyweb{
	dir = 8;
	icon_state = "cobweb1"
	},
/obj/effect/landmark/crap_item,
/turf/open/gm/dirt,
/area/lv624/ground/caves/sand_temple)
"WU" = (
/obj/effect/spider/stickyweb,

/turf/open/floor{
	color = "#6b675e";
	dir = 4;
	icon_state = "whiteyellowfull"
	},
/area/lv624/ground/caves/sand_temple)
"Xy" = (
/obj/effect/spider/stickyweb{
	dir = 1;
	icon_state = "cobweb1"
	},
/obj/effect/landmark/crap_item,
/turf/open/gm/dirt,
/area/lv624/ground/caves/sand_temple)
"XI" = (
/obj/structure/surface/table,
/turf/open/gm/dirt,
/area/lv624/ground/caves/sand_temple)
"YY" = (
/obj/structure/window_frame/wood,
/turf/open/floor{
	dir = 4;
	icon_state = "whiteyellowfull"
	},
/area/lv624/ground/caves/sand_temple)
"Zf" = (
/obj/structure/surface/table,
/obj/item/device/flashlight/lantern,
/obj/effect/spider/stickyweb{
	icon_state = "cobweb1"
	},

/turf/open/floor{
	color = "#6b675e";
	dir = 4;
	icon_state = "whiteyellowfull"
	},
/area/lv624/ground/caves/sand_temple)
"Zu" = (
/obj/structure/kitchenspike{
	icon_state = "spikebloodygreen"
	},
/turf/open/gm/dirt,
/area/lv624/ground/caves/sand_temple)
"Zw" = (
/obj/effect/spider/stickyweb{
	dir = 1;
	icon_state = "cobweb1"
	},
/turf/open/gm/dirt,
/area/lv624/ground/caves/sand_temple)

(1,1,1) = {"
mk
mk
mk
mk
DC
DC
DC
DC
DC
DC
DC
DC
DC
DC
DC
DC
DC
DC
DC
DC
DC
DC
DC
DC
DC
DC
"}
(2,1,1) = {"
mk
mk
mk
DC
DC
DC
DC
DC
DC
DC
DC
DC
DC
DC
DC
jn
jn
DC
DC
DC
DC
DC
DC
DC
DC
DC
"}
(3,1,1) = {"
mk
mk
mk
DC
DC
DC
DC
jn
jn
DC
DC
DC
jn
jn
jn
jn
jn
jn
DC
DC
DC
DC
DC
jn
jn
DC
"}
(4,1,1) = {"
mk
mk
DC
DC
DC
jn
jn
jn
jn
jn
jn
jn
jn
jn
jn
jn
Vg
jn
jn
DC
DC
DC
jn
jn
jn
CT
"}
(5,1,1) = {"
mk
DC
DC
DC
DC
jn
jn
jn
jn
jn
jn
jn
jn
Uc
jn
jn
jn
jn
jn
jn
jn
jn
jn
jn
jn
CT
"}
(6,1,1) = {"
DC
DC
DC
DC
DC
jn
jn
jn
jn
jn
KK
jn
jn
jn
jn
jn
KK
jn
jn
jn
jn
jn
jn
jn
jn
CT
"}
(7,1,1) = {"
DC
DC
DC
DC
jn
jn
jn
Uc
jn
Dx
jn
jn
Vg
jn
jn
jn
jn
jn
jn
jn
jn
KK
jn
jn
jn
DC
"}
(8,1,1) = {"
DC
to
Dh
jn
jn
KK
jn
jn
jn
jn
jn
jn
jn
jn
jn
jn
jn
jn
Dx
jn
jn
jn
jn
jn
jn
DC
"}
(9,1,1) = {"
DC
mD
jn
jn
jn
jn
jn
Ds
Ds
Ds
jn
jn
Ds
Ds
Dh
wW
Ds
jn
jn
jn
jn
jn
jn
jn
DC
DC
"}
(10,1,1) = {"
Bq
wG
Dh
jn
jn
jn
jn
Ds
Xy
Ds
Ds
Ds
Ds
TD
TD
TD
Ds
jn
jn
Uc
Dx
jn
jn
DC
DC
DC
"}
(11,1,1) = {"
Bq
Ds
Ds
Ds
Ds
Di
Ds
Ds
TD
jn
VD
Zf
TD
Dh
jn
MP
Ds
jn
jn
jn
jn
jn
DC
DC
DC
DC
"}
(12,1,1) = {"
Nt
jZ
HM
Di
TD
TD
Dh
jn
TD
TD
jn
jn
La
Dh
Dx
Zw
Ds
La
jn
jn
jn
jn
jn
DC
DC
DC
"}
(13,1,1) = {"
hg
jZ
jn
wW
TD
jn
Dh
Dh
TD
jn
jn
jn
jn
jn
Dh
jn
Ds
Ds
Ds
jn
jn
jn
jn
jn
jn
DC
"}
(14,1,1) = {"
hg
Nt
Bq
Ds
TD
jn
jn
Dh
TD
TD
TD
jn
jn
jn
Dh
Dh
Dh
cJ
IN
jn
jn
au
jn
jn
jn
DC
"}
(15,1,1) = {"
hg
Vq
Bq
FK
Dh
jn
Dh
Dx
Jx
kg
Dh
Hw
TD
jn
TD
ra
Dh
Dh
YY
jn
jn
jn
jn
KK
jn
DC
"}
(16,1,1) = {"
hg
hg
Bq
ru
Dh
La
jn
jn
Dt
Dh
La
Dh
jn
jn
TD
TD
Dh
jn
IN
jn
jn
Ds
jn
Ds
jn
jn
"}
(17,1,1) = {"
nn
hg
Bq
Bq
TD
Dh
jn
jn
nM
Dh
jn
jn
TD
jn
jn
TD
jn
nT
YY
jn
jn
jn
La
Dx
jn
jn
"}
(18,1,1) = {"
hg
bT
hg
Bq
HB
TD
TD
jn
nM
Hw
HN
Zu
Dh
jn
EK
Ds
Ds
Ds
Ds
jn
jn
Ds
Uc
Ds
jn
DC
"}
(19,1,1) = {"
hg
nn
hg
Bq
Dm
yu
TD
jn
jn
TD
jn
jn
Dh
Dh
Ds
Ds
jn
jn
jn
jn
jn
jn
jn
jn
jn
DC
"}
(20,1,1) = {"
hg
hg
hg
Bq
Ds
TD
jn
jn
jn
jn
Dh
jn
jn
La
wW
jn
jn
jn
jn
KK
jn
jn
jn
jn
lV
DC
"}
(21,1,1) = {"
hg
hg
hg
DC
Ds
TD
jn
jn
Dh
jn
Dh
jn
Dh
Dx
wW
jn
jn
La
jn
jn
jn
jn
jn
jn
DC
DC
"}
(22,1,1) = {"
ti
ti
DC
DC
Ds
xx
TD
jn
jn
Dh
Dh
Dh
EK
Ds
Ds
jn
jn
jn
jn
jn
jn
jn
DC
DC
DC
DC
"}
(23,1,1) = {"
Ar
Ar
DC
DC
Ds
Ds
TD
jn
TD
TD
Ds
Ds
Ds
Ds
jn
jn
jn
KK
jn
jn
Dx
DC
DC
DC
DC
DC
"}
(24,1,1) = {"
Ar
Ar
DC
DC
DC
Ds
jn
jn
jn
TD
IN
La
JX
Ds
Ds
jn
jn
jn
jn
jn
DC
DC
DC
DK
DC
DC
"}
(25,1,1) = {"
Ar
Ar
DC
DC
DC
Ds
bd
jn
TD
PF
YY
jn
jn
jn
YY
Uc
jn
jn
jn
KK
jn
CT
Nd
DK
DK
DC
"}
(26,1,1) = {"
Ar
Ar
DC
DC
DC
Ds
Sj
jn
Dh
Fc
YY
jn
Tr
La
IN
jn
jn
jn
DC
jn
jn
CT
DK
DK
DK
DK
"}
(27,1,1) = {"
Ar
Ar
DC
DC
DC
Ds
Ws
TD
Dx
Kw
IN
jn
jn
Ds
Ds
TD
Dh
Ds
DC
HG
jn
CT
DK
DK
DK
Nd
"}
(28,1,1) = {"
ck
Ar
DC
DC
DC
Ds
tI
jn
Dh
jn
IN
jn
jn
YY
Jx
Dh
jn
TD
Ds
DC
DC
DC
DK
lj
DK
DK
"}
(29,1,1) = {"
Qd
Ar
DC
DC
DC
Ds
TD
jn
jn
MP
Ds
tI
jn
IN
jn
jn
Dh
jn
Ds
DC
DC
DK
DK
DK
DK
sS
"}
(30,1,1) = {"
Qd
ck
DC
DC
Ds
Ds
Ds
TD
jn
Ds
Ds
Ds
La
YY
tI
jn
jn
Dh
Ds
DC
DC
DK
DK
bS
DK
DK
"}
(31,1,1) = {"
ck
Ar
DC
Ds
Ds
Uf
Vg
jn
TD
jn
cP
Ds
Ds
Ds
TD
Dh
Dh
Dh
Ds
DC
DC
DC
DK
DK
DK
DK
"}
(32,1,1) = {"
Qd
ck
DC
Ds
pK
TD
jn
jn
jn
ra
TD
fP
Ds
Ds
TD
XI
jn
TD
Ds
DC
DC
DC
DC
DK
DK
DK
"}
(33,1,1) = {"
Cy
ck
DC
Ds
TD
jn
jn
jn
Dh
jn
Dx
jn
Ds
WU
TD
jj
jn
Dh
Ds
DC
DC
DC
DK
DK
Nd
DK
"}
(34,1,1) = {"
Qd
ck
DC
Ds
Gy
jn
Dh
jn
jn
TD
Dh
fg
Ds
jn
jn
VJ
XI
Dx
Ds
DC
DC
DC
DC
DC
DK
DK
"}
(35,1,1) = {"
ck
Ar
DC
Ds
sn
TD
TD
Dh
jn
TD
jn
Wx
Ds
TD
jn
jn
jn
Dh
Ds
DC
DC
DC
DK
DK
DK
DK
"}
(36,1,1) = {"
Ar
Ar
DC
Ds
Od
jn
jn
jn
jn
jn
TD
QM
Ds
jn
La
Dh
Dh
oq
Ds
DC
DC
DC
DK
DK
DK
DK
"}
(37,1,1) = {"
Ar
Ar
DC
Ds
Ds
Dh
Dh
jn
Dh
TD
EK
Ds
Ds
TD
Dh
Dh
kP
Ds
Ds
DC
DC
DK
DK
DK
DK
hU
"}
(38,1,1) = {"
Ar
Ar
DC
DC
Ds
Ds
Wh
jn
jn
Od
Ds
Ds
DC
VL
jn
jn
Ds
Ds
DC
DC
DC
DK
DK
DK
Nd
DK
"}
(39,1,1) = {"
Ar
Ar
DC
DC
DC
Ds
Ds
TD
Ds
Ds
Ds
DC
DC
DC
tI
Dh
Ds
DC
DC
DC
DC
DK
DK
DK
DK
DK
"}
(40,1,1) = {"
Ar
Ar
DC
DC
DC
DC
Ds
TD
jn
LZ
FQ
FQ
fH
TD
Dh
Dh
Ds
DC
DC
DC
DC
DK
DK
DK
DK
DK
"}
(41,1,1) = {"
Ar
Ar
DC
DC
DC
DC
Ds
Ds
Ds
Ds
Ds
Ds
Ds
Ds
Ds
Ds
Ds
DC
DC
DC
DC
DC
jd
jd
jd
jd
"}
(42,1,1) = {"
Ar
Ar
DC
DC
DC
DC
DC
DC
DC
DC
DC
DC
DC
DC
DC
DC
DC
DC
DC
DC
DC
DC
Cn
Cn
Cn
Cn
"}
