//MAP CONVERTED BY dmm2tgm.py THIS HEADER COMMENT PREVENTS RECONVERSION, DO NOT REMOVE
"aa" = (
/turf/open/gm/grass/grass1,
/area/lv624/ground/jungle/north_west_jungle)
"ab" = (
/turf/closed/wall/r_wall,
/area/lv624/lazarus/research)
"ac" = (
/obj/structure/window/framed/colony/reinforced,
/obj/structure/machinery/door/poddoor/almayer{
	id = "science_blast";
	layer = 3.3;
	name = "\improper Science Wing Blast Door"
	},
/turf/open/floor/plating,
/area/lv624/lazarus/research)
"ad" = (
/obj/structure/machinery/door/poddoor/almayer{
	id = "science_blast";
	layer = 3.3;
	name = "\improper Science Wing Blast Door"
	},
/obj/structure/machinery/door/airlock/almayer/research/colony{
	dir = 1;
	locked = 1;
	name = "\improper Research Dome"
	},
/turf/open/floor/white,
/area/lv624/lazarus/research)
"ae" = (
/turf/open/gm/dirt,
/area/lv624/ground/colony/south_medbay_road)
"ag" = (
/obj/effect/decal/remains/xeno,
/turf/open/gm/dirt,
/area/lv624/ground/colony/south_medbay_road)
"ah" = (
/turf/closed/wall/strata_ice/jungle,
/area/lv624/ground/jungle/north_west_jungle)
"ai" = (
/obj/structure/window_frame/colony/reinforced,
/obj/structure/machinery/door/poddoor/almayer{
	id = "science_blast";
	layer = 3.3;
	name = "\improper Science Wing Blast Door"
	},
/turf/open/floor/plating,
/area/lv624/lazarus/research)
"aj" = (
/obj/structure/surface/table,
/obj/item/paper/research_notes,
/obj/effect/landmark/crap_item,
/turf/open/floor/whitepurple/southeast,
/area/lv624/lazarus/research)
"ak" = (
/turf/open/floor/white,
/area/lv624/lazarus/research)
"al" = (
/obj/effect/landmark/crap_item,
/turf/open/floor/whitepurple/southeast,
/area/lv624/lazarus/research)
"am" = (
/obj/structure/bed/chair/comfy/yautja{
	dir = 8
	},
/turf/open/floor/whitepurple/southeast,
/area/lv624/lazarus/research)
"ao" = (
/obj/structure/window/framed/colony/reinforced,
/obj/structure/machinery/door/poddoor/almayer{
	dir = 4;
	id = "science_blast";
	layer = 3.3;
	name = "\improper Science Wing Blast Door"
	},
/turf/open/floor/plating,
/area/lv624/lazarus/research)
"ar" = (
/turf/closed/wall,
/area/lv624/lazarus/research)
"as" = (
/obj/structure/surface/table,
/obj/structure/machinery/microwave/yautja{
	pixel_y = 7
	},
/turf/open/floor/whitepurple/southeast,
/area/lv624/lazarus/research)
"at" = (
/obj/structure/surface/table,
/obj/item/reagent_container/hypospray/autoinjector/yautja,
/obj/item/reagent_container/hypospray/autoinjector/yautja,
/turf/open/floor/whitepurple/southeast,
/area/lv624/lazarus/research)
"av" = (
/turf/open/gm/grass/grass1,
/area/lv624/ground/colony/south_medbay_road)
"ay" = (
/obj/structure/machinery/door/airlock/almayer/research/colony{
	locked = 1;
	name = "\improper Research Dome"
	},
/turf/open/floor/whitepurple/southeast,
/area/lv624/lazarus/research)
"aA" = (
/obj/structure/bed/chair/office/dark{
	dir = 1
	},
/turf/open/floor/whitepurple/southeast,
/area/lv624/lazarus/research)
"aB" = (
/obj/structure/closet/yautja,
/obj/item/tool/wirecutters/yautja,
/obj/item/tool/crowbar/yautja,
/obj/item/tool/wrench/yautja,
/turf/open/floor/whitepurple/southeast,
/area/lv624/lazarus/research)
"aC" = (
/obj/structure/machinery/light{
	dir = 1
	},
/turf/open/floor/whitepurple/southeast,
/area/lv624/lazarus/research)
"aD" = (
/obj/structure/machinery/shower{
	dir = 1
	},
/obj/structure/machinery/light{
	dir = 4
	},
/turf/open/floor/freezerfloor,
/area/lv624/lazarus/research)
"aE" = (
/obj/structure/surface/table,
/obj/structure/machinery/cell_charger,
/obj/item/tool/crowbar,
/obj/effect/landmark/objective_landmark/science,
/turf/open/floor/whitepurple/southeast,
/area/lv624/lazarus/research)
"aF" = (
/obj/structure/surface/table,
/obj/item/weapon/yautja/scythe,
/obj/effect/landmark/objective_landmark/science,
/turf/open/floor/whitepurple/southeast,
/area/lv624/lazarus/research)
"aG" = (
/obj/structure/machinery/door/airlock/almayer/research/colony{
	dir = 1;
	locked = 1;
	name = "\improper Research Dome"
	},
/turf/open/floor/whitepurple/southeast,
/area/lv624/lazarus/research)
"aH" = (
/obj/structure/machinery/door/airlock/almayer/research/colony{
	dir = 1;
	locked = 1;
	name = "\improper Research Dome"
	},
/turf/open/floor/white,
/area/lv624/lazarus/research)
"aJ" = (
/obj/structure/machinery/light{
	dir = 8
	},
/obj/structure/surface/table,
/obj/item/storage/box/disks{
	layer = 2.9;
	pixel_x = 5;
	pixel_y = 5
	},
/obj/item/paper/research_notes,
/obj/item/prop/alien/hugger,
/obj/effect/landmark/objective_landmark/science,
/turf/open/floor/white,
/area/lv624/lazarus/research)
"aK" = (
/obj/structure/machinery/door_control{
	id = "science_blast";
	name = "Science Wing Lockdown";
	pixel_x = 25
	},
/obj/structure/showcase/yautja{
	dir = 8
	},
/turf/open/floor/white,
/area/lv624/lazarus/research)
"aN" = (
/obj/structure/machinery/door/poddoor/almayer{
	dir = 4;
	id = "science_blast";
	layer = 3.3;
	name = "\improper Science Wing Blast Door"
	},
/obj/structure/machinery/door/airlock/almayer/research/colony{
	locked = 1;
	name = "\improper Research Dome"
	},
/turf/open/floor/white,
/area/lv624/lazarus/research)
"aO" = (
/obj/structure/bed/chair/office/dark,
/turf/open/floor/white,
/area/lv624/lazarus/research)
"aP" = (
/obj/structure/machinery/door/airlock/almayer/research/colony{
	locked = 1;
	name = "\improper Research Dome"
	},
/turf/open/floor/white,
/area/lv624/lazarus/research)
"aQ" = (
/obj/item/clothing/glasses/regular,
/turf/open/floor/white,
/area/lv624/lazarus/research)
"aS" = (
/obj/structure/machinery/door/poddoor/almayer{
	dir = 4;
	id = "science_blast";
	layer = 3.3;
	name = "\improper Science Wing Blast Door"
	},
/turf/open/floor/whitepurple/southeast,
/area/lv624/lazarus/research)
"aT" = (
/obj/structure/machinery/light{
	dir = 4
	},
/obj/effect/landmark/crap_item,
/turf/open/floor/white,
/area/lv624/lazarus/research)
"aU" = (
/obj/structure/fence,
/turf/open/gm/dirtgrassborder/south,
/area/lv624/ground/colony/south_medbay_road)
"aV" = (
/obj/structure/surface/table,
/obj/item/reagent_container/hypospray/autoinjector/yautja,
/obj/effect/landmark/objective_landmark/science,
/turf/open/floor/whitepurple/southeast,
/area/lv624/lazarus/research)
"aW" = (
/obj/structure/surface/table,
/obj/effect/landmark/objective_landmark/science,
/turf/open/floor/freezerfloor,
/area/lv624/lazarus/research)
"aX" = (
/turf/open/floor/freezerfloor,
/area/lv624/lazarus/research)
"aY" = (
/obj/structure/surface/rack{
	layer = 2.5
	},
/obj/item/clothing/glasses/regular,
/turf/open/floor/whitepurple/southeast,
/area/lv624/lazarus/research)
"bb" = (
/obj/structure/machinery/chem_dispenser,
/turf/open/floor/whitepurple/southeast,
/area/lv624/lazarus/research)
"bc" = (
/obj/structure/xenoautopsy/tank/broken/yautja,
/turf/open/floor/whitepurple/southeast,
/area/lv624/lazarus/research)
"bd" = (
/obj/structure/bed/chair/office/dark,
/turf/open/floor/whitepurple/southeast,
/area/lv624/lazarus/research)
"be" = (
/obj/effect/landmark/crap_item,
/obj/structure/sink{
	dir = 4;
	pixel_x = 11
	},
/turf/open/floor/freezerfloor,
/area/lv624/lazarus/research)
"bf" = (
/obj/structure/surface/table,
/obj/item/storage/fancy/vials/random,
/obj/effect/landmark/objective_landmark/science,
/turf/open/floor/whitepurple/southeast,
/area/lv624/lazarus/research)
"bg" = (
/turf/open/gm/grass/grass1,
/area/lv624/ground/jungle/central_jungle)
"bh" = (
/turf/closed/wall/strata_ice/jungle,
/area/lv624/ground/jungle/central_jungle)
"bi" = (
/obj/structure/surface/table,
/obj/item/storage/fancy/vials/random,
/turf/open/floor/whitepurple/southeast,
/area/lv624/lazarus/research)
"bj" = (
/obj/structure/surface/table,
/obj/item/clipboard,
/obj/item/paper/research_notes,
/turf/open/floor/whitepurple/southeast,
/area/lv624/lazarus/research)
"bl" = (
/obj/structure/xenoautopsy/tank/hugger/yautja,
/turf/open/floor/whitepurple/southeast,
/area/lv624/lazarus/research)
"bm" = (
/obj/structure/machinery/light{
	dir = 4
	},
/turf/open/floor/whitepurple/southeast,
/area/lv624/lazarus/research)
"bn" = (
/obj/structure/machinery/optable,
/obj/effect/decal/cleanable/blood/splatter,
/turf/open/floor/whitepurple/southeast,
/area/lv624/lazarus/research)
"bo" = (
/obj/structure/bed/chair/office/dark{
	dir = 8
	},
/turf/open/floor/whitepurple/southeast,
/area/lv624/lazarus/research)
"bp" = (
/turf/open/floor/whitepurple/southeast,
/area/lv624/lazarus/research)
"bq" = (
/obj/structure/machinery/smartfridge/chemistry,
/turf/open/floor/whitepurple/southeast,
/area/lv624/lazarus/research)
"br" = (
/obj/structure/surface/table,
/obj/item/tool/surgery/circular_saw/predatorbonesaw,
/obj/item/tool/surgery/hemostat/predatorhemostat,
/obj/item/tool/surgery/retractor/predatorretractor,
/obj/item/tool/surgery/scalpel/predatorscalpel,
/obj/effect/landmark/objective_landmark/science,
/obj/structure/machinery/light{
	dir = 1
	},
/turf/open/floor/whitepurple/southeast,
/area/lv624/lazarus/research)
"bs" = (
/obj/effect/landmark/crap_item,
/obj/structure/machinery/power/apc/no_power/south,
/turf/open/floor/whitepurple/southeast,
/area/lv624/lazarus/research)
"bt" = (
/obj/structure/surface/table,
/obj/item/paper/research_notes,
/obj/structure/machinery/light/small,
/turf/open/floor/whitepurple/southeast,
/area/lv624/lazarus/research)
"bu" = (
/obj/structure/machinery/cm_vending/sorted/tech/science,
/turf/open/floor/whitepurple/southeast,
/area/lv624/lazarus/research)
"bv" = (
/obj/structure/machinery/light{
	dir = 8
	},
/obj/effect/landmark/crap_item,
/obj/structure/transmitter/colony_net{
	phone_category = "Lazarus Landing";
	phone_id = "Research Dome";
	pixel_y = -24;
	dir = 1
	},
/turf/open/floor/whitepurple/southeast,
/area/lv624/lazarus/research)
"bw" = (
/obj/structure/surface/table,
/obj/item/explosive/grenade/spawnergrenade/smartdisc,
/obj/item/explosive/grenade/spawnergrenade/smartdisc,
/obj/item/weapon/yautja/chained/combistick,
/turf/open/floor/whitepurple/southeast,
/area/lv624/lazarus/research)
"bx" = (
/obj/item/storage/box/beakers,
/obj/structure/surface/table,
/obj/structure/sign/safety/biohazard,
/obj/effect/landmark/crap_item,
/turf/open/floor/whitepurple/southeast,
/area/lv624/lazarus/research)
"by" = (
/obj/structure/surface/table,
/obj/item/paper/research_notes,
/turf/open/floor/whitepurple/southeast,
/area/lv624/lazarus/research)
"ec" = (
/obj/effect/decal/cleanable/blood/splatter,
/obj/effect/landmark/corpsespawner/scientist,
/turf/open/floor/whitepurple/southeast,
/area/lv624/lazarus/research)
"gd" = (
/obj/effect/landmark/crap_item,
/turf/open/floor/white,
/area/lv624/lazarus/research)
"gM" = (
/obj/structure/surface/table,
/obj/structure/machinery/juicer/yautja{
	pixel_x = -11;
	pixel_y = 8
	},
/obj/item/stack/yautja_rope{
	pixel_x = 4;
	pixel_y = 7
	},
/obj/structure/machinery/light{
	dir = 1
	},
/turf/open/floor/whitepurple/southeast,
/area/lv624/lazarus/research)
"rg" = (
/obj/structure/surface/table,
/obj/effect/landmark/crap_item,
/turf/open/floor/whitepurple/southeast,
/area/lv624/lazarus/research)
"vn" = (
/obj/effect/landmark/objective_landmark/science,
/turf/open/floor/freezerfloor,
/area/lv624/lazarus/research)
"zm" = (
/obj/effect/landmark/monkey_spawn,
/turf/open/floor/white,
/area/lv624/lazarus/research)
"FO" = (
/obj/effect/landmark/crap_item,
/turf/open/floor/freezerfloor,
/area/lv624/lazarus/research)
"Lo" = (
/obj/effect/decal/cleanable/blood/splatter,
/obj/effect/decal/remains/human,
/turf/open/floor/white,
/area/lv624/lazarus/research)
"LE" = (
/obj/structure/machinery/chem_master,
/turf/open/floor/whitepurple/southeast,
/area/lv624/lazarus/research)
"Np" = (
/obj/effect/decal/cleanable/blood/splatter,
/obj/effect/landmark/corpsespawner/scientist,
/turf/open/floor/white,
/area/lv624/lazarus/research)
"Zw" = (
/obj/structure/surface/table,
/obj/item/weapon/yautja/knife,
/obj/effect/landmark/objective_landmark/science,
/turf/open/floor/whitepurple/southeast,
/area/lv624/lazarus/research)

(1,1,1) = {"
aa
aa
aa
aa
aa
ab
ao
aN
ao
ab
aa
aa
aa
ah
aa
"}
(2,1,1) = {"
aa
ab
ao
ao
ao
ab
as
ak
bf
ab
ao
ao
ao
ab
aa
"}
(3,1,1) = {"
aa
ac
FO
aX
aW
ar
gM
aO
aj
ar
br
bn
aV
ai
aa
"}
(4,1,1) = {"
aa
ac
vn
aX
aX
aG
bp
gd
bp
aG
bp
bo
bc
ai
aa
"}
(5,1,1) = {"
aa
ac
be
aX
aD
ar
aB
ak
am
ar
aY
bp
bl
ai
aa
"}
(6,1,1) = {"
ab
ab
ar
ay
ar
ar
ar
aP
ar
ar
ar
ay
ar
ab
ab
"}
(7,1,1) = {"
ac
by
bx
ec
bu
ar
gd
Lo
aJ
ar
bp
al
bf
rg
ac
"}
(8,1,1) = {"
ad
ak
zm
ak
ak
aH
ak
zm
ak
aH
ak
Lo
ak
ak
ad
"}
(9,1,1) = {"
ac
bp
bp
al
bm
ar
aT
ak
aK
ar
bp
bp
bm
al
ac
"}
(10,1,1) = {"
ab
ab
ar
ay
ar
ab
ab
aP
ab
ab
ar
bq
ar
ab
ab
"}
(11,1,1) = {"
bg
ac
Zw
bp
bv
ab
bp
ak
bs
ab
aC
bp
bi
ai
ae
"}
(12,1,1) = {"
bg
ac
at
aA
bp
aG
bp
Np
bp
aG
bp
bd
bj
ai
ae
"}
(13,1,1) = {"
bg
ac
rg
bw
aF
ab
bp
aQ
bt
ab
bb
al
LE
ac
ae
"}
(14,1,1) = {"
bg
ab
ao
ao
ao
ab
aC
ak
aE
ab
ao
ao
ao
ab
ag
"}
(15,1,1) = {"
bh
bg
bg
bg
bg
ab
aS
aS
ab
ab
av
av
av
aU
ae
"}
