//MAP CONVERTED BY dmm2tgm.py THIS HEADER COMMENT PREVENTS RECONVERSION, DO NOT REMOVE
"aa" = (
/turf/open/gm/grass/grass1,
/area/lv624/ground/jungle/north_west_jungle)
"ab" = (
/turf/closed/wall/r_wall,
/area/lv624/lazarus/research)
"ac" = (
/obj/structure/window/framed/colony/reinforced,
/obj/structure/machinery/door/poddoor/almayer/planet_side_blastdoor{
	id = "science_blast";
	layer = 3.3;
	name = "\improper Science Wing Blast Door"
	},
/turf/open/floor/plating,
/area/lv624/lazarus/research)
"ae" = (
/turf/open/gm/dirt,
/area/lv624/ground/colony/south_medbay_road)
"ag" = (
/obj/effect/decal/remains/xeno,
/turf/open/gm/dirt,
/area/lv624/ground/colony/south_medbay_road)
"ah" = (
/turf/closed/wall/strata_ice/jungle,
/area/lv624/ground/jungle/north_west_jungle)
"ai" = (
/obj/structure/window_frame/colony/reinforced,
/obj/structure/machinery/door/poddoor/almayer/planet_side_blastdoor{
	id = "science_blast";
	layer = 3.3;
	name = "\improper Science Wing Blast Door"
	},
/turf/open/floor/plating,
/area/lv624/lazarus/research)
"an" = (
/obj/structure/fence,
/turf/open/gm/dirtgrassborder/south,
/area/lv624/ground/colony/south_medbay_road)
"ao" = (
/obj/structure/window/framed/colony/reinforced,
/obj/structure/machinery/door/poddoor/almayer/planet_side_blastdoor{
	dir = 4;
	id = "science_blast";
	layer = 3.3;
	name = "\improper Science Wing Blast Door"
	},
/turf/open/floor/plating,
/area/lv624/lazarus/research)
"au" = (
/turf/closed/wall,
/area/lv624/lazarus/research)
"ax" = (
/turf/open/gm/grass/grass1,
/area/lv624/ground/colony/south_medbay_road)
"bE" = (
/turf/open/gm/grass/grass1,
/area/lv624/ground/jungle/central_jungle)
"bF" = (
/turf/closed/wall/strata_ice/jungle,
/area/lv624/ground/jungle/central_jungle)
"cv" = (
/obj/structure/machinery/door/airlock/almayer/research/colony{
	locked = 1;
	name = "\improper Research Dome"
	},
/turf/open/floor/white,
/area/lv624/lazarus/research)
"cE" = (
/obj/structure/machinery/light{
	dir = 4
	},
/turf/open/floor/whitepurple/northeast,
/area/lv624/lazarus/research)
"ek" = (
/obj/structure/surface/table,
/obj/item/tool/surgery/scalpel{
	pixel_y = 12
	},
/obj/structure/machinery/light,
/obj/effect/landmark/objective_landmark/science,
/turf/open/floor/whitepurple/northeast,
/area/lv624/lazarus/research)
"eM" = (
/obj/structure/machinery/light/small{
	dir = 1
	},
/obj/structure/surface/table,
/turf/open/floor/whitepurple/northeast,
/area/lv624/lazarus/research)
"eR" = (
/obj/effect/decal/cleanable/blood/splatter,
/turf/open/floor/white,
/area/lv624/lazarus/research)
"eZ" = (
/obj/structure/surface/table,
/obj/item/storage/fancy/vials/random,
/obj/effect/landmark/objective_landmark/science,
/turf/open/floor/whitepurple/northeast,
/area/lv624/lazarus/research)
"hi" = (
/obj/structure/sink{
	dir = 4;
	icon_state = "sink";
	pixel_x = 11
	},
/turf/open/floor/freezerfloor,
/area/lv624/lazarus/research)
"ic" = (
/obj/structure/xenoautopsy/tank/alien,
/turf/open/floor/whitepurple/northeast,
/area/lv624/lazarus/research)
"if" = (
/obj/effect/landmark/objective_landmark/science,
/turf/open/floor/freezerfloor,
/area/lv624/lazarus/research)
"iG" = (
/obj/structure/surface/table,
/obj/structure/machinery/cell_charger,
/obj/item/tool/crowbar,
/turf/open/floor/whitepurple/northeast,
/area/lv624/lazarus/research)
"lg" = (
/turf/open/floor/white,
/area/lv624/lazarus/research)
"lk" = (
/obj/structure/surface/table,
/turf/open/floor/freezerfloor,
/area/lv624/lazarus/research)
"mW" = (
/obj/structure/machinery/chem_master,
/turf/open/floor/whitepurple/northeast,
/area/lv624/lazarus/research)
"nh" = (
/obj/structure/machinery/door/poddoor/almayer/planet_side_blastdoor{
	dir = 4;
	id = "science_blast";
	layer = 3.3;
	name = "\improper Science Wing Blast Door"
	},
/obj/structure/machinery/door/airlock/almayer/research/colony{
	locked = 1;
	name = "\improper Research Dome"
	},
/turf/open/floor/white,
/area/lv624/lazarus/research)
"ok" = (
/obj/structure/machinery/cm_vending/sorted/tech/science,
/turf/open/floor/whitepurple/northeast,
/area/lv624/lazarus/research)
"pb" = (
/obj/structure/surface/table,
/obj/item/storage/fancy/vials/random,
/turf/open/floor/whitepurple/northeast,
/area/lv624/lazarus/research)
"qU" = (
/turf/open/floor/freezerfloor,
/area/lv624/lazarus/research)
"rm" = (
/obj/structure/machinery/shower{
	pixel_y = 16
	},
/obj/structure/machinery/light{
	dir = 4
	},
/turf/open/floor/freezerfloor,
/area/lv624/lazarus/research)
"sw" = (
/obj/structure/xenoautopsy/tank/hugger,
/turf/open/floor/whitepurple/northeast,
/area/lv624/lazarus/research)
"tA" = (
/obj/structure/machinery/chem_dispenser,
/turf/open/floor/whitepurple/northeast,
/area/lv624/lazarus/research)
"tL" = (
/obj/structure/machinery/door_control{
	id = "science_blast";
	name = "Science Wing Lockdown";
	pixel_x = 25
	},
/turf/open/floor/white,
/area/lv624/lazarus/research)
"uf" = (
/obj/structure/machinery/power/apc/directional/no_power/north,
/turf/open/floor/whitepurple/northeast,
/area/lv624/lazarus/research)
"ui" = (
/obj/structure/surface/table,
/obj/item/paper/research_notes,
/turf/open/floor/whitepurple/northeast,
/area/lv624/lazarus/research)
"vP" = (
/obj/structure/machinery/door/airlock/almayer/research/colony{
	locked = 1;
	name = "\improper Research Dome"
	},
/turf/open/floor/whitepurple/northeast,
/area/lv624/lazarus/research)
"vV" = (
/obj/item/clothing/glasses/regular,
/obj/effect/landmark/objective_landmark/science,
/turf/open/floor/white,
/area/lv624/lazarus/research)
"wd" = (
/obj/structure/machinery/light{
	dir = 8
	},
/obj/structure/xenoautopsy/jar_shelf,
/turf/open/floor/whitepurple/northeast,
/area/lv624/lazarus/research)
"CF" = (
/obj/structure/machinery/door/airlock/almayer/research/colony{
	dir = 1;
	locked = 1;
	name = "\improper Research Dome"
	},
/turf/open/floor/white,
/area/lv624/lazarus/research)
"Ej" = (
/obj/structure/machinery/light{
	dir = 4
	},
/turf/open/floor/white,
/area/lv624/lazarus/research)
"El" = (
/obj/structure/transmitter/colony_net{
	phone_category = "Lazarus Landing";
	phone_id = "Research Dome";
	pixel_y = 24
	},
/turf/open/floor/whitepurple/northeast,
/area/lv624/lazarus/research)
"EN" = (
/obj/structure/bed/chair/office/dark,
/turf/open/floor/whitepurple/northeast,
/area/lv624/lazarus/research)
"ES" = (
/obj/structure/bed/chair/office/dark{
	dir = 8
	},
/turf/open/floor/whitepurple/northeast,
/area/lv624/lazarus/research)
"FG" = (
/obj/effect/landmark/corpsespawner/scientist,
/obj/effect/decal/cleanable/blood/splatter,
/turf/open/floor/white,
/area/lv624/lazarus/research)
"JH" = (
/obj/item/storage/box/beakers,
/obj/structure/surface/table,
/obj/structure/sign/safety/biohazard,
/turf/open/floor/whitepurple/northeast,
/area/lv624/lazarus/research)
"LZ" = (
/obj/structure/machinery/light{
	dir = 8
	},
/obj/structure/surface/table,
/obj/item/storage/box/disks{
	layer = 2.9;
	pixel_x = 5;
	pixel_y = 5
	},
/obj/item/storage/fancy/vials/random,
/obj/effect/landmark/objective_landmark/science,
/turf/open/floor/white,
/area/lv624/lazarus/research)
"Mh" = (
/obj/structure/machinery/door/poddoor/almayer/planet_side_blastdoor{
	id = "science_blast";
	layer = 3.3;
	name = "\improper Science Wing Blast Door"
	},
/obj/structure/machinery/door/airlock/almayer/research/colony{
	dir = 1;
	locked = 1;
	name = "\improper Research Dome"
	},
/turf/open/floor/white,
/area/lv624/lazarus/research)
"MN" = (
/obj/structure/surface/table,
/obj/item/clipboard,
/obj/item/paper/research_notes,
/turf/open/floor/whitepurple/northeast,
/area/lv624/lazarus/research)
"Ng" = (
/obj/structure/surface/table,
/turf/open/floor/whitepurple/northeast,
/area/lv624/lazarus/research)
"NV" = (
/obj/structure/machinery/optable,
/turf/open/floor/whitepurple/northeast,
/area/lv624/lazarus/research)
"NY" = (
/obj/structure/machinery/door/airlock/almayer/research/colony{
	dir = 1;
	locked = 1;
	name = "\improper Research Dome"
	},
/turf/open/floor/whitepurple/northeast,
/area/lv624/lazarus/research)
"Oh" = (
/obj/structure/machinery/smartfridge/chemistry,
/turf/open/floor/whitepurple/northeast,
/area/lv624/lazarus/research)
"OL" = (
/turf/open/floor/whitepurple/northeast,
/area/lv624/lazarus/research)
"Pb" = (
/obj/structure/machinery/door/poddoor/almayer/planet_side_blastdoor{
	dir = 4;
	id = "science_blast";
	layer = 3.3;
	name = "\improper Science Wing Blast Door"
	},
/turf/open/floor/whitepurple/northeast,
/area/lv624/lazarus/research)
"Qk" = (
/obj/structure/machinery/light,
/obj/effect/decal/cleanable/blood/splatter,
/turf/open/floor/whitepurple/northeast,
/area/lv624/lazarus/research)
"Uk" = (
/obj/structure/machinery/light,
/turf/open/floor/whitepurple/northeast,
/area/lv624/lazarus/research)
"Uu" = (
/obj/structure/bed/chair/office/dark{
	dir = 1
	},
/turf/open/floor/whitepurple/northeast,
/area/lv624/lazarus/research)
"UB" = (
/obj/structure/bed/chair/office/dark{
	dir = 1
	},
/turf/open/floor/white,
/area/lv624/lazarus/research)
"VS" = (
/obj/structure/surface/table,
/obj/effect/landmark/objective_landmark/science,
/turf/open/floor/whitepurple/northeast,
/area/lv624/lazarus/research)
"Zv" = (
/obj/structure/surface/table,
/obj/item/paper/research_notes,
/obj/effect/landmark/objective_landmark/science,
/turf/open/floor/whitepurple/northeast,
/area/lv624/lazarus/research)
"ZT" = (
/obj/structure/surface/rack{
	layer = 2.5
	},
/obj/item/clothing/glasses/regular,
/turf/open/floor/whitepurple/northeast,
/area/lv624/lazarus/research)

(1,1,1) = {"
aa
ah
aa
aa
aa
ab
ao
nh
ao
ab
aa
aa
aa
aa
aa
"}
(2,1,1) = {"
aa
ab
ao
ao
ao
ab
eZ
FG
OL
ab
ao
ao
ao
ab
aa
"}
(3,1,1) = {"
aa
ai
VS
NV
ek
au
ui
UB
Uk
au
lk
qU
qU
ac
aa
"}
(4,1,1) = {"
aa
ai
ic
ES
OL
NY
OL
lg
OL
NY
qU
qU
if
ac
aa
"}
(5,1,1) = {"
aa
ai
sw
OL
ZT
au
El
lg
OL
au
rm
qU
hi
ac
aa
"}
(6,1,1) = {"
ab
ab
au
vP
au
au
au
cv
au
au
au
vP
au
ab
ab
"}
(7,1,1) = {"
ac
ui
VS
OL
OL
au
LZ
eR
lg
au
ok
OL
JH
ui
ac
"}
(8,1,1) = {"
Mh
lg
lg
FG
lg
CF
lg
lg
eR
CF
lg
FG
lg
lg
Mh
"}
(9,1,1) = {"
ac
OL
cE
OL
OL
au
tL
lg
Ej
au
cE
OL
OL
OL
ac
"}
(10,1,1) = {"
ab
ab
au
Oh
au
ab
ab
cv
ab
ab
au
vP
au
ab
ab
"}
(11,1,1) = {"
ae
ai
eZ
OL
Uk
ab
uf
lg
OL
ab
wd
OL
VS
ac
bE
"}
(12,1,1) = {"
ae
ai
MN
Uu
OL
NY
OL
eR
OL
NY
OL
EN
pb
ac
bE
"}
(13,1,1) = {"
ae
ac
mW
OL
tA
ab
eM
vV
OL
ab
Zv
ui
Ng
ac
bE
"}
(14,1,1) = {"
ag
ab
ao
ao
ao
ab
iG
lg
Qk
ab
ao
ao
ao
ab
bE
"}
(15,1,1) = {"
ae
an
ax
ax
ax
ab
ab
Pb
Pb
ab
bE
bE
bE
bE
bF
"}
