//MAP CONVERTED BY dmm2tgm.py THIS HEADER COMMENT PREVENTS RECONVERSION, DO NOT REMOVE
"aa" = (
/turf/open/gm/grass/grass1,
/area/lv624/ground/jungle/north_west_jungle)
"ab" = (
/turf/closed/wall/r_wall,
/area/lv624/lazarus/research)
"ac" = (
/obj/structure/window/framed/colony/reinforced,
/obj/structure/machinery/door/poddoor/almayer/planet_side_blastdoor{
	id = "science_blast";
	layer = 3.3;
	name = "\improper Science Wing Blast Door"
	},
/turf/open/floor/plating,
/area/lv624/lazarus/research)
"ad" = (
/obj/structure/machinery/door/poddoor/almayer/planet_side_blastdoor{
	id = "science_blast";
	layer = 3.3;
	name = "\improper Science Wing Blast Door"
	},
/obj/structure/machinery/door/airlock/almayer/research/colony{
	dir = 1;
	locked = 1;
	name = "\improper Research Dome"
	},
/turf/open/floor/white,
/area/lv624/lazarus/research)
"ae" = (
/turf/open/gm/dirt,
/area/lv624/ground/colony/south_medbay_road)
"af" = (
/obj/structure/fence,
/turf/open/gm/dirtgrassborder/south,
/area/lv624/ground/colony/south_medbay_road)
"ag" = (
/obj/effect/decal/remains/xeno,
/turf/open/gm/dirt,
/area/lv624/ground/colony/south_medbay_road)
"ah" = (
/turf/closed/wall/strata_ice/jungle,
/area/lv624/ground/jungle/north_west_jungle)
"ai" = (
/obj/structure/window_frame/colony/reinforced,
/obj/structure/machinery/door/poddoor/almayer/planet_side_blastdoor{
	id = "science_blast";
	layer = 3.3;
	name = "\improper Science Wing Blast Door"
	},
/turf/open/floor/plating,
/area/lv624/lazarus/research)
"aj" = (
/obj/structure/machinery/chem_master,
/turf/open/floor/whitepurple/southeast,
/area/lv624/lazarus/research)
"ak" = (
/turf/open/floor/white,
/area/lv624/lazarus/research)
"am" = (
/obj/structure/surface/table,
/obj/effect/landmark/objective_landmark/science,
/turf/open/floor/whitepurple/southeast,
/area/lv624/lazarus/research)
"ao" = (
/obj/structure/window/framed/colony/reinforced,
/obj/structure/machinery/door/poddoor/almayer/planet_side_blastdoor{
	dir = 4;
	id = "science_blast";
	layer = 3.3;
	name = "\improper Science Wing Blast Door"
	},
/turf/open/floor/plating,
/area/lv624/lazarus/research)
"aq" = (
/obj/structure/surface/table,
/obj/item/storage/fancy/vials/random,
/obj/effect/landmark/objective_landmark/science,
/turf/open/floor/whitepurple/southeast,
/area/lv624/lazarus/research)
"ar" = (
/obj/structure/surface/table,
/turf/open/floor/whitepurple/southeast,
/area/lv624/lazarus/research)
"au" = (
/turf/closed/wall,
/area/lv624/lazarus/research)
"av" = (
/obj/structure/surface/table,
/obj/item/storage/fancy/vials/random,
/turf/open/floor/whitepurple/southeast,
/area/lv624/lazarus/research)
"ax" = (
/turf/open/gm/grass/grass1,
/area/lv624/ground/colony/south_medbay_road)
"ay" = (
/turf/open/floor/whitepurple/southeast,
/area/lv624/lazarus/research)
"az" = (
/obj/structure/machinery/door/airlock/almayer/research/colony{
	dir = 1;
	locked = 1;
	name = "\improper Research Dome"
	},
/turf/open/floor/white,
/area/lv624/lazarus/research)
"aA" = (
/obj/structure/machinery/door_control{
	id = "science_blast";
	name = "Science Wing Lockdown";
	pixel_x = 25
	},
/turf/open/floor/white,
/area/lv624/lazarus/research)
"aB" = (
/obj/structure/machinery/door/airlock/almayer/research/colony{
	locked = 1;
	name = "\improper Research Dome"
	},
/turf/open/floor/whitepurple/southeast,
/area/lv624/lazarus/research)
"aC" = (
/obj/structure/machinery/door/airlock/almayer/research/colony{
	locked = 1;
	name = "\improper Research Dome"
	},
/turf/open/floor/white,
/area/lv624/lazarus/research)
"aD" = (
/obj/structure/bed/chair/office/dark{
	dir = 1
	},
/turf/open/floor/whitepurple/southeast,
/area/lv624/lazarus/research)
"aE" = (
/obj/structure/xenoautopsy/tank/alien,
/turf/open/floor/whitepurple/southeast,
/area/lv624/lazarus/research)
"aG" = (
/obj/structure/machinery/shower{
	dir = 1
	},
/obj/structure/machinery/light{
	dir = 4
	},
/turf/open/floor/freezerfloor,
/area/lv624/lazarus/research)
"aH" = (
/obj/structure/xenoautopsy/tank/hugger,
/turf/open/floor/whitepurple/southeast,
/area/lv624/lazarus/research)
"aI" = (
/obj/structure/machinery/door/poddoor/almayer/planet_side_blastdoor{
	dir = 4;
	id = "science_blast";
	layer = 3.3;
	name = "\improper Science Wing Blast Door"
	},
/turf/open/floor/whitepurple/southeast,
/area/lv624/lazarus/research)
"aJ" = (
/obj/structure/machinery/light{
	dir = 8
	},
/obj/structure/xenoautopsy/jar_shelf,
/turf/open/floor/whitepurple/southeast,
/area/lv624/lazarus/research)
"aK" = (
/obj/structure/surface/table,
/obj/item/paper/research_notes,
/obj/effect/landmark/objective_landmark/science,
/turf/open/floor/whitepurple/southeast,
/area/lv624/lazarus/research)
"aL" = (
/obj/structure/machinery/door/airlock/almayer/research/colony{
	dir = 1;
	locked = 1;
	name = "\improper Research Dome"
	},
/turf/open/floor/whitepurple/southeast,
/area/lv624/lazarus/research)
"aM" = (
/obj/structure/machinery/light{
	dir = 4
	},
/turf/open/floor/white,
/area/lv624/lazarus/research)
"aN" = (
/obj/structure/machinery/light{
	dir = 4
	},
/turf/open/floor/whitepurple/southeast,
/area/lv624/lazarus/research)
"aO" = (
/obj/structure/surface/rack{
	layer = 2.5
	},
/obj/item/clothing/glasses/regular,
/turf/open/floor/whitepurple/southeast,
/area/lv624/lazarus/research)
"aP" = (
/obj/structure/machinery/light{
	dir = 1
	},
/turf/open/floor/whitepurple/southeast,
/area/lv624/lazarus/research)
"aQ" = (
/obj/structure/machinery/light{
	dir = 8
	},
/obj/structure/surface/table,
/obj/item/storage/box/disks{
	layer = 2.9;
	pixel_x = 5;
	pixel_y = 5
	},
/obj/item/storage/fancy/vials/random,
/obj/effect/landmark/objective_landmark/science,
/turf/open/floor/white,
/area/lv624/lazarus/research)
"aR" = (
/obj/structure/sink{
	dir = 4;
	pixel_x = 11
	},
/turf/open/floor/freezerfloor,
/area/lv624/lazarus/research)
"aT" = (
/obj/effect/decal/cleanable/blood/splatter,
/obj/structure/machinery/light{
	dir = 1
	},
/turf/open/floor/whitepurple/southeast,
/area/lv624/lazarus/research)
"aU" = (
/obj/structure/machinery/door/poddoor/almayer/planet_side_blastdoor{
	dir = 4;
	id = "science_blast";
	layer = 3.3;
	name = "\improper Science Wing Blast Door"
	},
/obj/structure/machinery/door/airlock/almayer/research/colony{
	locked = 1;
	name = "\improper Research Dome"
	},
/turf/open/floor/white,
/area/lv624/lazarus/research)
"aV" = (
/obj/structure/bed/chair/office/dark,
/turf/open/floor/white,
/area/lv624/lazarus/research)
"aW" = (
/obj/structure/machinery/optable,
/turf/open/floor/whitepurple/southeast,
/area/lv624/lazarus/research)
"aX" = (
/obj/structure/bed/chair/office/dark{
	dir = 8
	},
/turf/open/floor/whitepurple/southeast,
/area/lv624/lazarus/research)
"aY" = (
/obj/structure/machinery/smartfridge/chemistry,
/turf/open/floor/whitepurple/southeast,
/area/lv624/lazarus/research)
"aZ" = (
/obj/structure/surface/table,
/obj/item/tool/surgery/scalpel{
	pixel_y = 12
	},
/obj/effect/landmark/objective_landmark/science,
/obj/structure/machinery/light{
	dir = 1
	},
/turf/open/floor/whitepurple/southeast,
/area/lv624/lazarus/research)
"ba" = (
/obj/structure/transmitter/colony_net{
	phone_category = "Lazarus Landing";
	phone_id = "Research Dome";
	pixel_y = 24
	},
/turf/open/floor/whitepurple/southeast,
/area/lv624/lazarus/research)
"bb" = (
/obj/item/clothing/glasses/regular,
/obj/effect/landmark/objective_landmark/science,
/turf/open/floor/white,
/area/lv624/lazarus/research)
"bc" = (
/obj/structure/machinery/power/apc/no_power/south,
/turf/open/floor/whitepurple/southeast,
/area/lv624/lazarus/research)
"bd" = (
/obj/structure/surface/table,
/obj/structure/machinery/light/small,
/turf/open/floor/whitepurple/southeast,
/area/lv624/lazarus/research)
"be" = (
/obj/structure/machinery/cm_vending/sorted/tech/science,
/turf/open/floor/whitepurple/southeast,
/area/lv624/lazarus/research)
"bf" = (
/obj/item/storage/box/beakers,
/obj/structure/surface/table,
/obj/structure/sign/safety/biohazard,
/turf/open/floor/whitepurple/southeast,
/area/lv624/lazarus/research)
"bm" = (
/obj/structure/surface/table,
/turf/open/floor/freezerfloor,
/area/lv624/lazarus/research)
"bn" = (
/obj/structure/machinery/chem_dispenser,
/turf/open/floor/whitepurple/southeast,
/area/lv624/lazarus/research)
"bx" = (
/obj/structure/bed/chair/office/dark,
/turf/open/floor/whitepurple/southeast,
/area/lv624/lazarus/research)
"bE" = (
/turf/open/gm/grass/grass1,
/area/lv624/ground/jungle/central_jungle)
"bF" = (
/turf/closed/wall/strata_ice/jungle,
/area/lv624/ground/jungle/central_jungle)
"ky" = (
/obj/effect/landmark/objective_landmark/science,
/turf/open/floor/freezerfloor,
/area/lv624/lazarus/research)
"qs" = (
/obj/structure/surface/table,
/obj/item/clipboard,
/obj/item/paper/research_notes,
/turf/open/floor/whitepurple/southeast,
/area/lv624/lazarus/research)
"wY" = (
/turf/open/floor/freezerfloor,
/area/lv624/lazarus/research)
"DC" = (
/obj/structure/surface/table,
/obj/structure/machinery/cell_charger,
/obj/item/tool/crowbar,
/turf/open/floor/whitepurple/southeast,
/area/lv624/lazarus/research)
"Jv" = (
/obj/effect/landmark/corpsespawner/scientist,
/obj/effect/decal/cleanable/blood/splatter,
/turf/open/floor/white,
/area/lv624/lazarus/research)
"Kl" = (
/obj/effect/decal/cleanable/blood/splatter,
/turf/open/floor/white,
/area/lv624/lazarus/research)
"Tz" = (
/obj/structure/surface/table,
/obj/item/paper/research_notes,
/turf/open/floor/whitepurple/southeast,
/area/lv624/lazarus/research)

(1,1,1) = {"
aa
aa
aa
aa
aa
ab
ao
aU
ao
ab
aa
aa
aa
ah
aa
"}
(2,1,1) = {"
aa
ab
ao
ao
ao
ab
ay
Jv
aq
ab
ao
ao
ao
ab
aa
"}
(3,1,1) = {"
aa
ac
wY
wY
bm
au
aP
aV
Tz
au
aZ
aW
am
ai
aa
"}
(4,1,1) = {"
aa
ac
ky
wY
wY
aL
ay
ak
ay
aL
ay
aX
aE
ai
aa
"}
(5,1,1) = {"
aa
ac
aR
wY
aG
au
ay
ak
ba
au
aO
ay
aH
ai
aa
"}
(6,1,1) = {"
ab
ab
au
aB
au
au
au
aC
au
au
au
aB
au
ab
ab
"}
(7,1,1) = {"
ac
Tz
bf
ay
be
au
ak
Kl
aQ
au
ay
ay
am
Tz
ac
"}
(8,1,1) = {"
ad
ak
ak
Jv
ak
az
Kl
ak
ak
az
ak
Jv
ak
ak
ad
"}
(9,1,1) = {"
ac
ay
ay
ay
aN
au
aM
ak
aA
au
ay
ay
aN
ay
ac
"}
(10,1,1) = {"
ab
ab
au
aB
au
ab
ab
aC
ab
ab
au
aY
au
ab
ab
"}
(11,1,1) = {"
bE
ac
am
ay
aJ
ab
ay
ak
bc
ab
aP
ay
aq
ai
ae
"}
(12,1,1) = {"
bE
ac
av
aD
ay
aL
ay
Kl
ay
aL
ay
bx
qs
ai
ae
"}
(13,1,1) = {"
bE
ac
ar
Tz
aK
ab
ay
bb
bd
ab
bn
ay
aj
ac
ae
"}
(14,1,1) = {"
bE
ab
ao
ao
ao
ab
aT
ak
DC
ab
ao
ao
ao
ab
ag
"}
(15,1,1) = {"
bF
bE
bE
bE
bE
ab
aI
aI
ab
ab
ax
ax
ax
af
ae
"}
