//MAP CONVERTED BY dmm2tgm.py THIS HEADER COMMENT PREVENTS RECONVERSION, DO NOT REMOVE
"a" = (
/obj/structure/platform{
	dir = 4
	},
/obj/effect/blocker/toxic_water/Group_2,
/turf/open/desert/desert_shore/desert_shore1{
	icon_state = "shore1";
	dir = 1
	},
/area/desert_dam/exterior/river/riverside_east)
"b" = (
/turf/open/asphalt{
	icon_state = "tile"
	},
/area/desert_dam/exterior/river/riverside_east)
"c" = (
/obj/structure/desertdam/decals/road_edge,
/turf/open/asphalt,
/area/desert_dam/exterior/river/riverside_east)
"d" = (
/turf/open/asphalt,
/area/desert_dam/exterior/river/riverside_east)
"e" = (
/obj/structure/desertdam/decals/road_edge{
	icon_state = "road_edge_decal2"
	},
/turf/open/asphalt,
/area/desert_dam/exterior/river/riverside_east)
"f" = (
/obj/structure/disposalpipe/segment,
/turf/open/asphalt{
	icon_state = "tile"
	},
/area/desert_dam/exterior/river/riverside_east)
"g" = (
/obj/structure/platform{
	dir = 8
	},
/obj/effect/blocker/toxic_water/Group_2,
/turf/open/gm/river/desert/shallow,
/area/desert_dam/exterior/river/riverside_east)
"h" = (
/obj/structure/platform{
	dir = 4
	},
/obj/effect/blocker/toxic_water/Group_2,
/turf/open/gm/river/desert/shallow_edge{
	icon_state = "shallow_edge";
	dir = 1
	},
/area/desert_dam/exterior/river/riverside_east)
"i" = (
/obj/effect/blocker/toxic_water/Group_2,
/turf/open/asphalt{
	icon_state = "tile"
	},
/area/desert_dam/exterior/river/riverside_east)
"j" = (
/obj/effect/blocker/toxic_water/Group_2,
/turf/open/gm/river/desert/shallow_edge/covered{
	dir = 1
	},
/area/desert_dam/exterior/river/riverside_east)
"k" = (
/obj/structure/disposalpipe/segment,
/obj/effect/blocker/toxic_water/Group_2,
/turf/open/asphalt{
	icon_state = "tile"
	},
/area/desert_dam/exterior/river/riverside_east)
"l" = (
/obj/structure/platform{
	dir = 8
	},
/obj/effect/blocker/toxic_water/Group_2,
/turf/open/gm/river/desert/shallow_edge{
	icon_state = "shallow_edge";
	dir = 1
	},
/area/desert_dam/exterior/river/riverside_east)
"m" = (
/obj/effect/blocker/toxic_water/Group_2,
/obj/structure/platform{
	dir = 4
	},
/turf/open/gm/river/desert/deep,
/area/desert_dam/exterior/river/riverside_east)
"n" = (
/obj/effect/blocker/toxic_water/Group_2,
/turf/open/gm/river/desert/deep/covered,
/area/desert_dam/exterior/river/riverside_east)
"o" = (
/obj/effect/blocker/toxic_water/Group_2,
/obj/structure/disposalpipe/segment,
/turf/open/asphalt{
	icon_state = "tile"
	},
/area/desert_dam/exterior/river/riverside_east)
"p" = (
/obj/effect/blocker/toxic_water/Group_2,
/obj/structure/platform{
	dir = 8
	},
/turf/open/gm/river/desert/deep,
/area/desert_dam/exterior/river/riverside_east)
"q" = (
/obj/structure/platform{
	dir = 4
	},
/obj/effect/blocker/toxic_water/Group_2,
/turf/open/gm/river/desert/shallow_edge,
/area/desert_dam/exterior/river/riverside_east)
"r" = (
/obj/effect/blocker/toxic_water/Group_2,
/turf/open/gm/river/desert/shallow_edge/covered,
/area/desert_dam/exterior/river/riverside_east)
"s" = (
/obj/structure/platform{
	dir = 8
	},
/obj/effect/blocker/toxic_water/Group_2,
/turf/open/gm/river/desert/shallow_edge,
/area/desert_dam/exterior/river/riverside_east)
"t" = (
/obj/structure/platform{
	dir = 4
	},
/obj/effect/blocker/toxic_water/Group_2,
/turf/open/desert/desert_shore/desert_shore1,
/area/desert_dam/exterior/river/riverside_east)
"u" = (
/obj/effect/blocker/toxic_water/Group_2,
/obj/structure/desertdam/decals/road_edge,
/turf/open/asphalt,
/area/desert_dam/exterior/river/riverside_east)
"v" = (
/obj/effect/blocker/toxic_water/Group_2,
/turf/open/asphalt,
/area/desert_dam/exterior/river/riverside_east)
"w" = (
/obj/effect/blocker/toxic_water/Group_2,
/obj/structure/desertdam/decals/road_edge{
	icon_state = "road_edge_decal2"
	},
/turf/open/asphalt,
/area/desert_dam/exterior/river/riverside_east)
"x" = (
/obj/structure/platform{
	dir = 8
	},
/obj/effect/blocker/toxic_water/Group_2,
/turf/open/desert/desert_shore/desert_shore1,
/area/desert_dam/exterior/river/riverside_east)

(1,1,1) = {"
a
h
m
m
m
q
t
"}
(2,1,1) = {"
b
i
i
i
i
i
i
"}
(3,1,1) = {"
c
j
n
n
n
r
u
"}
(4,1,1) = {"
d
j
n
n
n
r
v
"}
(5,1,1) = {"
d
j
n
n
n
r
v
"}
(6,1,1) = {"
e
j
n
n
n
r
w
"}
(7,1,1) = {"
f
k
o
o
o
k
k
"}
(8,1,1) = {"
g
l
p
p
p
s
x
"}
