//MAP CONVERTED BY dmm2tgm.py THIS HEADER COMMENT PREVENTS RECONVERSION, DO NOT REMOVE
"bm" = (
/obj/structure/machinery/light/double{
	dir = 4;
	pixel_y = -5
	},
/obj/effect/decal/cleanable/dirt,
/turf/open/shuttle/dropship{
	icon_state = "rasputin3"
	},
/area/desert_dam/exterior/valley/valley_civilian)
"bz" = (
/turf/closed/shuttle/ert{
	icon_state = "T7";
	name = "Buran"
	},
/area/desert_dam/exterior/valley/valley_civilian)
"cn" = (
/turf/closed/shuttle/ert{
	icon_state = "T5";
	name = "Fulcrum"
	},
/area/desert_dam/exterior/valley/valley_civilian)
"cp" = (
/obj/effect/decal/cleanable/dirt,
/turf/open/asphalt/cement_sunbleached{
	icon_state = "cement_sunbleached12"
	},
/area/desert_dam/exterior/valley/valley_civilian)
"dv" = (
/obj/effect/landmark/monkey_spawn,
/turf/open/auto_turf/snow/layer2,
/area/desert_dam/exterior/valley/valley_civilian)
"dz" = (
/obj/structure/desertdam/decals/road_stop{
	icon_state = "stop_decal5"
	},
/turf/open/asphalt,
/area/desert_dam/exterior/valley/valley_civilian)
"dN" = (
/obj/effect/decal/cleanable/blood/oil,
/turf/open/auto_turf/snow/layer0,
/area/desert_dam/exterior/valley/valley_civilian)
"dP" = (
/turf/open/asphalt/cement_sunbleached{
	icon_state = "cement_sunbleached18"
	},
/area/desert_dam/exterior/valley/valley_civilian)
"eb" = (
/obj/effect/spawner/gibspawner/human,
/turf/open/auto_turf/snow/layer2,
/area/desert_dam/exterior/valley/valley_civilian)
"eC" = (
/turf/closed/shuttle/ert{
	icon_state = "T17";
	name = "Buran"
	},
/area/desert_dam/exterior/valley/valley_civilian)
"fa" = (
/turf/closed/shuttle/ert{
	icon_state = "T9";
	name = "Buran"
	},
/area/desert_dam/exterior/valley/valley_civilian)
"fg" = (
/obj/effect/decal/cleanable/blood,
/obj/effect/decal/cleanable/dirt,
/turf/open/shuttle/dropship{
	icon_state = "rasputin3"
	},
/area/desert_dam/exterior/valley/valley_civilian)
"ft" = (
/turf/closed/wall,
/area/desert_dam/exterior/valley/valley_civilian)
"fA" = (
/turf/closed/shuttle/ert{
	icon_state = "leftengine_2";
	name = "Buran";
	opacity = 0
	},
/area/desert_dam/exterior/valley/valley_civilian)
"gb" = (
/obj/structure/desertdam/decals/road_edge,
/turf/open/asphalt,
/area/desert_dam/exterior/valley/valley_civilian)
"hK" = (
/obj/structure/prop/invuln/fire{
	pixel_x = -7;
	pixel_y = 17
	},
/turf/closed/shuttle/ert{
	icon_state = "upp4";
	name = "Buran"
	},
/area/desert_dam/exterior/valley/valley_civilian)
"ig" = (
/obj/effect/decal/cleanable/blood/splatter,
/turf/open/floor/plating,
/area/desert_dam/exterior/valley/valley_civilian)
"ih" = (
/obj/effect/decal/cleanable/dirt,
/turf/closed/shuttle/ert{
	icon_state = "upp21";
	name = "Buran"
	},
/area/desert_dam/exterior/valley/valley_civilian)
"jN" = (
/turf/open/asphalt/cement_sunbleached{
	icon_state = "cement_sunbleached19"
	},
/area/desert_dam/exterior/valley/valley_civilian)
"jU" = (
/obj/effect/decal/cleanable/blood/splatter,
/obj/effect/decal/cleanable/dirt,
/turf/open/shuttle/dropship{
	icon_state = "rasputin3"
	},
/area/desert_dam/exterior/valley/valley_civilian)
"kd" = (
/turf/closed/shuttle/ert{
	icon_state = "leftengine_1";
	name = "Buran";
	opacity = 0
	},
/area/desert_dam/exterior/valley/valley_civilian)
"la" = (
/turf/closed/wall/shiva/ice,
/area/desert_dam/exterior/rock)
"ly" = (
/obj/effect/decal/cleanable/dirt,
/turf/open/floor/plating,
/area/desert_dam/exterior/valley/valley_civilian)
"mk" = (
/obj/structure/closet/crate/ammo,
/obj/item/explosive/grenade/high_explosive/upp,
/obj/item/explosive/grenade/high_explosive/upp,
/obj/item/explosive/grenade/high_explosive/upp,
/obj/item/explosive/grenade/high_explosive/upp,
/obj/item/explosive/grenade/high_explosive/upp,
/obj/item/explosive/grenade/high_explosive/upp,
/turf/open/shuttle/dropship{
	icon_state = "rasputin15"
	},
/area/desert_dam/exterior/valley/valley_civilian)
"mt" = (
/obj/structure/machinery/light/double{
	dir = 8
	},
/obj/effect/decal/cleanable/dirt,
/turf/open/shuttle/dropship{
	icon_state = "rasputin3"
	},
/area/desert_dam/exterior/valley/valley_civilian)
"nA" = (
/turf/closed/shuttle/ert{
	icon_state = "upp4";
	name = "Buran"
	},
/area/desert_dam/exterior/valley/valley_civilian)
"oj" = (
/obj/effect/decal/cleanable/blood/splatter,
/obj/effect/decal/cleanable/dirt,
/turf/open/shuttle/dropship{
	icon_state = "rasputin4"
	},
/area/desert_dam/exterior/valley/valley_civilian)
"os" = (
/obj/effect/decal/cleanable/blood/splatter,
/turf/open/shuttle/dropship{
	icon_state = "rasputin5"
	},
/area/desert_dam/exterior/valley/valley_civilian)
"oL" = (
/obj/effect/decal/cleanable/blood,
/turf/open/shuttle/dropship{
	icon_state = "rasputin3"
	},
/area/desert_dam/exterior/valley/valley_civilian)
"oX" = (
/obj/structure/desertdam/decals/road_edge{
	icon_state = "road_edge_decal9"
	},
/turf/open/asphalt,
/area/desert_dam/exterior/valley/valley_civilian)
"pF" = (
/turf/closed/shuttle/ert{
	icon_state = "T14";
	name = "Buran"
	},
/area/desert_dam/exterior/valley/valley_civilian)
"qD" = (
/obj/effect/decal/cleanable/dirt,
/turf/open/asphalt/cement_sunbleached,
/area/desert_dam/exterior/valley/valley_civilian)
"qM" = (
/obj/structure/closet/crate/ammo,
/obj/item/ammo_magazine/rifle/type71/ap,
/obj/item/ammo_magazine/rifle/type71/ap,
/obj/item/ammo_magazine/rifle/type71/ap,
/obj/item/ammo_magazine/rifle/type71/ap,
/obj/item/ammo_magazine/rifle/type71/ap,
/obj/item/ammo_magazine/rifle/type71/ap,
/turf/open/shuttle/dropship{
	icon_state = "rasputin15"
	},
/area/desert_dam/exterior/valley/valley_civilian)
"uK" = (
/obj/structure/desertdam/decals/road_edge{
	icon_state = "road_edge_decal4"
	},
/turf/open/asphalt,
/area/desert_dam/exterior/valley/valley_civilian)
"vz" = (
/obj/structure/closet/crate/ammo,
/obj/item/ammo_magazine/rifle/type71,
/obj/item/ammo_magazine/rifle/type71,
/obj/item/ammo_magazine/rifle/type71,
/obj/item/ammo_magazine/rifle/type71,
/obj/item/ammo_magazine/rifle/type71,
/obj/item/ammo_magazine/rifle/type71,
/obj/item/ammo_magazine/rifle/type71,
/obj/item/ammo_magazine/rifle/type71,
/obj/item/ammo_magazine/rifle/type71,
/obj/item/ammo_magazine/rifle/type71,
/obj/item/weapon/gun/rifle/type71,
/obj/item/weapon/gun/rifle/type71,
/turf/open/shuttle/dropship{
	icon_state = "rasputin15"
	},
/area/desert_dam/exterior/valley/valley_civilian)
"vJ" = (
/obj/structure/prop/invuln/fire,
/turf/closed/shuttle/ert{
	icon_state = "T3";
	name = "Buran";
	opacity = 0
	},
/area/desert_dam/exterior/valley/valley_civilian)
"xp" = (
/obj/structure/desertdam/decals/road_edge{
	icon_state = "road_edge_decal10"
	},
/turf/open/asphalt,
/area/desert_dam/exterior/valley/valley_civilian)
"xz" = (
/obj/structure/girder/displaced,
/turf/open/floor/plating,
/area/desert_dam/exterior/valley/valley_civilian)
"xE" = (
/turf/open/shuttle/dropship{
	icon_state = "rasputin7"
	},
/area/desert_dam/exterior/valley/valley_civilian)
"xK" = (
/obj/effect/decal/cleanable/dirt,
/obj/effect/decal/cleanable/blood{
	layer = 3
	},
/obj/structure/girder,
/turf/open/floor/plating,
/area/desert_dam/exterior/valley/valley_civilian)
"xP" = (
/obj/effect/decal/cleanable/dirt,
/turf/open/shuttle/dropship{
	icon_state = "rasputin5"
	},
/area/desert_dam/exterior/valley/valley_civilian)
"yl" = (
/turf/closed/shuttle/ert{
	icon_state = "T19";
	name = "Buran"
	},
/area/desert_dam/exterior/valley/valley_civilian)
"yU" = (
/obj/structure/prop/invuln/fire{
	pixel_x = -3;
	pixel_y = 6
	},
/turf/closed/shuttle/ert{
	icon_state = "upp20";
	name = "Buran"
	},
/area/desert_dam/exterior/valley/valley_civilian)
"zs" = (
/turf/open/asphalt/cement_sunbleached{
	icon_state = "cement_sunbleached12"
	},
/area/desert_dam/exterior/valley/valley_civilian)
"Bk" = (
/turf/closed/shuttle/ert{
	icon_state = "T4";
	name = "Buran"
	},
/area/desert_dam/exterior/valley/valley_civilian)
"BE" = (
/turf/open/asphalt/cement_sunbleached,
/area/desert_dam/exterior/valley/valley_civilian)
"CL" = (
/obj/structure/bed/chair/dropship/passenger,
/turf/open/shuttle/dropship{
	icon_state = "rasputin15"
	},
/area/desert_dam/exterior/valley/valley_civilian)
"Dd" = (
/obj/structure/prop/invuln/fire{
	pixel_x = -7;
	pixel_y = 17
	},
/turf/closed/shuttle/ert{
	icon_state = "rightengine_2";
	name = "Buran";
	opacity = 0
	},
/area/desert_dam/exterior/valley/valley_civilian)
"Gt" = (
/turf/closed/shuttle/ert{
	icon_state = "T4";
	name = "Buran";
	opacity = 0
	},
/area/desert_dam/exterior/valley/valley_civilian)
"Hm" = (
/turf/closed/shuttle/ert{
	icon_state = "T1";
	name = "Buran";
	opacity = 0
	},
/area/desert_dam/exterior/valley/valley_civilian)
"Hs" = (
/obj/structure/prop/invuln/fire{
	pixel_x = -8;
	pixel_y = 10
	},
/turf/closed/shuttle/ert{
	icon_state = "rightengine_1";
	name = "Buran";
	opacity = 0
	},
/area/desert_dam/exterior/valley/valley_civilian)
"IS" = (
/turf/closed/shuttle/ert{
	icon_state = "upp16";
	name = "Fulcrum"
	},
/area/desert_dam/exterior/valley/valley_civilian)
"Jy" = (
/obj/structure/prop/invuln/fire,
/turf/closed/shuttle/ert{
	icon_state = "leftengine_2";
	name = "Buran";
	opacity = 0
	},
/area/desert_dam/exterior/valley/valley_civilian)
"JW" = (
/turf/closed/shuttle/ert{
	icon_state = "upp25";
	name = "Buran"
	},
/area/desert_dam/exterior/valley/valley_civilian)
"Kr" = (
/turf/closed/shuttle/ert{
	icon_state = "T10";
	name = "Buran"
	},
/area/desert_dam/exterior/valley/valley_civilian)
"KX" = (
/turf/open/asphalt/cement_sunbleached{
	icon_state = "cement_sunbleached13"
	},
/area/desert_dam/exterior/valley/valley_civilian)
"Lp" = (
/obj/structure/prop/invuln/fire{
	pixel_x = 8;
	pixel_y = 10
	},
/turf/closed/shuttle/ert{
	icon_state = "upp5";
	name = "Buran"
	},
/area/desert_dam/exterior/valley/valley_civilian)
"Lt" = (
/obj/effect/spawner/gibspawner/human,
/obj/effect/decal/cleanable/dirt,
/turf/open/floor/plating,
/area/desert_dam/exterior/valley/valley_civilian)
"Lv" = (
/turf/open/asphalt/cement_sunbleached{
	icon_state = "cement_sunbleached15"
	},
/area/desert_dam/exterior/valley/valley_civilian)
"MM" = (
/turf/closed/shuttle/ert{
	icon_state = "T5";
	name = "Buran"
	},
/area/desert_dam/exterior/valley/valley_civilian)
"Nt" = (
/turf/closed/shuttle/ert{
	icon_state = "T7";
	name = "Buran";
	opacity = 0
	},
/area/desert_dam/exterior/valley/valley_civilian)
"Ny" = (
/obj/structure/closet/crate/ammo,
/obj/item/ammo_magazine/pkp,
/obj/item/weapon/gun/pkp,
/turf/open/shuttle/dropship{
	icon_state = "rasputin15"
	},
/area/desert_dam/exterior/valley/valley_civilian)
"NP" = (
/turf/closed/shuttle/ert{
	icon_state = "rightengine_2";
	name = "Buran";
	opacity = 0
	},
/area/desert_dam/exterior/valley/valley_civilian)
"OB" = (
/obj/structure/desertdam/decals/road_edge{
	icon_state = "road_edge_decal4"
	},
/turf/open/auto_turf/snow/layer0,
/area/desert_dam/exterior/valley/valley_civilian)
"OG" = (
/obj/effect/decal/cleanable/dirt,
/turf/open/shuttle/dropship{
	icon_state = "rasputin3"
	},
/area/desert_dam/exterior/valley/valley_civilian)
"Pc" = (
/obj/structure/desertdam/decals/road_edge{
	icon_state = "road_edge_decal7"
	},
/turf/open/asphalt,
/area/desert_dam/exterior/valley/valley_civilian)
"Pr" = (
/turf/open/asphalt,
/area/desert_dam/exterior/valley/valley_civilian)
"PI" = (
/obj/effect/decal/warning_stripes{
	icon_state = "S"
	},
/turf/open/asphalt,
/area/desert_dam/exterior/valley/valley_civilian)
"PS" = (
/turf/closed/shuttle/ert{
	icon_state = "upp20";
	name = "Buran"
	},
/area/desert_dam/exterior/valley/valley_civilian)
"Qc" = (
/obj/effect/spawner/gibspawner/human,
/turf/open/auto_turf/snow/layer0,
/area/desert_dam/exterior/valley/valley_civilian)
"Qj" = (
/obj/structure/machinery/colony_floodlight,
/turf/open/auto_turf/snow/layer2,
/area/desert_dam/exterior/valley/valley_civilian)
"Rq" = (
/turf/open/shuttle/dropship{
	icon_state = "rasputin6"
	},
/area/desert_dam/exterior/valley/valley_civilian)
"Ry" = (
/obj/effect/decal/cleanable/blood/splatter,
/turf/open/shuttle/dropship{
	icon_state = "rasputin8"
	},
/area/desert_dam/exterior/valley/valley_civilian)
"Sf" = (
/turf/closed/shuttle/ert{
	icon_state = "T14";
	name = "Buran";
	opacity = 0
	},
/area/desert_dam/exterior/valley/valley_civilian)
"Sm" = (
/obj/structure/desertdam/decals/road_edge{
	icon_state = "road_edge_decal8"
	},
/turf/open/asphalt,
/area/desert_dam/exterior/valley/valley_civilian)
"SN" = (
/obj/effect/spawner/gibspawner/human,
/obj/effect/decal/cleanable/dirt,
/turf/open/shuttle/dropship{
	icon_state = "rasputin5"
	},
/area/desert_dam/exterior/valley/valley_civilian)
"SV" = (
/obj/structure/prop/invuln/fire{
	pixel_x = -7;
	pixel_y = 24
	},
/turf/closed/shuttle/ert{
	icon_state = "T3";
	name = "Buran";
	opacity = 0
	},
/area/desert_dam/exterior/valley/valley_civilian)
"Tn" = (
/turf/closed/shuttle/ert{
	icon_state = "upp5";
	name = "Buran"
	},
/area/desert_dam/exterior/valley/valley_civilian)
"TT" = (
/obj/structure/girder,
/turf/open/floor/plating,
/area/desert_dam/exterior/valley/valley_civilian)
"Ug" = (
/obj/structure/bed/chair/dropship/pilot{
	dir = 1
	},
/obj/structure/machinery/computer/cameras{
	desc = "The flight controls for a Mi-220 Attack Dropship. these controls look pretty banged up, and there's some blood covering the screen..";
	name = "\improper 'Buran' flight controls";
	network = null;
	pixel_y = 21
	},
/obj/effect/decal/cleanable/dirt,
/turf/open/shuttle/dropship{
	icon_state = "rasputin15"
	},
/area/desert_dam/exterior/valley/valley_civilian)
"UB" = (
/obj/structure/prop/invuln/fire{
	pixel_x = -3;
	pixel_y = 6
	},
/turf/closed/shuttle/ert{
	icon_state = "rightengine_1";
	name = "Buran";
	opacity = 0
	},
/area/desert_dam/exterior/valley/valley_civilian)
"UK" = (
/obj/effect/decal/cleanable/blood/splatter,
/turf/open/auto_turf/snow/layer0,
/area/desert_dam/exterior/valley/valley_civilian)
"VK" = (
/obj/structure/desertdam/decals/road_edge{
	icon_state = "road_edge_decal2"
	},
/turf/open/asphalt,
/area/desert_dam/exterior/valley/valley_civilian)
"Wb" = (
/turf/open/asphalt/cement_sunbleached{
	icon_state = "cement_sunbleached2"
	},
/area/desert_dam/exterior/valley/valley_civilian)
"Wy" = (
/turf/open/shuttle/dropship{
	icon_state = "rasputin5"
	},
/area/desert_dam/exterior/valley/valley_civilian)
"WW" = (
/turf/open/asphalt{
	icon_state = "tile"
	},
/area/desert_dam/exterior/valley/valley_civilian)
"Xq" = (
/turf/template_noop,
/area/template_noop)
"Yr" = (
/turf/closed/shuttle/ert{
	icon_state = "upp27";
	name = "Buran";
	opacity = 0
	},
/area/desert_dam/exterior/valley/valley_civilian)
"YD" = (
/obj/structure/fence,
/turf/open/auto_turf/snow/layer2,
/area/desert_dam/exterior/valley/valley_civilian)
"YZ" = (
/turf/open/auto_turf/snow/layer0,
/area/desert_dam/exterior/valley/valley_civilian)
"Zm" = (
/turf/open/auto_turf/snow/layer2,
/area/desert_dam/exterior/valley/valley_civilian)
"Zz" = (
/obj/effect/decal/cleanable/dirt,
/obj/structure/prop/invuln/fire{
	pixel_x = 8;
	pixel_y = 10
	},
/turf/closed/shuttle/ert{
	icon_state = "T2";
	name = "Buran";
	opacity = 0
	},
/area/desert_dam/exterior/valley/valley_civilian)

(1,1,1) = {"
la
la
la
la
la
la
la
la
la
la
la
la
la
la
la
la
WW
WW
WW
WW
WW
WW
WW
WW
WW
uK
Pr
Xq
Xq
Xq
"}
(2,1,1) = {"
la
la
la
la
la
la
la
la
la
la
la
la
la
la
la
ft
YD
YD
YD
ft
YD
YD
YD
ft
jN
uK
PI
Xq
Xq
Xq
"}
(3,1,1) = {"
la
la
la
la
la
la
la
la
la
la
la
la
la
la
Bk
Zm
Zm
Zm
Zm
Zm
Zm
YZ
Hm
SV
vJ
Gt
Pr
Xq
Xq
Xq
"}
(4,1,1) = {"
la
la
la
la
la
la
la
la
la
la
la
la
la
Nt
cn
Zm
Zm
Zm
Zm
Zm
YZ
YZ
YZ
xK
Zz
Sf
Pr
Xq
Xq
Xq
"}
(5,1,1) = {"
yU
nA
IS
nA
la
la
la
la
la
la
la
la
Nt
fa
Jy
kd
Zm
Zm
Zm
Zm
YZ
YZ
YZ
YZ
YZ
OB
PI
Xq
Xq
Xq
"}
(6,1,1) = {"
Yr
Ug
ih
Ug
YZ
la
la
la
la
la
la
la
Nt
Kr
NP
Hs
Zm
Zm
WW
Wb
KX
KX
KX
KX
Lv
uK
Pr
Xq
Xq
Xq
"}
(7,1,1) = {"
Yr
fg
OG
oL
YZ
la
la
la
la
la
la
la
la
YZ
YZ
YZ
YZ
Zm
WW
dP
oX
gb
gb
gb
gb
Pc
Pr
Xq
Xq
Xq
"}
(8,1,1) = {"
JW
Tn
TT
xz
YZ
YZ
YZ
la
la
la
YZ
YZ
YZ
YZ
YZ
YZ
YZ
Qj
WW
dP
uK
Pr
Pr
Pr
dz
Pr
PI
Xq
Xq
Xq
"}
(9,1,1) = {"
Zm
Zm
Zm
YZ
UK
YZ
YZ
PS
hK
nA
nA
xz
ig
YZ
YZ
UK
YZ
YZ
Zm
dP
uK
Pr
Pr
Pr
dz
Pr
Pr
Xq
Xq
Xq
"}
(10,1,1) = {"
Zm
Zm
Zm
Zm
YZ
YZ
YZ
xz
Rq
mt
jU
OG
oj
YZ
YZ
YZ
YZ
UK
Zm
Zm
xp
VK
VK
VK
Sm
Pr
Pr
Xq
Xq
Xq
"}
(11,1,1) = {"
Zm
Zm
Zm
Zm
YZ
YZ
YZ
ly
os
CL
mk
Ny
SN
YZ
dN
YZ
YZ
YZ
YZ
Zm
oX
gb
gb
gb
Pc
Pr
PI
Xq
Xq
Xq
"}
(12,1,1) = {"
Zm
Zm
Zm
YZ
YZ
YZ
YZ
Lt
Wy
CL
vz
qM
xP
YZ
YZ
YZ
YZ
YZ
YZ
eb
uK
Pr
Pr
Pr
dz
Pr
Pr
Xq
Xq
Xq
"}
(13,1,1) = {"
Zm
Zm
Zm
YZ
YZ
YZ
UK
xz
xE
bm
OG
OG
Ry
YZ
YZ
YZ
YZ
YZ
YZ
Zm
uK
Pr
Pr
Pr
dz
Pr
Pr
Xq
Xq
Xq
"}
(14,1,1) = {"
Zm
Zm
Zm
YZ
YZ
YZ
Zm
TT
Tn
Lp
Tn
Tn
xz
YZ
YZ
YZ
UK
YZ
Zm
zs
xp
VK
VK
VK
Sm
Pr
PI
Xq
Xq
Xq
"}
(15,1,1) = {"
Zm
Zm
Zm
Qc
YZ
Zm
Zm
Zm
la
la
la
la
yl
fA
kd
YZ
YZ
YZ
Zm
zs
oX
gb
gb
gb
Pc
Pr
Pr
Xq
Xq
Xq
"}
(16,1,1) = {"
Zm
Zm
Zm
Zm
Zm
Zm
Zm
la
la
la
la
la
eC
Dd
UB
YZ
YZ
Zm
BE
zs
uK
Pr
Pr
Pr
dz
Pr
Pr
Xq
Xq
Xq
"}
(17,1,1) = {"
Zm
Zm
Zm
la
la
la
la
la
la
la
la
la
bz
MM
YZ
YZ
Zm
qD
qD
cp
uK
Pr
Pr
Pr
dz
Pr
Pr
Xq
Xq
Xq
"}
(18,1,1) = {"
dv
Zm
la
la
la
la
la
la
la
la
la
la
la
pF
YZ
YZ
Zm
qD
qD
cp
xp
VK
VK
VK
VK
VK
VK
Xq
Xq
Xq
"}
(19,1,1) = {"
Xq
Xq
Xq
Xq
Xq
Xq
Xq
Xq
Xq
Xq
Xq
Xq
Xq
Xq
Xq
Xq
Xq
Xq
Xq
Xq
Xq
Xq
Xq
Xq
Xq
Xq
Xq
Xq
Xq
Xq
"}
(20,1,1) = {"
Xq
Xq
Xq
Xq
Xq
Xq
Xq
Xq
Xq
Xq
Xq
Xq
Xq
Xq
Xq
Xq
Xq
Xq
Xq
Xq
Xq
Xq
Xq
Xq
Xq
Xq
Xq
Xq
Xq
Xq
"}
(21,1,1) = {"
Xq
Xq
Xq
Xq
Xq
Xq
Xq
Xq
Xq
Xq
Xq
Xq
Xq
Xq
Xq
Xq
Xq
Xq
Xq
Xq
Xq
Xq
Xq
Xq
Xq
Xq
Xq
Xq
Xq
Xq
"}
(22,1,1) = {"
Xq
Xq
Xq
Xq
Xq
Xq
Xq
Xq
Xq
Xq
Xq
Xq
Xq
Xq
Xq
Xq
Xq
Xq
Xq
Xq
Xq
Xq
Xq
Xq
Xq
Xq
Xq
Xq
Xq
Xq
"}
(23,1,1) = {"
Xq
Xq
Xq
Xq
Xq
Xq
Xq
Xq
Xq
Xq
Xq
Xq
Xq
Xq
Xq
Xq
Xq
Xq
Xq
Xq
Xq
Xq
Xq
Xq
Xq
Xq
Xq
Xq
Xq
Xq
"}
(24,1,1) = {"
Xq
Xq
Xq
Xq
Xq
Xq
Xq
Xq
Xq
Xq
Xq
Xq
Xq
Xq
Xq
Xq
Xq
Xq
Xq
Xq
Xq
Xq
Xq
Xq
Xq
Xq
Xq
Xq
Xq
Xq
"}
(25,1,1) = {"
Xq
Xq
Xq
Xq
Xq
Xq
Xq
Xq
Xq
Xq
Xq
Xq
Xq
Xq
Xq
Xq
Xq
Xq
Xq
Xq
Xq
Xq
Xq
Xq
Xq
Xq
Xq
Xq
Xq
Xq
"}
(26,1,1) = {"
Xq
Xq
Xq
Xq
Xq
Xq
Xq
Xq
Xq
Xq
Xq
Xq
Xq
Xq
Xq
Xq
Xq
Xq
Xq
Xq
Xq
Xq
Xq
Xq
Xq
Xq
Xq
Xq
Xq
Xq
"}
