//MAP CONVERTED BY dmm2tgm.py THIS HEADER COMMENT PREVENTS RECONVERSION, DO NOT REMOVE
"a" = (
/turf/open/auto_turf/snow/layer4,
/area/shiva/exterior/cp_lz2)
"n" = (
/turf/closed/wall/shiva/prefabricated/pink,
/area/shiva/exterior/lz2_fortress)
"D" = (
/turf/open/auto_turf/snow/layer3,
/area/shiva/exterior/cp_lz2)
"R" = (
/turf/open/floor/shiva/north,
/area/shiva/exterior/lz2_fortress)
"Y" = (
/turf/closed/wall/shiva/prefabricated/reinforced/hull,
/area/shiva/exterior/lz2_fortress)

(1,1,1) = {"
R
R
n
n
a
a
"}
(2,1,1) = {"
R
R
n
n
a
D
"}
(3,1,1) = {"
Y
Y
Y
Y
Y
Y
"}
(4,1,1) = {"
Y
Y
Y
Y
Y
Y
"}
(5,1,1) = {"
R
R
n
n
a
D
"}
(6,1,1) = {"
R
R
n
n
a
a
"}
