//MAP CONVERTED BY dmm2tgm.py THIS HEADER COMMENT PREVENTS RECONVERSION, DO NOT REMOVE
"aa" = (
/obj/structure/filingcabinet{
	pixel_x = -8;
	pixel_y = 4
	},
/obj/structure/filingcabinet{
	pixel_x = 8;
	pixel_y = 4
	},
/obj/effect/landmark/objective_landmark/close,
/turf/open/floor/shiva/yellowfull,
/area/shiva/interior/colony/research_hab)
"ab" = (
/obj/structure/filingcabinet{
	pixel_x = -8;
	pixel_y = 4
	},
/obj/structure/filingcabinet{
	pixel_x = 8;
	pixel_y = 4
	},
/turf/open/floor/shiva/yellowfull,
/area/shiva/interior/colony/research_hab)
"ac" = (
/obj/structure/filingcabinet{
	pixel_x = -8;
	pixel_y = 4
	},
/obj/structure/filingcabinet{
	pixel_x = 8;
	pixel_y = 4
	},
/obj/effect/landmark/objective_landmark/medium,
/turf/open/floor/shiva/yellowfull,
/area/shiva/interior/colony/research_hab)
"ad" = (
/obj/structure/surface/table/reinforced/prison,
/obj/item/storage/pill_bottle/bicaridine,
/turf/open/floor/shiva,
/area/shiva/interior/colony/research_hab)
"ae" = (
/obj/structure/surface/table/reinforced/prison,
/turf/open/floor/shiva,
/area/shiva/interior/colony/research_hab)
"af" = (
/obj/structure/surface/rack,
/obj/structure/machinery/light/double{
	dir = 8;
	pixel_y = 9
	},
/obj/item/clothing/suit/storage/labcoat/researcher,
/turf/open/floor/shiva/multi_tiles,
/area/shiva/interior/colony/research_hab)
"ag" = (
/obj/structure/surface/rack,
/obj/structure/machinery/light/double{
	dir = 4;
	pixel_y = 9
	},
/obj/item/clothing/suit/storage/labcoat/researcher,
/turf/open/floor/shiva/multi_tiles,
/area/shiva/interior/colony/research_hab)
"ah" = (
/obj/effect/landmark/structure_spawner/setup/distress/xeno_weed_node,
/turf/open/floor/shiva/multi_tiles/east,
/area/shiva/interior/colony/research_hab)
"ai" = (
/obj/structure/closet/crate,
/obj/effect/decal/cleanable/dirt,
/obj/effect/landmark/objective_landmark/science,
/turf/open/floor/plating,
/area/shiva/interior/colony/research_hab)
"aj" = (
/obj/structure/barricade/wooden{
	dir = 4
	},
/turf/open/floor/plating,
/area/shiva/interior/colony/research_hab)
"ak" = (
/obj/structure/machinery/light/double{
	dir = 8;
	pixel_x = -6
	},
/turf/open/floor/shiva,
/area/shiva/interior/colony/research_hab)
"al" = (
/obj/structure/machinery/light/double{
	dir = 4;
	pixel_x = 6
	},
/obj/effect/decal/cleanable/dirt,
/turf/open/floor/shiva,
/area/shiva/interior/colony/research_hab)
"am" = (
/obj/structure/machinery/door/airlock/multi_tile/almayer/engidoor/glass/colony{
	dir = 1;
	req_access_txt = "100";
	name = "\improper Omicron Field Gear Storage"
	},
/obj/effect/decal/cleanable/dirt,
/turf/open/floor/shiva,
/area/shiva/interior/colony/research_hab)
"an" = (
/obj/structure/machinery/light/double{
	dir = 8;
	pixel_y = 9
	},
/obj/effect/decal/cleanable/dirt,
/turf/open/floor/shiva,
/area/shiva/interior/colony/research_hab)
"ao" = (
/obj/item/stack/snow,
/obj/structure/machinery/light/double{
	dir = 4;
	pixel_y = 9
	},
/obj/item/stack/snow,
/obj/effect/decal/cleanable/dirt,
/turf/open/floor/shiva,
/area/shiva/interior/colony/research_hab)
"ap" = (
/obj/effect/landmark/structure_spawner/setup/distress/xeno_weed_node,
/turf/open/floor/plating,
/area/shiva/interior/colony/research_hab)
"aq" = (
/obj/structure/window/framed/shiva/orange,
/turf/open/floor/plating,
/area/shiva/interior/colony/research_hab)
"ar" = (
/obj/structure/closet/radiation,
/obj/structure/machinery/light/double{
	dir = 4;
	pixel_y = -5
	},
/obj/effect/landmark/objective_landmark/science,
/turf/open/floor/shiva/purplefull,
/area/shiva/interior/colony/research_hab)
"as" = (
/obj/effect/decal/cleanable/dirt,
/obj/effect/landmark/structure_spawner/setup/distress/xeno_weed_node,
/turf/open/floor/shiva,
/area/shiva/interior/colony/research_hab)
"at" = (
/obj/effect/decal/warning_stripes{
	icon_state = "NE-out"
	},
/obj/structure/machinery/door_control/brbutton{
	id = "labs_ice_1";
	pixel_y = 28
	},
/obj/structure/surface/rack,
/obj/item/clothing/suit/storage/snow_suit,
/obj/item/clothing/suit/storage/snow_suit,
/turf/open/floor/shiva,
/area/shiva/interior/colony/research_hab)
"au" = (
/obj/structure/surface/rack,
/obj/item/tool/shovel/snow,
/obj/item/tool/shovel/snow,
/obj/effect/decal/warning_stripes{
	icon_state = "NW-out"
	},
/obj/structure/machinery/door_control/brbutton{
	id = "labs_ice_1";
	pixel_y = 28
	},
/turf/open/floor/shiva,
/area/shiva/interior/colony/research_hab)
"av" = (
/obj/structure/blocker/forcefield/multitile_vehicles,
/turf/closed/wall/shiva/prefabricated/blue,
/area/shiva/interior/colony/research_hab)
"aw" = (
/obj/structure/machinery/door/poddoor/shutters/almayer{
	id = "labs_ice_1";
	name = "\improper Research Shutters"
	},
/obj/structure/blocker/forcefield/multitile_vehicles,
/turf/open/floor/shiva/floor3,
/area/shiva/interior/colony/research_hab)
"ax" = (
/turf/closed/wall/shiva/ice,
/area/shiva/interior/oob)
"ay" = (
/obj/structure/blocker/forcefield/multitile_vehicles,
/turf/closed/wall/shiva/prefabricated/orange,
/area/shiva/interior/colony/research_hab)
"az" = (
/obj/structure/machinery/door/airlock/almayer/maint/colony/autoname{
	dir = 1;
	req_one_access = null
	},
/obj/structure/blocker/forcefield/multitile_vehicles,
/turf/open/floor/plating,
/area/shiva/interior/colony/research_hab)
"cn" = (
/obj/effect/decal/cleanable/dirt,
/turf/open/floor/shiva,
/area/shiva/interior/colony/research_hab)
"cO" = (
/obj/structure/surface/rack,
/obj/item/stack/cable_coil/random,
/obj/item/stack/cable_coil/random,
/turf/open/floor/plating,
/area/shiva/interior/colony/research_hab)
"ei" = (
/obj/structure/machinery/space_heater,
/turf/open/floor/shiva/purplefull/north,
/area/shiva/interior/colony/research_hab)
"hG" = (
/turf/open/floor/shiva/purplefull/north,
/area/shiva/interior/colony/research_hab)
"ip" = (
/obj/structure/closet/crate/secure/weyland,
/turf/open/floor/plating,
/area/shiva/interior/colony/research_hab)
"iw" = (
/obj/structure/closet/crate,
/turf/open/auto_turf/ice/layer1,
/area/shiva/interior/caves/cp_camp)
"ju" = (
/turf/closed/wall/shiva/prefabricated/blue,
/area/shiva/interior/colony/research_hab)
"kA" = (
/obj/structure/closet/secure_closet/medical3{
	req_access = null
	},
/obj/item/explosive/grenade/custom/cleaner,
/obj/item/explosive/grenade/custom/cleaner,
/obj/item/storage/pill_bottle/kelotane/skillless,
/turf/open/floor/shiva/multi_tiles,
/area/shiva/interior/colony/research_hab)
"lA" = (
/turf/open/floor/shiva/multi_tiles/east,
/area/shiva/interior/colony/research_hab)
"lM" = (
/obj/structure/surface/rack,
/obj/effect/landmark/crap_item,
/obj/structure/machinery/alarm{
	dir = 4;
	pixel_y = 24
	},
/turf/open/floor/shiva/purplefull,
/area/shiva/interior/colony/research_hab)
"lX" = (
/obj/structure/machinery/light/double{
	dir = 1;
	pixel_y = 9
	},
/turf/open/floor/shiva/purplefull,
/area/shiva/interior/colony/research_hab)
"mj" = (
/obj/structure/machinery/door/airlock/almayer/maint/colony,
/turf/open/floor/shiva,
/area/shiva/interior/colony/research_hab)
"ni" = (
/obj/structure/closet/secure_closet/medical3{
	req_access = null
	},
/obj/item/explosive/grenade/custom/cleaner,
/obj/item/explosive/grenade/custom/cleaner,
/obj/item/storage/pill_bottle/bicaridine/skillless,
/turf/open/floor/shiva/multi_tiles,
/area/shiva/interior/colony/research_hab)
"nn" = (
/obj/effect/decal/cleanable/dirt,
/turf/open/floor/shiva/purplefull/west,
/area/shiva/interior/colony/research_hab)
"nQ" = (
/obj/structure/surface/table,
/obj/item/reagent_container/food/drinks/flask/weylandyutani,
/turf/open/floor/shiva,
/area/shiva/interior/colony/research_hab)
"oM" = (
/turf/closed/wall/shiva/prefabricated/orange,
/area/shiva/interior/colony/research_hab)
"pr" = (
/obj/effect/decal/cleanable/dirt,
/turf/open/floor/shiva/floor3,
/area/shiva/interior/colony/research_hab)
"pC" = (
/obj/structure/closet/radiation,
/turf/open/floor/shiva/purplefull,
/area/shiva/interior/colony/research_hab)
"pI" = (
/obj/effect/decal/cleanable/dirt,
/turf/open/floor/shiva/purplefull/east,
/area/shiva/interior/colony/research_hab)
"qH" = (
/obj/structure/surface/rack,
/obj/effect/spawner/random/toolbox,
/turf/open/floor/shiva/purplefull/west,
/area/shiva/interior/colony/research_hab)
"rA" = (
/obj/structure/machinery/space_heater,
/turf/open/floor/plating,
/area/shiva/interior/colony/research_hab)
"sj" = (
/obj/structure/machinery/door/airlock/multi_tile/almayer/engidoor/glass/colony{
	req_access_txt = "100";
	name = "\improper Omicron Field Gear Storage"
	},
/obj/effect/decal/cleanable/dirt,
/turf/open/floor/shiva/multi_tiles/east,
/area/shiva/interior/colony/research_hab)
"sV" = (
/obj/effect/decal/cleanable/dirt,
/turf/open/floor/shiva/multi_tiles/east,
/area/shiva/interior/colony/research_hab)
"tr" = (
/obj/structure/closet/radiation,
/obj/effect/spawner/random/powercell,
/turf/open/floor/shiva/purplefull,
/area/shiva/interior/colony/research_hab)
"tO" = (
/obj/effect/decal/cleanable/dirt,
/turf/open/floor/plating,
/area/shiva/interior/colony/research_hab)
"uJ" = (
/turf/open/floor/shiva/purplefull/east,
/area/shiva/interior/colony/research_hab)
"vZ" = (
/obj/item/ammo_magazine/rifle/m41aMK1,
/turf/open/floor/shiva,
/area/shiva/interior/colony/research_hab)
"wX" = (
/obj/structure/closet/secure_closet/medical3{
	req_access = null
	},
/obj/item/explosive/grenade/custom/cleaner,
/obj/item/explosive/grenade/custom/cleaner,
/obj/item/storage/pill_bottle/inaprovaline/skillless,
/turf/open/floor/shiva/multi_tiles,
/area/shiva/interior/colony/research_hab)
"yZ" = (
/turf/open/floor/shiva/purplefull/west,
/area/shiva/interior/colony/research_hab)
"AC" = (
/turf/open/floor/plating,
/area/shiva/interior/colony/research_hab)
"DE" = (
/turf/open/auto_turf/ice/layer2,
/area/shiva/interior/caves/cp_camp)
"DO" = (
/obj/structure/machinery/door/airlock/multi_tile/almayer/generic2/autoname{
	req_access_txt = "100"
	},
/turf/open/floor/shiva/purplefull/west,
/area/shiva/interior/colony/research_hab)
"GL" = (
/turf/open/floor/shiva/floor3,
/area/shiva/interior/colony/research_hab)
"Hm" = (
/turf/open/auto_turf/snow/layer0,
/area/shiva/interior/caves/cp_camp)
"HR" = (
/obj/structure/surface/table/reinforced/prison,
/obj/structure/machinery/door_control/brbutton/alt{
	id = "labs_ice_1"
	},
/turf/open/auto_turf/ice/layer1,
/area/shiva/interior/colony/research_hab)
"IK" = (
/obj/effect/decal/warning_stripes{
	icon_state = "N"
	},
/obj/effect/decal/cleanable/dirt,
/turf/open/floor/shiva,
/area/shiva/interior/colony/research_hab)
"JH" = (
/obj/effect/decal/cleanable/dirt,
/turf/open/floor/shiva/purplefull,
/area/shiva/interior/colony/research_hab)
"JI" = (
/obj/structure/surface/rack,
/obj/item/stack/rods,
/obj/item/stack/rods,
/turf/open/floor/plating,
/area/shiva/interior/colony/research_hab)
"JO" = (
/obj/structure/machinery/light/double,
/turf/open/floor/shiva/floor3,
/area/shiva/interior/colony/research_hab)
"KS" = (
/turf/open/floor/shiva,
/area/shiva/interior/colony/research_hab)
"Lg" = (
/obj/structure/surface/rack,
/obj/item/clothing/suit/storage/labcoat/researcher,
/turf/open/floor/shiva/multi_tiles,
/area/shiva/interior/colony/research_hab)
"Lk" = (
/obj/structure/surface/rack,
/obj/item/clothing/shoes/snow,
/obj/item/clothing/shoes/snow,
/obj/effect/decal/cleanable/dirt,
/turf/open/floor/shiva,
/area/shiva/interior/colony/research_hab)
"Ov" = (
/obj/structure/machinery/space_heater,
/turf/open/floor/shiva/purplefull/west,
/area/shiva/interior/colony/research_hab)
"Qg" = (
/obj/structure/surface/rack,
/obj/item/device/motiondetector/hacked,
/obj/effect/landmark/objective_landmark/science,
/turf/open/floor/shiva/purplefull/west,
/area/shiva/interior/colony/research_hab)
"Qz" = (
/obj/structure/machinery/door/airlock/almayer/engineering/colony{
	dir = 8;
	name = "\improper Omicron Field Gear Storage";
	req_access_txt = "100"
	},
/turf/open/floor/shiva,
/area/shiva/interior/colony/research_hab)
"Ro" = (
/turf/open/auto_turf/snow/layer1,
/area/shiva/interior/caves/cp_camp)
"SV" = (
/obj/structure/closet/secure_closet/medical3{
	req_access = null
	},
/obj/effect/spawner/random/attachment,
/obj/effect/decal/cleanable/dirt,
/turf/open/floor/shiva/multi_tiles,
/area/shiva/interior/colony/research_hab)
"Vp" = (
/obj/structure/surface/table,
/obj/item/storage/fancy/crayons{
	pixel_x = 1;
	pixel_y = 2
	},
/obj/effect/spawner/random/bomb_supply,
/turf/open/floor/shiva/purplefull,
/area/shiva/interior/colony/research_hab)
"Vv" = (
/turf/open/auto_turf/ice/layer1,
/area/shiva/interior/caves/cp_camp)
"Wd" = (
/obj/structure/closet/secure_closet/medical3{
	req_access = null
	},
/obj/item/explosive/grenade/custom/cleaner,
/obj/item/explosive/grenade/custom/cleaner,
/obj/item/storage/pill_bottle/dexalin/skillless,
/turf/open/floor/shiva/multi_tiles,
/area/shiva/interior/colony/research_hab)
"Xo" = (
/turf/open/floor/shiva/purplefull,
/area/shiva/interior/colony/research_hab)
"XI" = (
/obj/structure/closet/radiation,
/obj/effect/spawner/random/technology_scanner,
/turf/open/floor/shiva/purplefull,
/area/shiva/interior/colony/research_hab)
"Yz" = (
/obj/effect/decal/warning_stripes{
	icon_state = "N"
	},
/turf/open/floor/shiva,
/area/shiva/interior/colony/research_hab)
"YD" = (
/turf/open/auto_turf/ice/layer0,
/area/shiva/interior/caves/cp_camp)
"YI" = (
/obj/effect/landmark/structure_spawner/setup/distress/xeno_weed_node,
/turf/open/floor/shiva,
/area/shiva/interior/colony/research_hab)
"YZ" = (
/obj/structure/machinery/disposal,
/obj/effect/decal/cleanable/dirt,
/turf/open/floor/shiva/multi_tiles,
/area/shiva/interior/colony/research_hab)

(1,1,1) = {"
ay
Qg
uJ
Ov
aq
KS
KS
cn
KS
vZ
KS
KS
ad
GL
"}
(2,1,1) = {"
az
hG
cn
ei
aq
KS
KS
KS
KS
KS
cn
KS
ae
GL
"}
(3,1,1) = {"
av
qH
pI
Ov
oM
oM
Qz
oM
oM
GL
lA
GL
oM
oM
"}
(4,1,1) = {"
av
ju
Xo
Xo
XI
pC
Xo
Vp
oM
nn
yZ
yZ
oM
aa
"}
(5,1,1) = {"
av
ju
lX
KS
cn
cn
cn
Xo
sj
pr
ah
pr
oM
ab
"}
(6,1,1) = {"
av
ju
lM
Xo
KS
KS
KS
JH
sV
GL
sV
JO
oM
aa
"}
(7,1,1) = {"
av
ju
ju
pC
ar
tr
cn
Xo
oM
yZ
yZ
yZ
oM
ac
"}
(8,1,1) = {"
av
ju
ju
ju
ju
ju
cn
am
oM
Qz
oM
oM
oM
oM
"}
(9,1,1) = {"
av
av
av
at
Lk
an
cn
KS
ak
nn
oM
Lg
af
oM
"}
(10,1,1) = {"
Vv
Vv
aw
IK
KS
KS
KS
cn
cn
KS
DO
ah
sV
DO
"}
(11,1,1) = {"
DE
Vv
aw
Yz
as
KS
cn
YI
KS
nn
yZ
sV
sV
yZ
"}
(12,1,1) = {"
Vv
Ro
aw
IK
KS
cn
cn
cn
cn
SV
ju
Lg
ag
ju
"}
(13,1,1) = {"
Hm
Vv
aw
Yz
cn
KS
KS
cn
KS
SV
ju
ju
ju
ju
"}
(14,1,1) = {"
Ro
HR
av
au
nQ
ao
cn
cn
al
YZ
ju
ju
ju
wX
"}
(15,1,1) = {"
Vv
iw
av
ju
ju
ju
mj
mj
ju
ju
ju
ju
ju
Wd
"}
(16,1,1) = {"
YD
ax
ax
ju
cO
AC
AC
AC
tO
ip
ju
ju
ju
kA
"}
(17,1,1) = {"
Vv
ax
ax
ju
rA
ap
tO
AC
tO
ai
ju
ju
ju
ni
"}
(18,1,1) = {"
ax
ax
ax
ju
JI
AC
AC
tO
AC
aj
ju
ju
ju
ju
"}
