//MAP CONVERTED BY dmm2tgm.py THIS HEADER COMMENT PREVENTS RECONVERSION, DO NOT REMOVE
"a" = (
/obj/structure/interior_viewport/humvee{
	pixel_x = -3;
	pixel_y = -7
	},
/turf/open/void/vehicle,
/area/space)
"g" = (
/obj/structure/bed/chair/comfy/vehicle/passager{
	dir = 1;
	pixel_y = 8;
	buckling_y = 8
	},
/turf/open/void/vehicle,
/area/interior/vehicle/humvee/medical)
"o" = (
/obj/structure/bed/chair/comfy/vehicle/driver/humvee{
	dir = 4;
	pixel_x = -3;
	pixel_y = 10;
	buckling_x = -3;
	buckling_y = 10
	},
/obj/effect/landmark/interior/spawn/entrance{
	dir = 1;
	exit_type = /obj/structure/interior_exit/vehicle/van/left;
	name = "left entrance marker";
	pixel_y = 32;
	tag = "left"
	},
/obj/structure/interior_exit/vehicle/humvee/left{
	pixel_x = -3;
	pixel_y = 23;
	layer = 2.9
	},
/obj/structure/extinguisher_cabinet/lifeboat{
	icon = 'icons/obj/vehicles/interiors/general.dmi';
	pixel_x = -17;
	pixel_y = 22
	},
/turf/open/void/vehicle,
/area/interior/vehicle/humvee/medical)
"s" = (
/obj/structure/machinery/cm_vending/sorted/medical/vehicle{
	pixel_x = -3;
	pixel_y = 12
	},
/turf/open/void/vehicle,
/area/interior/vehicle/humvee/medical)
"t" = (
/obj/structure/interior_viewport/humvee/windshield/north{
	pixel_x = -10;
	pixel_y = 14
	},
/turf/open/void/vehicle,
/area/space)
"v" = (
/obj/structure/prop/vehicle/humvee/medical{
	pixel_x = 24;
	pixel_y = -3
	},
/turf/open/void/vehicle,
/area/space)
"y" = (
/obj/structure/interior_viewport/humvee/windshield/south{
	pixel_x = -10;
	pixel_y = 16
	},
/turf/open/void/vehicle,
/area/space)
"C" = (
/obj/effect/landmark/interior/spawn/entrance{
	alpha = 50;
	exit_type = /obj/structure/interior_exit/vehicle/van/right;
	name = "right entrance marker";
	tag = "right"
	},
/obj/structure/interior_exit/vehicle/humvee/right{
	pixel_x = -3;
	pixel_y = -1;
	alpha = 50
	},
/obj/structure/interior_viewport/humvee{
	pixel_x = -3;
	pixel_y = 1;
	alpha = 50
	},
/obj/structure/bed/chair/comfy/vehicle/passager{
	dir = 4;
	pixel_y = 14;
	pixel_x = -3;
	buckling_x = -3;
	buckling_y = 14
	},
/turf/open/void/vehicle,
/area/interior/vehicle/humvee/medical)
"G" = (
/obj/effect/landmark/interior/spawn/entrance{
	dir = 8;
	exit_type = /obj/structure/interior_exit/vehicle/van/backright;
	name = "back right entrance marker";
	pixel_x = -32;
	tag = "back_right"
	},
/obj/structure/interior_exit/vehicle/humvee/back/medical/right{
	pixel_x = -32;
	pixel_y = 9
	},
/obj/structure/bed/chair/comfy/vehicle/passager{
	dir = 1;
	pixel_x = 15;
	pixel_y = 8;
	buckling_x = 15;
	buckling_y = 8
	},
/obj/structure/bed/chair/comfy/vehicle/passager{
	dir = 1;
	pixel_x = -1;
	pixel_y = 8;
	buckling_x = -1;
	buckling_y = 8
	},
/turf/open/void/vehicle,
/area/interior/vehicle/humvee/medical)
"M" = (
/obj/effect/landmark/interior/spawn/entrance{
	dir = 8;
	exit_type = /obj/structure/interior_exit/vehicle/van/backleft;
	name = "back left entrance marker";
	pixel_x = -32;
	tag = "back_left"
	},
/obj/structure/machinery/cm_vending/sorted/medical/blood/vehicle/humvee{
	pixel_x = -6;
	pixel_y = 23
	},
/obj/structure/vehicle_locker/med/humvee{
	pixel_x = 16;
	pixel_y = 23
	},
/obj/structure/interior_exit/vehicle/humvee/back/medical/left{
	pixel_x = -32;
	pixel_y = 9
	},
/obj/structure/bed/portable_surgery{
	icon_state = "surgical_up";
	pixel_x = 1;
	pixel_y = 3;
	buckling_x = 1;
	buckling_y = 5
	},
/turf/open/void/vehicle,
/area/interior/vehicle/humvee/medical)
"O" = (
/turf/open/void/vehicle,
/area/space)

(1,1,1) = {"
O
O
O
v
O
"}
(2,1,1) = {"
O
O
M
G
O
"}
(3,1,1) = {"
O
O
s
g
O
"}
(4,1,1) = {"
O
a
o
C
O
"}
(5,1,1) = {"
O
O
t
y
O
"}
