//MAP CONVERTED BY dmm2tgm.py THIS HEADER COMMENT PREVENTS RECONVERSION, DO NOT REMOVE
"aP" = (
/obj/item/stack/sheet/metal,
/turf/open/auto_turf/strata_grass/layer0_mud,
/area/strata/exterior/marsh/crash)
"cq" = (
/obj/structure/prop/colorable_rock/colorable{
	color = "#9d7766";
	pixel_x = -2;
	pixel_y = 2;
	dir = 4
	},
/obj/effect/decal/cleanable/dirt,
/obj/item/stack/rods,
/obj/effect/decal/cleanable/dirt,
/obj/effect/decal/cleanable/dirt,
/obj/effect/decal/cleanable/dirt/greenglow{
	color = "#140400";
	name = "dirt";
	alpha = 100
	},
/obj/effect/decal/cleanable/dirt/greenglow{
	color = "#140400";
	name = "dirt";
	alpha = 100
	},
/turf/open/auto_turf/strata_grass/layer0_mud,
/area/strata/exterior/marsh/crash)
"cG" = (
/turf/closed/shuttle/ert{
	icon_state = "upp_leftengine"
	},
/area/strata/interior/outpost/engi/drome/shuttle_MK3)
"dI" = (
/obj/item/ammo_box/magazine/ak4047/ap/empty{
	pixel_x = 3;
	pixel_y = -4
	},
/turf/open/floor/almayer/test_floor5,
/area/strata/interior/outpost/engi/drome/shuttle_MK3)
"eV" = (
/obj/effect/decal/cleanable/dirt,
/obj/item/stack/rods,
/turf/open/auto_turf/strata_grass/layer0_mud,
/area/strata/exterior/marsh/crash)
"gP" = (
/obj/structure/prop/invuln/fire{
	pixel_x = -1;
	pixel_y = 17
	},
/turf/closed/shuttle/ert{
	icon_state = "upp22"
	},
/area/strata/interior/outpost/engi/drome/shuttle_MK3)
"gR" = (
/obj/structure/prop/colorable_rock/colorable{
	color = "#9d7766";
	dir = 5;
	pixel_x = 11;
	pixel_y = 15
	},
/turf/closed/shuttle/ert{
	icon_state = "upp25"
	},
/area/strata/interior/outpost/engi/drome/shuttle_MK3)
"gV" = (
/obj/structure/closet/crate/ammo,
/obj/item/ammo_magazine/rifle/ak4047/ap,
/obj/item/ammo_magazine/rifle/ak4047/ap,
/obj/item/ammo_magazine/rifle/ak4047/ap,
/obj/item/ammo_magazine/rifle/ak4047,
/obj/item/ammo_magazine/rifle/ak4047,
/obj/item/ammo_magazine/rifle/ak4047,
/obj/item/ammo_magazine/rifle/ak4047,
/turf/open/floor/almayer/test_floor5,
/area/strata/interior/outpost/engi/drome/shuttle_MK3)
"iS" = (
/obj/structure/prop/colorable_rock/colorable{
	color = "#9d7766";
	pixel_x = -10;
	pixel_y = 13;
	dir = 5
	},
/turf/closed/shuttle/ert{
	icon_state = "upp20"
	},
/area/strata/interior/outpost/engi/drome/shuttle_MK3)
"iY" = (
/obj/effect/decal/cleanable/dirt/greenglow{
	color = "#140400";
	name = "dirt";
	alpha = 100
	},
/turf/open/auto_turf/strata_grass/layer1,
/area/strata/exterior/marsh/crash)
"jA" = (
/turf/closed/shuttle/ert{
	icon_state = "rightengine_1";
	opacity = 0
	},
/area/strata/interior/outpost/engi/drome/shuttle_MK3)
"mL" = (
/obj/effect/decal/cleanable/dirt,
/obj/effect/decal/cleanable/dirt/greenglow{
	color = "#140400";
	name = "dirt";
	alpha = 100
	},
/obj/effect/decal/cleanable/blood,
/turf/open/floor/almayer/plate,
/area/strata/exterior/marsh/crash)
"ns" = (
/turf/open/floor/almayer/test_floor6,
/area/strata/interior/outpost/engi/drome/shuttle_MK3)
"nu" = (
/obj/structure/prop/colorable_rock/colorable{
	color = "#9d7766";
	dir = 5;
	pixel_x = 2
	},
/turf/open/auto_turf/strata_grass/layer0_mud,
/area/strata/exterior/marsh/crash)
"oZ" = (
/turf/closed/shuttle/ert{
	icon_state = "upp5"
	},
/area/strata/interior/outpost/engi/drome/shuttle_MK3)
"pc" = (
/obj/effect/decal/cleanable/dirt,
/obj/structure/prop/colorable_rock/colorable{
	color = "#9d7766";
	pixel_x = -2;
	pixel_y = 2;
	dir = 4
	},
/obj/effect/decal/cleanable/dirt/greenglow{
	color = "#140400";
	name = "dirt";
	alpha = 100
	},
/obj/effect/decal/cleanable/blood/gibs/limb,
/turf/open/floor/almayer/plate,
/area/strata/exterior/marsh/crash)
"pV" = (
/obj/effect/decal/cleanable/dirt/greenglow{
	color = "#140400";
	name = "dirt";
	alpha = 100
	},
/obj/effect/decal/cleanable/dirt/greenglow{
	color = "#140400";
	name = "dirt";
	alpha = 100
	},
/obj/effect/decal/cleanable/dirt,
/obj/item/stack/rods,
/turf/open/auto_turf/strata_grass/layer1,
/area/strata/exterior/marsh/crash)
"qH" = (
/obj/item/ammo_box/magazine/ak4047/empty{
	pixel_x = -4;
	pixel_y = -6
	},
/obj/item/ammo_box/magazine/ak4047/empty{
	pixel_x = -4;
	pixel_y = -13
	},
/obj/item/ammo_box/magazine/ak4047/empty{
	pixel_x = -4;
	pixel_y = -20
	},
/turf/open/floor/almayer/test_floor5,
/area/strata/interior/outpost/engi/drome/shuttle_MK3)
"qZ" = (
/turf/closed/shuttle/ert{
	icon_state = "upp9"
	},
/area/strata/interior/outpost/engi/drome/shuttle_MK3)
"ra" = (
/turf/closed/shuttle/ert{
	icon_state = "upp_rightengine"
	},
/area/strata/interior/outpost/engi/drome/shuttle_MK3)
"rw" = (
/obj/structure/prop/colorable_rock/colorable{
	color = "#9d7766";
	pixel_y = 19;
	dir = 8;
	pixel_x = -15
	},
/turf/open/auto_turf/strata_grass/layer0_mud,
/area/strata/exterior/marsh/crash)
"sa" = (
/turf/closed/shuttle/ert{
	icon_state = "upp27"
	},
/area/strata/interior/outpost/engi/drome/shuttle_MK3)
"sw" = (
/turf/closed/shuttle/ert{
	icon_state = "upp21"
	},
/area/strata/interior/outpost/engi/drome/shuttle_MK3)
"tc" = (
/obj/structure/prop/colorable_rock/colorable{
	color = "#9d796a";
	dir = 9;
	pixel_x = -16;
	pixel_y = 15
	},
/obj/effect/decal/cleanable/dirt/greenglow{
	color = "#140400";
	name = "dirt";
	alpha = 100
	},
/turf/open/auto_turf/strata_grass/layer1,
/area/strata/exterior/marsh/crash)
"ug" = (
/obj/structure/prop/invuln/fire,
/turf/closed/shuttle/ert{
	icon_state = "upp_rightengine"
	},
/area/strata/interior/outpost/engi/drome/shuttle_MK3)
"uS" = (
/obj/structure/machinery/door/poddoor/almayer/closed{
	name = "Supply Dropship Hold Lockdown";
	needs_power = 0
	},
/turf/open/floor/almayer/pod_landing_floor,
/area/strata/interior/outpost/engi/drome/shuttle_MK3)
"vB" = (
/obj/effect/decal/cleanable/dirt,
/obj/structure/girder,
/turf/open/floor/plating,
/area/strata/exterior/marsh/crash)
"xC" = (
/obj/effect/decal/cleanable/dirt,
/obj/effect/decal/cleanable/dirt,
/obj/structure/prop/colorable_rock/colorable{
	color = "#9d7766";
	pixel_x = -19;
	pixel_y = 12;
	dir = 1
	},
/obj/effect/decal/cleanable/dirt/greenglow{
	color = "#140400";
	name = "dirt";
	alpha = 100
	},
/obj/item/stack/sheet/metal,
/obj/effect/decal/cleanable/blood,
/turf/open/floor/plating,
/area/strata/exterior/marsh/crash)
"xI" = (
/obj/structure/machinery/big_computers/computerblack/computer4{
	pixel_y = 3;
	icon_state = "blacksensor_comp2_off"
	},
/obj/effect/decal/cleanable/dirt,
/turf/open/floor/almayer/plate,
/area/strata/exterior/marsh/crash)
"yC" = (
/turf/closed/shuttle/ert{
	icon_state = "upp4"
	},
/area/strata/interior/outpost/engi/drome/shuttle_MK3)
"AT" = (
/obj/effect/decal/cleanable/dirt,
/obj/item/stack/rods,
/obj/effect/decal/cleanable/dirt/greenglow{
	color = "#140400";
	name = "dirt";
	alpha = 100
	},
/obj/effect/landmark/objective_landmark/close,
/obj/effect/decal/cleanable/blood,
/obj/item/clothing/head/helmet/marine/veteran/UPP/heavy/SOF_helmet,
/obj/effect/decal/cleanable/blood/gibs/up,
/turf/open/floor/almayer/plate,
/area/strata/exterior/marsh/crash)
"BN" = (
/obj/structure/prop/colorable_rock/colorable{
	color = "#9d7766";
	pixel_x = 19;
	pixel_y = 19;
	dir = 4
	},
/turf/open/auto_turf/strata_grass/layer0_mud,
/area/strata/exterior/marsh/crash)
"CM" = (
/obj/structure/prop/colorable_rock/colorable{
	color = "#9d7766";
	pixel_x = -20;
	pixel_y = 2
	},
/turf/open/auto_turf/strata_grass/layer0_mud,
/area/strata/exterior/marsh/crash)
"CS" = (
/turf/closed/shuttle/ert{
	icon_state = "leftengine_1";
	opacity = 0
	},
/area/strata/interior/outpost/engi/drome/shuttle_MK3)
"CU" = (
/obj/structure/prop/colorable_rock/colorable{
	color = "#9d7766";
	dir = 4;
	pixel_x = -11;
	pixel_y = 10
	},
/turf/open/auto_turf/strata_grass/layer1,
/area/strata/exterior/marsh/crash)
"Dn" = (
/obj/structure/closet/crate/ammo,
/obj/item/explosive/grenade/high_explosive/upp,
/obj/item/explosive/grenade/high_explosive/upp,
/obj/item/explosive/grenade/high_explosive/upp,
/obj/item/explosive/grenade/high_explosive/upp,
/obj/item/explosive/grenade/high_explosive/upp,
/obj/item/explosive/grenade/high_explosive/upp,
/obj/structure/machinery/light/double{
	dir = 8;
	pixel_y = -15
	},
/obj/item/storage/belt/gun/type47/SOF_belt,
/obj/item/clothing/suit/storage/marine/faction/UPP/SOF_armor,
/obj/item/clothing/suit/storage/marine/faction/UPP/SOF_armor,
/obj/item/clothing/accessory/storage/webbing/black,
/obj/item/clothing/accessory/storage/webbing/black,
/obj/item/clothing/accessory/storage/webbing/black,
/obj/item/clothing/accessory/storage/webbing/black,
/turf/open/floor/almayer/test_floor5,
/area/strata/interior/outpost/engi/drome/shuttle_MK3)
"DB" = (
/turf/open/auto_turf/strata_grass/layer0_mud,
/area/strata/exterior/marsh/crash)
"Ff" = (
/turf/open/auto_turf/strata_grass/layer1,
/area/strata/exterior/marsh/crash)
"Fz" = (
/obj/item/ammo_magazine/rifle/ak4047/ap,
/turf/open/floor/almayer/test_floor5,
/area/strata/interior/outpost/engi/drome/shuttle_MK3)
"FK" = (
/obj/effect/decal/cleanable/dirt,
/obj/item/stack/rods,
/obj/effect/decal/cleanable/blood,
/turf/open/auto_turf/strata_grass/layer0_mud,
/area/strata/exterior/marsh/crash)
"FL" = (
/obj/item/ammo_magazine/rifle/ak4047,
/obj/structure/machinery/power/apc/no_power/west,
/turf/open/floor/almayer/test_floor5,
/area/strata/interior/outpost/engi/drome/shuttle_MK3)
"Gj" = (
/obj/structure/prop/invuln/fire{
	pixel_y = 11
	},
/turf/closed/shuttle/ert{
	icon_state = "leftengine_3";
	opacity = 0
	},
/area/strata/interior/outpost/engi/drome/shuttle_MK3)
"Gp" = (
/obj/effect/decal/cleanable/dirt,
/obj/structure/prop/colorable_rock/colorable{
	color = "#9d7766";
	pixel_x = 17;
	pixel_y = -1;
	dir = 4
	},
/obj/structure/prop/colorable_rock/colorable{
	color = "#9d7766";
	pixel_x = -13;
	pixel_y = 8;
	dir = 1
	},
/obj/item/stack/rods,
/turf/open/floor/wall_thermite,
/area/strata/exterior/marsh/crash)
"Hm" = (
/obj/structure/prop/invuln/fire{
	pixel_x = 27;
	pixel_y = 3
	},
/turf/closed/shuttle/ert{
	icon_state = "upp21"
	},
/area/strata/interior/outpost/engi/drome/shuttle_MK3)
"HS" = (
/obj/effect/decal/cleanable/dirt,
/obj/effect/decal/cleanable/dirt,
/turf/open/auto_turf/strata_grass/layer0_mud,
/area/strata/exterior/marsh/crash)
"Is" = (
/turf/closed/shuttle/ert{
	icon_state = "upp8"
	},
/area/strata/interior/outpost/engi/drome/shuttle_MK3)
"Iz" = (
/obj/effect/decal/cleanable/dirt,
/obj/item/stack/rods,
/obj/effect/decal/cleanable/blood,
/turf/open/floor/wall_thermite,
/area/strata/exterior/marsh/crash)
"IC" = (
/obj/structure/prop/colorable_rock/colorable{
	color = "#9d7766";
	pixel_x = 13;
	pixel_y = 15;
	dir = 1
	},
/obj/effect/decal/cleanable/dirt,
/turf/open/auto_turf/strata_grass/layer0_mud,
/area/strata/exterior/marsh/crash)
"II" = (
/obj/item/ammo_box/magazine/ak4047/ap/empty{
	pixel_x = 4;
	pixel_y = 7
	},
/turf/open/floor/almayer/test_floor6,
/area/strata/interior/outpost/engi/drome/shuttle_MK3)
"Ju" = (
/obj/structure/prop/colorable_rock/colorable{
	color = "#9d7766";
	pixel_x = -19;
	pixel_y = 18
	},
/obj/effect/decal/cleanable/dirt,
/obj/effect/decal/cleanable/dirt/greenglow{
	color = "#140400";
	name = "dirt";
	alpha = 100
	},
/obj/effect/decal/cleanable/dirt,
/turf/open/auto_turf/strata_grass/layer0_mud,
/area/strata/exterior/marsh/crash)
"Kr" = (
/obj/structure/closet/crate/ammo,
/obj/item/weapon/gun/launcher/rocket/upp,
/turf/open/floor/almayer/test_floor5,
/area/strata/interior/outpost/engi/drome/shuttle_MK3)
"Lc" = (
/obj/effect/decal/cleanable/dirt,
/obj/structure/machinery/door/poddoor/almayer/closed{
	name = "Supply Dropship Hold Lockdown";
	needs_power = 0
	},
/turf/open/floor/almayer/pod_landing_floor,
/area/strata/interior/outpost/engi/drome/shuttle_MK3)
"Lq" = (
/obj/structure/prop/colorable_rock/colorable{
	color = "#9d796a";
	dir = 9;
	pixel_x = 2;
	pixel_y = 4
	},
/turf/open/auto_turf/strata_grass/layer0_mud,
/area/strata/exterior/marsh/crash)
"LL" = (
/obj/structure/prop/colorable_rock/colorable{
	color = "#9d7766";
	pixel_x = 23;
	pixel_y = 12;
	dir = 5
	},
/turf/open/auto_turf/strata_grass/layer1,
/area/strata/exterior/marsh/crash)
"MO" = (
/turf/closed/shuttle/ert{
	icon_state = "rightengine_3";
	opacity = 0
	},
/area/strata/interior/outpost/engi/drome/shuttle_MK3)
"Nq" = (
/obj/structure/prop/colorable_rock/colorable{
	color = "#9d7766";
	pixel_x = -2;
	pixel_y = -9;
	dir = 4
	},
/turf/open/auto_turf/strata_grass/layer0_mud,
/area/strata/exterior/marsh/crash)
"NK" = (
/obj/structure/prop/colorable_rock/colorable{
	color = "#9d7766";
	pixel_x = 19;
	pixel_y = 19;
	dir = 4
	},
/turf/open/auto_turf/strata_grass/layer1,
/area/strata/exterior/marsh/crash)
"OI" = (
/obj/structure/prop/colorable_rock/colorable{
	color = "#9d7766";
	dir = 8
	},
/obj/structure/prop/colorable_rock/colorable{
	color = "#9d7766";
	pixel_x = -19;
	pixel_y = 12;
	dir = 1
	},
/obj/effect/decal/cleanable/dirt,
/obj/effect/decal/cleanable/dirt/greenglow{
	color = "#140400";
	name = "dirt";
	alpha = 100
	},
/obj/effect/decal/cleanable/dirt,
/turf/open/auto_turf/strata_grass/layer0_mud,
/area/strata/exterior/marsh/crash)
"Sj" = (
/obj/structure/prop/colorable_rock/colorable{
	color = "#9d7766";
	pixel_x = 7;
	pixel_y = 21;
	dir = 4
	},
/obj/structure/prop/colorable_rock/colorable{
	color = "#9d7766";
	pixel_x = 18;
	pixel_y = 12;
	dir = 5
	},
/turf/closed/shuttle/ert{
	icon_state = "upp25"
	},
/area/strata/interior/outpost/engi/drome/shuttle_MK3)
"TE" = (
/obj/effect/decal/cleanable/dirt/greenglow{
	color = "#140400";
	name = "dirt";
	alpha = 100
	},
/obj/effect/decal/cleanable/dirt/greenglow{
	color = "#140400";
	name = "dirt";
	alpha = 100
	},
/obj/effect/decal/cleanable/dirt,
/turf/open/auto_turf/strata_grass/layer1,
/area/strata/exterior/marsh/crash)
"Ud" = (
/obj/effect/decal/cleanable/dirt,
/turf/open/auto_turf/strata_grass/layer0_mud,
/area/strata/exterior/marsh/crash)
"VU" = (
/obj/structure/prop/colorable_rock/colorable{
	color = "#9d7766";
	pixel_x = 8;
	pixel_y = -14
	},
/obj/structure/prop/colorable_rock/colorable{
	color = "#9d7766";
	pixel_y = 19;
	dir = 8;
	pixel_x = -15
	},
/turf/open/auto_turf/strata_grass/layer1,
/area/strata/exterior/marsh/crash)
"Wk" = (
/obj/structure/closet/crate/ammo,
/obj/structure/machinery/light/double{
	dir = 4;
	pixel_y = -15
	},
/obj/item/ammo_magazine/rifle/ak4047,
/obj/item/ammo_magazine/rifle/ak4047,
/obj/item/ammo_magazine/rifle/ak4047,
/obj/item/ammo_magazine/rifle/ak4047,
/obj/item/ammo_magazine/rifle/ak4047,
/obj/item/ammo_magazine/rifle/ak4047,
/obj/item/ammo_magazine/rifle/ak4047,
/obj/item/ammo_magazine/rifle/ak4047,
/obj/item/ammo_magazine/rifle/ak4047,
/obj/item/weapon/gun/rifle/ak4047,
/obj/item/weapon/gun/rifle/ak4047,
/turf/open/floor/almayer/test_floor5,
/area/strata/interior/outpost/engi/drome/shuttle_MK3)
"Ww" = (
/obj/effect/decal/cleanable/dirt,
/obj/effect/decal/cleanable/blood,
/obj/item/organ/eyes,
/turf/open/floor/almayer/plate,
/area/strata/exterior/marsh/crash)
"WW" = (
/obj/structure/prop/colorable_rock/colorable{
	color = "#9d7766";
	pixel_x = 4;
	pixel_y = 17
	},
/turf/open/auto_turf/strata_grass/layer0_mud,
/area/strata/exterior/marsh/crash)
"YA" = (
/obj/effect/decal/cleanable/dirt,
/obj/effect/decal/cleanable/blood/gibs/body,
/obj/effect/decal/cleanable/blood,
/obj/item/clothing/suit/storage/marine/faction/UPP/SOF_armor,
/turf/open/floor/almayer/plate,
/area/strata/exterior/marsh/crash)
"Zi" = (
/obj/structure/prop/colorable_rock/colorable{
	color = "#9d7766";
	pixel_y = -14;
	pixel_x = 12
	},
/turf/open/auto_turf/strata_grass/layer0_mud,
/area/strata/exterior/marsh/crash)
"ZE" = (
/obj/structure/prop/colorable_rock/colorable{
	color = "#9d7766";
	pixel_x = -2;
	pixel_y = 2;
	dir = 4
	},
/obj/effect/decal/cleanable/dirt/greenglow{
	color = "#140400";
	name = "dirt";
	alpha = 100
	},
/turf/open/auto_turf/strata_grass/layer1,
/area/strata/exterior/marsh/crash)

(1,1,1) = {"
BN
Ff
NK
Ff
Ff
Ff
iY
Ff
Ff
Ff
Ff
"}
(2,1,1) = {"
DB
LL
FK
Ud
rw
WW
Ju
pV
TE
Ff
Ff
"}
(3,1,1) = {"
DB
Iz
xC
yC
yC
yC
cG
Gj
CS
OI
DB
"}
(4,1,1) = {"
iS
gP
pc
sw
Dn
Kr
Is
yC
cG
CS
Ud
"}
(5,1,1) = {"
vB
AT
Ww
Lc
ns
ns
qH
FL
uS
nu
CU
"}
(6,1,1) = {"
sa
xI
YA
uS
II
ns
Fz
dI
uS
Lq
IC
"}
(7,1,1) = {"
Sj
vB
mL
Hm
Wk
gV
qZ
oZ
ug
jA
iY
"}
(8,1,1) = {"
DB
gR
Gp
oZ
oZ
oZ
ra
MO
jA
cq
HS
"}
(9,1,1) = {"
Ff
CM
Ud
eV
aP
Nq
Zi
Ff
iY
tc
ZE
"}
(10,1,1) = {"
Ff
Ff
Ff
rw
VU
DB
Ff
Ff
Ff
Ff
Ff
"}
