//MAP CONVERTED BY dmm2tgm.py THIS HEADER COMMENT PREVENTS RECONVERSION, DO NOT REMOVE
"a" = (
/turf/open/floor/strata,
/area/atlan/station/promenade)
"b" = (
/obj/structure/pipes/standard/simple/hidden/cyan,
/turf/open/floor/strata,
/area/atlan/station/promenade)
"c" = (
/obj/structure/pipes/standard/simple/hidden/cyan{
	dir = 6
	},
/turf/open/floor/strata,
/area/atlan/station/promenade)
"d" = (
/obj/structure/pipes/vents/pump,
/turf/open/floor/strata,
/area/atlan/station/promenade)
"e" = (
/obj/structure/pipes/standard/simple/hidden/cyan{
	dir = 9
	},
/turf/open/floor/strata/floor3/east,
/area/atlan/station/promenade)
"k" = (
/obj/structure/machinery/cm_vending/sorted/walkman,
/turf/open/floor/strata,
/area/atlan/station/promenade)
"l" = (
/obj/structure/bed/chair{
	dir = 1;
	pixel_y = 8;
	pixel_x = -3
	},
/turf/open/floor/strata,
/area/atlan/station/promenade)
"n" = (
/turf/closed/wall/upp_ship/grey/reinforced/outer,
/area/atlan/oob)
"o" = (
/turf/open/space/basic,
/area/atlan/oob/space)
"p" = (
/obj/item/weapon/twohanded/folded_metal_chair{
	pixel_x = 6;
	pixel_y = 9
	},
/turf/open/floor/strata,
/area/atlan/station/promenade)
"s" = (
/obj/structure/machinery/light/double/blue{
	pixel_y = -1
	},
/obj/structure/flora/pottedplant{
	icon_state = "pottedplant_18";
	pixel_y = 11;
	pixel_x = 2
	},
/turf/open/floor/strata,
/area/atlan/station/promenade)
"v" = (
/obj/structure/lattice,
/turf/open/space/basic,
/area/atlan/oob/space)
"w" = (
/obj/structure/machinery/light/double/blue{
	dir = 4
	},
/obj/structure/flora/pottedplant{
	icon_state = "pottedplant_22";
	pixel_x = -8
	},
/turf/open/floor/strata/floor3/east,
/area/atlan/station/promenade)
"z" = (
/obj/structure/surface/table/almayer,
/obj/item/trash/plate{
	pixel_x = -5;
	pixel_y = 4
	},
/obj/structure/pipes/standard/simple/hidden/cyan,
/obj/effect/decal/cleanable/dirt,
/turf/open/floor/strata,
/area/atlan/station/promenade)
"A" = (
/obj/effect/decal/cleanable/generic{
	color = "#5d524b";
	alpha = 155;
	pixel_x = -5;
	pixel_y = 3
	},
/turf/open/floor/strata,
/area/atlan/station/promenade)
"C" = (
/obj/effect/decal/cleanable/dirt,
/obj/structure/pipes/standard/simple/hidden/cyan,
/turf/open/floor/strata/floor3/east,
/area/atlan/station/promenade)
"D" = (
/obj/effect/decal/cleanable/dirt,
/turf/open/floor/strata,
/area/atlan/station/promenade)
"F" = (
/obj/structure/bed/chair{
	pixel_x = 3;
	pixel_y = 2
	},
/turf/open/floor/strata,
/area/atlan/station/promenade)
"M" = (
/obj/effect/landmark/yautja_teleport,
/obj/effect/decal/cleanable/dirt,
/turf/open/floor/strata,
/area/atlan/station/promenade)
"Q" = (
/obj/structure/surface/table/almayer,
/obj/structure/pipes/standard/simple/hidden/cyan{
	dir = 4
	},
/turf/open/floor/strata,
/area/atlan/station/promenade)
"R" = (
/obj/structure/bed/chair{
	dir = 4;
	pixel_y = 9
	},
/obj/effect/decal/cleanable/dirt,
/turf/open/floor/strata,
/area/atlan/station/promenade)
"U" = (
/obj/structure/pipes/standard/simple/hidden/cyan,
/obj/effect/decal/cleanable/dirt,
/turf/open/floor/strata/floor3/east,
/area/atlan/station/promenade)
"Z" = (
/obj/structure/machinery/vending/cola,
/turf/open/floor/strata,
/area/atlan/station/promenade)

(1,1,1) = {"
a
a
a
A
a
a
a
"}
(2,1,1) = {"
D
a
a
c
U
b
b
"}
(3,1,1) = {"
a
D
F
Q
l
D
Z
"}
(4,1,1) = {"
D
R
D
d
a
s
n
"}
(5,1,1) = {"
b
z
C
e
M
n
n
"}
(6,1,1) = {"
a
p
a
w
n
n
v
"}
(7,1,1) = {"
a
D
k
n
n
o
v
"}
