//MAP CONVERTED BY dmm2tgm.py THIS HEADER COMMENT PREVENTS RECONVERSION, DO NOT REMOVE
"a" = (
/turf/closed/wall/upp_ship/grey/teal,
/area/atlan/station/medical)
"b" = (
/obj/structure/sign/safety/biolab,
/turf/closed/wall/upp_ship/grey/teal,
/area/atlan/station/medical)
"c" = (
/obj/structure/machinery/light/small{
	dir = 4
	},
/obj/structure/closet/bodybag,
/obj/effect/decal/cleanable/blood,
/obj/effect/decal/cleanable/blood/gibs/core,
/obj/effect/decal/cleanable/blood/gibs/down,
/obj/effect/decal/cleanable/blood/gibs/up,
/obj/effect/decal/cleanable/blood/gibs,
/turf/open/floor/strata/multi_tiles/southwest,
/area/atlan/station/medical)
"e" = (
/obj/effect/decal/cleanable/blood,
/obj/effect/decal/cleanable/blood/gibs/up,
/turf/open/floor/strata/multi_tiles/southwest,
/area/atlan/station/medical)
"g" = (
/obj/structure/closet/bodybag,
/obj/effect/decal/cleanable/blood,
/obj/effect/decal/cleanable/blood/gibs/down,
/turf/open/floor/strata/multi_tiles/southwest,
/area/atlan/station/medical)
"h" = (
/obj/structure/machinery/door/airlock/hybrisa/medical_solid/autoname{
	dir = 2
	},
/turf/open/floor/strata/multi_tiles/southeast,
/area/atlan/station/medical)
"i" = (
/obj/structure/machinery/light/small,
/obj/structure/closet/bodybag{
	icon_state = "bodybag_open"
	},
/obj/effect/decal/cleanable/blood,
/obj/effect/decal/cleanable/blood{
	dir = 8;
	icon_state = "gib6";
	layer = 4;
	pixel_x = 12;
	pixel_y = 3
	},
/turf/open/floor/strata/multi_tiles/southwest,
/area/atlan/station/medical)
"j" = (
/obj/structure/flora/pottedplant{
	icon_state = "pottedplant_22";
	pixel_y = 18;
	pixel_x = -4
	},
/obj/structure/sign/poster/upp{
	pixel_y = 33;
	layer = 2.5
	},
/turf/open/floor/strata/multi_tiles/southwest,
/area/atlan/station/medical)
"k" = (
/obj/effect/decal/cleanable/blood{
	icon_state = "csplatter1";
	pixel_y = 4;
	pixel_x = -10
	},
/turf/open/floor/strata/multi_tiles/southwest,
/area/atlan/station/medical)
"l" = (
/obj/effect/decal/cleanable/blood,
/obj/effect/decal/cleanable/blood/gibs/down,
/turf/open/floor/strata/multi_tiles/southwest,
/area/atlan/station/medical)
"m" = (
/obj/structure/curtain/colorable_transparent{
	color = "#22282c";
	alpha = 235
	},
/turf/open/floor/strata/multi_tiles/west,
/area/atlan/station/medical)
"p" = (
/obj/structure/morgue,
/turf/open/floor/strata/cyan1/east,
/area/atlan/station/medical)
"q" = (
/obj/structure/prop/hybrisa/misc/buildinggreebliessmall/smallvent3,
/turf/closed/wall/upp_ship/grey/teal,
/area/atlan/station/medical)
"r" = (
/obj/structure/surface/table/reinforced/prison{
	color = "#98a3ab"
	},
/obj/item/storage/box/gloves,
/obj/item/tool/surgery/FixOVein{
	pixel_x = -4;
	pixel_y = 2
	},
/turf/open/floor/strata/multi_tiles/southwest,
/area/atlan/station/medical)
"t" = (
/obj/effect/decal/cleanable/blood{
	icon_state = "csplatter1";
	pixel_y = 4;
	pixel_x = -10
	},
/obj/effect/decal/cleanable/blood/gibs/core,
/obj/effect/decal/cleanable/blood/gibs/down,
/obj/effect/decal/cleanable/blood/gibs/body,
/obj/effect/decal/cleanable/blood{
	icon_state = "csplatter1"
	},
/obj/effect/landmark/corpsespawner/colonist/random/burst,
/obj/structure/closet/bodybag{
	icon_state = "bodybag_open"
	},
/turf/open/floor/strata/multi_tiles/southwest,
/area/atlan/station/medical)
"x" = (
/obj/structure/morgue{
	dir = 8
	},
/turf/open/floor/strata/cyan1/east,
/area/atlan/station/medical)
"y" = (
/obj/structure/sign/nosmoking_1,
/turf/closed/wall/upp_ship/grey/teal,
/area/atlan/station/medical)
"z" = (
/turf/open/floor/strata/multi_tiles/southwest,
/area/atlan/station/medical)
"A" = (
/obj/structure/machinery/light/small{
	dir = 1;
	pixel_y = 20
	},
/turf/open/floor/strata/multi_tiles/southwest,
/area/atlan/station/medical)
"B" = (
/obj/structure/machinery/light/small{
	dir = 4
	},
/obj/effect/decal/cleanable/blood,
/obj/effect/decal/cleanable/blood/gibs/down,
/obj/effect/decal/cleanable/blood/gibs/down,
/obj/effect/decal/cleanable/blood{
	desc = "Watch your step.";
	icon_state = "gib6"
	},
/obj/effect/landmark/corpsespawner/colonist/random/burst,
/obj/structure/closet/bodybag{
	icon_state = "bodybag_open"
	},
/turf/open/floor/strata/multi_tiles/southwest,
/area/atlan/station/medical)
"C" = (
/obj/structure/sign/safety/medical,
/turf/closed/wall/upp_ship/grey/teal,
/area/atlan/station/medical)
"D" = (
/obj/structure/closet/bodybag,
/turf/open/floor/strata/multi_tiles/southwest,
/area/atlan/station/medical)
"E" = (
/obj/structure/machinery/light/small{
	dir = 8;
	pixel_y = 8
	},
/obj/effect/decal/cleanable/blood/oil,
/turf/open/floor/strata/multi_tiles/southwest,
/area/atlan/station/medical)
"F" = (
/obj/structure/bookcase{
	pixel_y = 22;
	pixel_x = 1
	},
/obj/structure/closet/bodybag{
	icon_state = "bodybag_open"
	},
/obj/effect/decal/cleanable/blood,
/obj/effect/decal/cleanable/blood/gibs/core,
/obj/effect/decal/cleanable/blood/gibs/down,
/obj/effect/decal/cleanable/blood/gibs/up,
/obj/effect/decal/cleanable/blood{
	icon_state = "csplatter1"
	},
/turf/open/floor/strata/multi_tiles/southwest,
/area/atlan/station/medical)
"G" = (
/turf/open/floor/strata/cyan1,
/area/atlan/station/medical)
"J" = (
/obj/effect/decal/cleanable/blood,
/obj/effect/decal/cleanable/blood{
	icon_state = "csplatter1"
	},
/turf/open/floor/strata/multi_tiles/southwest,
/area/atlan/station/medical)
"N" = (
/obj/structure/machinery/bioprinter{
	stored_metal = 1000
	},
/turf/open/floor/strata/cyan1,
/area/atlan/station/medical)
"O" = (
/obj/structure/sign/safety/biohazard,
/obj/structure/sign/safety/biolab{
	pixel_x = 13
	},
/turf/closed/wall/upp_ship/grey/teal,
/area/atlan/station/medical)
"R" = (
/obj/effect/decal/cleanable/dirt/alt_dirt{
	color = "#140400"
	},
/obj/effect/decal/cleanable/blood,
/obj/effect/decal/cleanable/blood/gibs/core,
/turf/open/floor/strata/multi_tiles/southwest,
/area/atlan/station/medical)
"S" = (
/obj/effect/decal/cleanable/blood/gibs/down,
/obj/effect/decal/cleanable/blood/gibs,
/obj/effect/decal/cleanable/blood{
	icon_state = "csplatter1"
	},
/obj/effect/landmark/corpsespawner/colonist/random/burst,
/obj/structure/closet/bodybag{
	icon_state = "bodybag_open"
	},
/turf/open/floor/strata/multi_tiles/southwest,
/area/atlan/station/medical)
"T" = (
/obj/structure/extinguisher_cabinet,
/turf/closed/wall/upp_ship/grey/teal,
/area/atlan/station/medical)
"V" = (
/obj/structure/morgue,
/obj/effect/decal/cleanable/blood,
/turf/open/floor/strata/cyan1/east,
/area/atlan/station/medical)
"W" = (
/obj/structure/morgue,
/obj/effect/decal/cleanable/blood{
	icon_state = "gib6";
	pixel_y = -8
	},
/turf/open/floor/strata/cyan1/east,
/area/atlan/station/medical)
"X" = (
/obj/effect/decal/cleanable/dirt/alt_dirt{
	color = "#140400"
	},
/turf/open/floor/strata/multi_tiles/southwest,
/area/atlan/station/medical)
"Z" = (
/obj/structure/surface/table/reinforced/prison{
	color = "#98a3ab"
	},
/obj/item/storage/surgical_tray{
	pixel_y = 9
	},
/obj/item/tank/anesthetic,
/turf/open/floor/strata/cyan1,
/area/atlan/station/medical)

(1,1,1) = {"
O
m
m
m
a
a
Z
N
G
G
"}
(2,1,1) = {"
a
D
X
z
i
a
a
a
a
a
"}
(3,1,1) = {"
a
j
z
z
z
e
z
E
z
a
"}
(4,1,1) = {"
a
A
x
x
x
x
x
x
z
h
"}
(5,1,1) = {"
b
J
p
W
p
p
p
V
z
a
"}
(6,1,1) = {"
h
z
z
k
l
z
R
z
z
q
"}
(7,1,1) = {"
a
F
t
c
g
S
D
B
r
T
"}
(8,1,1) = {"
C
a
a
a
a
a
a
a
a
y
"}
