//MAP CONVERTED BY dmm2tgm.py THIS HEADER COMMENT PREVENTS RECONVERSION, DO NOT REMOVE
"a" = (
/obj/structure/bed/chair{
	dir = 4
	},
/turf/open/floor/strata/cyan1,
/area/atlan/station/medical/morgue)
"d" = (
/obj/structure/prop/hybrisa/misc/buildinggreebliessmall{
	pixel_y = 21
	},
/obj/effect/decal/cleanable/dirt,
/turf/open/floor/strata/cyan1,
/area/atlan/station/medical/morgue)
"e" = (
/obj/effect/decal/cleanable/blood/splatter,
/turf/open/floor/strata/multi_tiles/southwest,
/area/atlan/station/medical/morgue)
"f" = (
/obj/structure/machinery/light/double/blue{
	dir = 1
	},
/turf/open/floor/strata/cyan1,
/area/atlan/station/medical/morgue)
"h" = (
/turf/open/floor/strata/cyan1,
/area/atlan/station/medical/morgue)
"i" = (
/obj/structure/closet/bodybag,
/obj/effect/decal/cleanable/blood/gibs/down,
/turf/open/floor/strata/multi_tiles/southwest,
/area/atlan/station/medical/morgue)
"j" = (
/obj/structure/sign/poster/upp{
	pixel_y = 33
	},
/turf/open/floor/strata/multi_tiles/southwest,
/area/atlan/station/medical/morgue)
"k" = (
/obj/effect/decal/cleanable/dirt,
/turf/open/floor/strata/multi_tiles/southwest,
/area/atlan/station/medical/morgue)
"l" = (
/obj/structure/closet/bodybag,
/obj/effect/decal/cleanable/blood/gibs/limb,
/turf/open/floor/strata/multi_tiles/southwest,
/area/atlan/station/medical/morgue)
"m" = (
/obj/structure/machinery/door/airlock/prison_hatch/alt/autoname,
/turf/open/floor/strata/multi_tiles/west,
/area/atlan/station/medical/morgue)
"n" = (
/turf/closed/wall/upp_ship/grey/teal,
/area/atlan/station/medical/morgue)
"o" = (
/obj/structure/prop/hybrisa/misc/buildinggreebliessmall/smallvent3,
/turf/closed/wall/upp_ship/grey/teal,
/area/atlan/station/medical/morgue)
"p" = (
/obj/structure/morgue,
/turf/open/floor/strata/cyan1/east,
/area/atlan/station/medical/morgue)
"q" = (
/obj/structure/sign/nosmoking_1{
	pixel_x = -4;
	pixel_y = 32
	},
/obj/structure/platform_decoration/metal/strata/west,
/turf/open/floor/strata/cyan1,
/area/atlan/station/medical/morgue)
"s" = (
/obj/structure/closet/bodybag{
	icon_state = "bodybag_open"
	},
/obj/effect/decal/cleanable/blood,
/obj/effect/landmark/corpsespawner/colonist/random/burst,
/turf/open/floor/strata/multi_tiles/southwest,
/area/atlan/station/medical/morgue)
"t" = (
/obj/structure/machinery/light/small{
	dir = 4
	},
/obj/structure/closet/bodybag,
/obj/effect/decal/cleanable/blood/gibs,
/obj/effect/landmark/corpsespawner/colonist/random,
/turf/open/floor/strata/multi_tiles/southwest,
/area/atlan/station/medical/morgue)
"u" = (
/obj/structure/closet/bodybag,
/turf/open/floor/strata/multi_tiles/southwest,
/area/atlan/station/medical/morgue)
"v" = (
/obj/structure/machinery/light/small{
	dir = 8
	},
/obj/structure/closet/bodybag,
/obj/effect/decal/cleanable/blood/splatter,
/turf/open/floor/strata/multi_tiles/southwest,
/area/atlan/station/medical/morgue)
"w" = (
/obj/structure/closet/bodybag{
	icon_state = "bodybag_open"
	},
/obj/effect/decal/cleanable/blood,
/obj/effect/decal/cleanable/blood/gibs/core,
/obj/effect/landmark/corpsespawner/colonist/random/burst,
/turf/open/floor/strata/multi_tiles/southwest,
/area/atlan/station/medical/morgue)
"x" = (
/obj/structure/morgue{
	dir = 8
	},
/turf/open/floor/strata/cyan1/east,
/area/atlan/station/medical/morgue)
"y" = (
/obj/effect/decal/cleanable/dirt,
/obj/structure/machinery/camera/autoname,
/turf/open/floor/strata/cyan1,
/area/atlan/station/medical/morgue)
"z" = (
/obj/structure/machinery/door/airlock/hybrisa/medical_solid/autoname{
	dir = 2
	},
/turf/open/floor/strata/multi_tiles/southeast,
/area/atlan/station/medical/morgue)
"A" = (
/obj/effect/decal/cleanable/dirt/alt_dirt{
	color = "#140400"
	},
/turf/open/floor/strata/multi_tiles/southwest,
/area/atlan/station/medical/morgue)
"B" = (
/obj/structure/surface/table/reinforced/prison{
	color = "#98a3ab"
	},
/obj/item/storage/box/gloves,
/obj/item/tool/surgery/FixOVein{
	pixel_x = -4;
	pixel_y = 2
	},
/turf/open/floor/strata/multi_tiles/southwest,
/area/atlan/station/medical/morgue)
"D" = (
/obj/structure/machinery/light/small{
	dir = 4
	},
/obj/item/bodybag,
/turf/open/floor/strata/multi_tiles/southwest,
/area/atlan/station/medical/morgue)
"E" = (
/turf/open/floor/strata/multi_tiles/southwest,
/area/atlan/station/medical/morgue)
"G" = (
/obj/effect/landmark/nightmare{
	insert_tag = "morgue"
	},
/turf/closed/wall/upp_ship/grey/teal,
/area/atlan/station/medical/morgue)
"H" = (
/obj/structure/curtain/colorable_transparent{
	color = "#22282c";
	alpha = 235
	},
/turf/open/floor/strata/multi_tiles/west,
/area/atlan/station/medical/morgue)
"I" = (
/obj/structure/morgue,
/obj/effect/decal/cleanable/dirt,
/turf/open/floor/strata/cyan1/east,
/area/atlan/station/medical/morgue)
"K" = (
/obj/structure/sign/safety/medical,
/turf/closed/wall/upp_ship/grey/teal,
/area/atlan/station/medical/morgue)
"L" = (
/obj/structure/sign/safety/biohazard,
/obj/structure/sign/safety/biolab{
	pixel_x = 13
	},
/turf/closed/wall/upp_ship/grey/teal,
/area/atlan/station/medical/morgue)
"M" = (
/obj/structure/flora/pottedplant{
	icon_state = "pottedplant_22";
	pixel_y = 2;
	pixel_x = -8
	},
/turf/open/floor/strata/multi_tiles/southwest,
/area/atlan/station/medical/morgue)
"P" = (
/obj/structure/closet/bodybag,
/obj/effect/decal/cleanable/blood,
/obj/effect/decal/cleanable/blood/gibs/body,
/turf/open/floor/strata/multi_tiles/southwest,
/area/atlan/station/medical/morgue)
"Q" = (
/obj/structure/machinery/door/airlock/prison_hatch/alt/autoname{
	dir = 2
	},
/turf/open/floor/strata/multi_tiles/southeast,
/area/atlan/station/medical/morgue)
"S" = (
/obj/effect/decal/cleanable/blood,
/turf/open/floor/strata/multi_tiles/southwest,
/area/atlan/station/medical/morgue)
"T" = (
/obj/structure/stairs/perspective{
	color = "#6e6e6e";
	icon_state = "p_stair_ew_full_cap";
	layer = 3.5
	},
/obj/structure/platform/metal/stair_cut/strata_right,
/turf/open/floor/strata/multi_tiles/west,
/area/atlan/station/medical/morgue)
"X" = (
/obj/effect/decal/cleanable/dirt/alt_dirt{
	color = "#140400"
	},
/obj/structure/machinery/light/small{
	dir = 8
	},
/obj/structure/closet/bodybag,
/obj/effect/decal/cleanable/blood,
/obj/effect/decal/cleanable/blood/gibs,
/turf/open/floor/strata/multi_tiles/southwest,
/area/atlan/station/medical/morgue)

(1,1,1) = {"
n
n
K
m
n
n
n
n
n
G
"}
(2,1,1) = {"
n
M
X
E
i
w
v
s
o
a
"}
(3,1,1) = {"
n
j
S
S
E
e
E
E
n
d
"}
(4,1,1) = {"
n
A
x
x
x
x
x
E
z
h
"}
(5,1,1) = {"
n
E
p
I
I
p
p
E
n
f
"}
(6,1,1) = {"
K
P
k
k
l
E
E
u
n
q
"}
(7,1,1) = {"
Q
E
t
E
E
S
D
B
n
T
"}
(8,1,1) = {"
n
n
L
H
H
H
n
n
n
y
"}
