//MAP CONVERTED BY dmm2tgm.py THIS HEADER COMMENT PREVENTS RECONVERSION, DO NOT REMOVE
"a" = (
/obj/effect/decal/warning_stripes{
	icon_state = "E";
	pixel_y = 1
	},
/turf/open/floor/strata/multi_tiles/west,
/area/atlan/asteroid/processing_caves)
"b" = (
/obj/item/ammo_casing{
	dir = 8;
	icon_state = "casing_6"
	},
/turf/open/floor/strata/floor2,
/area/atlan/asteroid/processing_caves)
"c" = (
/obj/structure/monorail{
	name = "launch track"
	},
/turf/open/floor/plating/prison,
/area/atlan/asteroid/processing_aux)
"d" = (
/obj/item/frame/rack,
/turf/open/floor/strata/floor2,
/area/atlan/asteroid/processing_caves)
"g" = (
/obj/effect/decal/warning_stripes{
	icon_state = "W";
	pixel_y = 1
	},
/obj/effect/landmark/structure_spawner/setup/distress/xeno_weed_node,
/turf/open/floor/strata/multi_tiles/west,
/area/atlan/asteroid/processing_aux)
"h" = (
/obj/structure/monorail{
	dir = 4;
	name = "launch track"
	},
/turf/open/floor/plating/prison,
/area/atlan/asteroid/processing_caves)
"k" = (
/turf/open/floor/strata/floor2,
/area/atlan/asteroid/processing_caves)
"l" = (
/obj/effect/decal/cleanable/blood,
/turf/open/floor/strata/multi_tiles,
/area/atlan/asteroid/processing_caves)
"m" = (
/obj/effect/decal/warning_stripes{
	icon_state = "W";
	pixel_y = 1
	},
/turf/open/floor/strata/multi_tiles/west,
/area/atlan/asteroid/processing_caves)
"n" = (
/turf/closed/wall/rock/brown,
/area/atlan/oob)
"o" = (
/obj/effect/decal/warning_stripes{
	icon_state = "S";
	pixel_x = -1
	},
/turf/open/floor/strata/multi_tiles/southeast,
/area/atlan/asteroid/processing_caves)
"r" = (
/obj/effect/decal/cleanable/dirt,
/obj/effect/landmark/structure_spawner/setup/distress/xeno_weed_node,
/turf/open/floor/strata/floor2,
/area/atlan/asteroid/processing_caves)
"v" = (
/obj/effect/decal/cleanable/blood,
/obj/effect/landmark/corpsespawner/colonist/random,
/obj/item/weapon/gun/rifle/type71/flamer,
/turf/open/floor/strata/floor2,
/area/atlan/asteroid/processing_caves)
"x" = (
/obj/effect/decal/warning_stripes{
	icon_state = "S";
	pixel_x = -1
	},
/obj/effect/decal/cleanable/blood/xeno,
/obj/effect/decal/cleanable/blood/xeno{
	icon_state = "xgib1"
	},
/obj/effect/spawner/gibspawner/xeno,
/turf/open/floor/strata/multi_tiles/southeast,
/area/atlan/asteroid/processing_caves)
"C" = (
/obj/effect/decal/warning_stripes{
	icon_state = "S";
	pixel_x = -1
	},
/obj/item/ammo_casing{
	icon_state = "casing_6_1"
	},
/obj/effect/landmark/structure_spawner/setup/distress/xeno_weed_node,
/turf/open/floor/strata/multi_tiles/southeast,
/area/atlan/asteroid/processing_caves)
"F" = (
/obj/effect/decal/cleanable/blood/xeno{
	icon_state = "xgib5"
	},
/obj/effect/spawner/gibspawner/xeno,
/obj/effect/decal/cleanable/blood/xeno{
	pixel_x = -2;
	pixel_y = -4
	},
/turf/open/floor/plating/prison,
/area/atlan/asteroid/processing_caves)
"G" = (
/turf/closed/wall/mineral/bone_resin,
/area/atlan/oob)
"H" = (
/obj/effect/decal/cleanable/blood/xeno{
	icon_state = "xgib5"
	},
/obj/effect/spawner/gibspawner/xeno,
/obj/effect/decal/cleanable/blood/xeno,
/turf/open/floor/strata/floor3/east,
/area/atlan/asteroid/processing_caves)
"I" = (
/obj/item/ammo_casing{
	icon_state = "casing_5"
	},
/obj/item/ammo_casing{
	icon_state = "casing_1"
	},
/obj/item/ammo_casing{
	icon_state = "casing_10_1"
	},
/turf/open/floor/plating,
/area/atlan/asteroid/processing_caves)
"J" = (
/obj/structure/monorail{
	dir = 10;
	name = "launch track"
	},
/turf/open/floor/plating/prison,
/area/atlan/asteroid/processing_caves)
"K" = (
/obj/effect/decal/cleanable/dirt,
/obj/effect/decal/cleanable/blood/xeno{
	icon_state = "xgib5"
	},
/turf/open/floor/plating,
/area/atlan/asteroid/processing_caves)
"L" = (
/obj/effect/decal/warning_stripes{
	icon_state = "W";
	pixel_y = 1
	},
/obj/effect/decal/cleanable/blood/xeno{
	icon_state = "xgib5"
	},
/obj/effect/spawner/gibspawner/xeno,
/obj/effect/decal/cleanable/blood/xeno,
/turf/open/floor/strata/multi_tiles/west,
/area/atlan/asteroid/processing_caves)
"M" = (
/obj/structure/monorail{
	name = "launch track"
	},
/turf/open/floor/plating/prison,
/area/atlan/asteroid/processing_caves)
"N" = (
/obj/structure/machinery/light/double/blue{
	dir = 1
	},
/turf/open/floor/strata/floor2,
/area/atlan/asteroid/processing_caves)
"R" = (
/turf/open/floor/plating/prison,
/area/atlan/asteroid/processing_caves)
"S" = (
/obj/effect/landmark/structure_spawner/spore_sac_rng,
/turf/open/floor/plating/prison,
/area/atlan/asteroid/processing_caves)
"T" = (
/turf/open/floor/strata/floor3/east,
/area/atlan/asteroid/processing_caves)
"U" = (
/turf/open/floor/strata/multi_tiles,
/area/atlan/asteroid/processing_caves)
"Y" = (
/obj/structure/monorail{
	dir = 6;
	name = "launch track"
	},
/obj/effect/decal/cleanable/blood/xeno{
	icon_state = "xgib5"
	},
/obj/effect/spawner/gibspawner/xeno,
/turf/open/floor/plating/prison,
/area/atlan/asteroid/processing_caves)

(1,1,1) = {"
G
k
k
K
r
k
G
"}
(2,1,1) = {"
d
T
k
b
H
k
G
"}
(3,1,1) = {"
G
I
l
a
a
a
a
"}
(4,1,1) = {"
n
v
C
Y
M
M
M
"}
(5,1,1) = {"
n
N
x
h
S
R
F
"}
(6,1,1) = {"
n
k
o
J
M
M
c
"}
(7,1,1) = {"
n
G
U
L
m
m
g
"}
