//MAP CONVERTED BY dmm2tgm.py THIS HEADER COMMENT PREVENTS RECONVERSION, DO NOT REMOVE
"au" = (
/turf/open/floor/strata/orange_edge/southwest,
/area/atlan/station/storage)
"aw" = (
/obj/effect/decal/cleanable/blood/splatter{
	icon_state = "gibdown1"
	},
/obj/effect/decal/cleanable/blood/gibs/body,
/obj/effect/decal/cleanable/blood/gibs/limb,
/obj/structure/barricade/wooden{
	dir = 4;
	pixel_y = 2
	},
/turf/open/floor/strata/floor3/east,
/area/atlan/station/storage)
"ds" = (
/obj/effect/decal/cleanable/blood,
/obj/effect/decal/cleanable/blood/gibs/core,
/turf/open/floor/strata/orange_edge/east,
/area/atlan/station/storage)
"eE" = (
/obj/structure/barricade/wooden,
/turf/open/floor/strata/floor3/east,
/area/atlan/station/storage)
"fl" = (
/obj/effect/decal/cleanable/blood/gibs/xeno/down,
/obj/effect/decal/cleanable/blood/xeno,
/obj/effect/decal/cleanable/blood/xeno{
	pixel_x = -2;
	pixel_y = -4
	},
/obj/effect/spawner/gibspawner/xeno,
/turf/open/floor/strata/orange_edge/west,
/area/atlan/station/storage)
"fv" = (
/obj/structure/flag/plantable/upp,
/obj/effect/decal/cleanable/dirt,
/turf/open/floor/strata/floor3/east,
/area/atlan/station/storage)
"hI" = (
/obj/effect/decal/cleanable/blood/gibs/xeno/body,
/turf/open/floor/strata/floor2,
/area/atlan/station/storage)
"jh" = (
/obj/effect/decal/cleanable/blood/xeno{
	icon_state = "xgib5"
	},
/obj/effect/spawner/gibspawner/xeno,
/turf/open/floor/strata/floor2,
/area/atlan/station/storage)
"jr" = (
/turf/open/floor/strata/orange_edge/west,
/area/atlan/station/storage)
"jN" = (
/obj/effect/decal/cleanable/blood,
/obj/effect/decal/cleanable/blood/gibs,
/obj/effect/landmark/corpsespawner/colonist/random,
/turf/open/floor/strata/floor2,
/area/atlan/station/storage)
"oJ" = (
/obj/structure/surface/table/woodentable/poor,
/obj/item/weapon/gun/rifle/ak4047,
/obj/effect/decal/cleanable/dirt,
/turf/open/floor/strata/orange_edge/east,
/area/atlan/station/storage)
"rF" = (
/obj/structure/surface/rack{
	color = "#98a3ab"
	},
/obj/item/ammo_magazine/rifle/ak4047,
/obj/item/ammo_magazine/rifle/ak4047,
/turf/open/floor/strata/floor3/east,
/area/atlan/station/storage)
"rV" = (
/turf/open/floor/strata/orange_edge/east,
/area/atlan/station/storage)
"sz" = (
/obj/effect/landmark/item_pool_spawner/survivor_ammo/buckshot,
/turf/open/floor/strata/floor2,
/area/atlan/station/storage)
"sO" = (
/turf/open/floor/strata/floor2,
/area/atlan/station/storage)
"tq" = (
/obj/structure/barricade/wooden,
/turf/open/floor/strata/floor2,
/area/atlan/station/storage)
"uQ" = (
/obj/structure/cargo_container/upp/mk6/left,
/turf/open/floor/strata/orange_edge/east,
/area/atlan/station/storage)
"uT" = (
/obj/effect/decal/cleanable/dirt,
/obj/structure/largecrate/empty/secure,
/turf/open/floor/strata/orange_edge/west,
/area/atlan/station/storage)
"vW" = (
/obj/effect/decal/cleanable/dirt,
/obj/item/storage/box/mre/upp{
	pixel_x = -1;
	pixel_y = 7
	},
/turf/open/floor/strata/floor3/east,
/area/atlan/station/storage)
"wl" = (
/obj/structure/cargo_container/hybrisa/containersextended/blueright,
/turf/open/floor/strata/floor3/east,
/area/atlan/station/storage)
"wS" = (
/obj/structure/cargo_container/upp_small/container_6/left,
/turf/open/floor/strata/floor3/east,
/area/atlan/station/storage)
"xv" = (
/obj/structure/cargo_container/upp_small/container_19/right,
/turf/open/floor/strata/orange_edge/east,
/area/atlan/station/storage)
"zk" = (
/obj/effect/decal/cleanable/dirt,
/turf/open/floor/strata/orange_edge/east,
/area/atlan/station/storage)
"zI" = (
/obj/effect/decal/cleanable/dirt,
/obj/structure/cargo_container/hybrisa/containersextended/blueleft,
/turf/open/floor/strata/floor3/east,
/area/atlan/station/storage)
"Bz" = (
/turf/open/floor/strata/orange_edge/southeast,
/area/atlan/station/storage)
"BD" = (
/obj/structure/cargo_container/upp_small/container_19/left,
/turf/open/floor/strata/floor2,
/area/atlan/station/storage)
"Cn" = (
/obj/structure/barricade/wooden{
	dir = 1;
	pixel_y = 7
	},
/turf/open/floor/strata/orange_edge/west,
/area/atlan/station/storage)
"DO" = (
/obj/effect/decal/cleanable/dirt,
/obj/item/device/flashlight/lamp/tripod,
/turf/open/floor/strata/floor3/east,
/area/atlan/station/storage)
"EY" = (
/obj/effect/decal/cleanable/dirt,
/turf/open/floor/strata/orange_edge/west,
/area/atlan/station/storage)
"Ft" = (
/turf/open/floor/strata/orange_edge/northwest,
/area/atlan/station/storage)
"Hk" = (
/obj/structure/barricade/wooden{
	dir = 4;
	pixel_y = 2
	},
/obj/structure/barricade/wooden,
/turf/open/floor/strata/floor3/east,
/area/atlan/station/storage)
"Hl" = (
/obj/effect/decal/cleanable/dirt,
/turf/open/floor/strata/floor2,
/area/atlan/station/storage)
"HE" = (
/obj/effect/decal/cleanable/blood,
/turf/open/floor/strata/floor2,
/area/atlan/station/storage)
"HH" = (
/turf/open/floor/strata/orange_edge,
/area/atlan/station/storage)
"IN" = (
/obj/structure/largecrate/random,
/turf/open/floor/strata/floor3/east,
/area/atlan/station/storage)
"KC" = (
/obj/effect/decal/cleanable/blood/gibs/xeno/body,
/obj/effect/decal/cleanable/blood/gibs/xeno/limb,
/obj/effect/spawner/gibspawner/xeno,
/turf/open/floor/strata/floor3/east,
/area/atlan/station/storage)
"KK" = (
/obj/effect/decal/cleanable/dirt,
/turf/open/floor/strata/floor3/east,
/area/atlan/station/storage)
"Lp" = (
/obj/effect/decal/strata_decals/grime/grime4,
/obj/structure/largecrate/random,
/turf/open/floor/plating,
/area/atlan/station/storage)
"Lt" = (
/obj/effect/decal/cleanable/blood,
/obj/item/attachable/bayonet/upp,
/turf/open/floor/strata/floor3/east,
/area/atlan/station/storage)
"LY" = (
/obj/effect/landmark/item_pool_spawner/survivor_ammo/buckshot,
/turf/open/floor/strata/floor3/east,
/area/atlan/station/storage)
"MM" = (
/turf/open/floor/strata/floor3/east,
/area/atlan/station/storage)
"NN" = (
/obj/structure/largecrate/random,
/turf/open/floor/strata/orange_edge/west,
/area/atlan/station/storage)
"Py" = (
/obj/structure/cargo_container/upp_small/container_6/right,
/turf/open/floor/strata/floor3/east,
/area/atlan/station/storage)
"PM" = (
/obj/structure/barricade/wooden,
/obj/effect/decal/cleanable/dirt,
/turf/open/floor/strata/floor2,
/area/atlan/station/storage)
"Qs" = (
/obj/structure/cargo_container/upp/mk6/right,
/turf/open/floor/strata/floor3/east,
/area/atlan/station/storage)
"QY" = (
/obj/effect/decal/cleanable/dirt,
/obj/structure/cargo_container/upp/mk6/mid,
/turf/open/floor/strata/floor3/east,
/area/atlan/station/storage)
"Rg" = (
/obj/effect/decal/cleanable/dirt,
/obj/structure/largecrate/random/barrel/true_random,
/turf/open/floor/strata/floor3/east,
/area/atlan/station/storage)
"Sb" = (
/obj/effect/decal/cleanable/blood/drip,
/obj/effect/decal/cleanable/blood/drip{
	pixel_x = -8;
	pixel_y = 4
	},
/obj/effect/decal/cleanable/blood,
/obj/item/weapon/gun/smg/pps43,
/turf/open/floor/strata/floor3/east,
/area/atlan/station/storage)
"Tt" = (
/obj/effect/decal/cleanable/blood/gibs/xeno/body,
/obj/effect/decal/cleanable/blood/xeno{
	icon_state = "xgibleg"
	},
/obj/effect/decal/cleanable/dirt,
/turf/open/floor/strata/floor3/east,
/area/atlan/station/storage)
"TF" = (
/obj/effect/decal/cleanable/dirt/alt_dirt,
/turf/open/floor/strata/floor2,
/area/atlan/station/storage)
"UQ" = (
/obj/effect/decal/cleanable/blood/gibs/up,
/turf/open/floor/strata/floor3/east,
/area/atlan/station/storage)
"UZ" = (
/obj/item/stack/sheet/wood,
/turf/open/floor/strata/floor3/east,
/area/atlan/station/storage)
"Vl" = (
/obj/structure/largecrate/random/barrel/true_random,
/turf/open/floor/strata/floor3/east,
/area/atlan/station/storage)
"VU" = (
/obj/effect/decal/cleanable/blood/gibs/xeno/limb,
/obj/effect/decal/cleanable/blood/xeno,
/obj/effect/decal/cleanable/blood/xeno{
	icon_state = "xgib5"
	},
/obj/effect/spawner/gibspawner/xeno,
/turf/open/floor/strata/orange_edge/east,
/area/atlan/station/storage)
"Xv" = (
/obj/structure/largecrate/random,
/turf/open/floor/strata/floor2,
/area/atlan/station/storage)
"Xx" = (
/obj/structure/barricade/wooden{
	dir = 1;
	pixel_y = 7
	},
/obj/structure/barricade/wooden{
	dir = 8
	},
/turf/open/floor/plating/plating_catwalk/strata,
/area/atlan/station/storage)

(1,1,1) = {"
MM
au
jr
Cn
jr
jr
Ft
TF
au
jr
"}
(2,1,1) = {"
sO
sO
Hl
HE
sz
PM
hI
sO
sO
sO
"}
(3,1,1) = {"
Hl
Xv
Xx
jN
sO
tq
BD
sO
Lp
jh
"}
(4,1,1) = {"
Bz
rV
uQ
oJ
ds
rV
xv
VU
zk
rV
"}
(5,1,1) = {"
HH
MM
QY
rF
DO
LY
eE
Rg
MM
IN
"}
(6,1,1) = {"
HH
KK
Qs
zI
IN
fv
UQ
wS
KC
MM
"}
(7,1,1) = {"
HH
MM
Vl
wl
UZ
Sb
vW
Py
Vl
MM
"}
(8,1,1) = {"
HH
MM
Tt
UZ
Lt
aw
Hk
IN
MM
KK
"}
(9,1,1) = {"
au
EY
jr
fl
jr
NN
uT
jr
jr
jr
"}
