//MAP CONVERTED BY dmm2tgm.py THIS HEADER COMMENT PREVENTS RECONVERSION, DO NOT REMOVE
"a" = (
/turf/open/space/basic,
/area/space)
"b" = (
/turf/closed/wall,
/area/misc/moba)
"c" = (
/turf/open/floor/almayer,
/area/misc/moba)
"d" = (
/turf/open/floor/plating,
/area/misc/moba)
"e" = (
/turf/open/floor/almayer/bluefull2,
/area/misc/moba)
"j" = (
/obj/effect/alien/resin/moba_turret/left,
/turf/open/floor/almayer,
/area/misc/moba)
"q" = (
/obj/effect/alien/resin/moba_turret/right,
/turf/open/floor/almayer,
/area/misc/moba)
"u" = (
/turf/open/floor/almayer/redfull,
/area/misc/moba)
"v" = (
/turf/open/floor/almayer/aicore,
/area/misc/moba)
"y" = (
/turf/open/floor/almayer/greenfull,
/area/misc/moba)
"z" = (
/obj/effect/moba_camp_spawner,
/turf/open/floor/almayer/greenfull,
/area/misc/moba)
"A" = (
/obj/effect/landmark/moba_tunnel_spawner,
/turf/open/floor/almayer/emeraldfull,
/area/misc/moba)
"C" = (
/turf/open/floor,
/area/misc/moba)
"D" = (
/obj/effect/landmark/moba_base,
/turf/open/floor,
/area/misc/moba)
"P" = (
/obj/effect/landmark/moba_base{
	right_side = 1
	},
/turf/open/floor,
/area/misc/moba)
"Z" = (
/turf/open/floor/almayer/orangefull,
/area/misc/moba)

(1,1,1) = {"
a
a
a
a
a
a
a
a
a
a
a
a
a
a
a
a
a
a
a
a
a
b
b
b
b
b
b
b
b
b
b
b
b
b
a
a
a
a
a
a
a
a
a
a
a
a
a
a
a
a
a
a
a
a
a
"}
(2,1,1) = {"
a
a
a
a
a
a
a
a
a
a
a
a
a
a
a
a
a
a
a
a
b
b
C
C
C
C
C
C
C
C
C
C
C
b
b
a
a
a
a
a
a
a
a
a
a
a
a
a
a
a
a
a
a
a
a
"}
(3,1,1) = {"
a
a
a
a
a
a
a
a
a
a
a
a
a
a
a
a
a
a
a
b
b
C
C
C
C
C
C
D
C
C
C
C
C
C
b
b
a
a
a
a
a
a
a
a
a
a
a
a
a
a
a
a
a
a
a
"}
(4,1,1) = {"
a
a
a
a
a
a
a
a
a
a
a
a
a
a
a
a
a
a
b
b
C
C
C
C
C
C
C
C
C
C
C
C
C
C
C
b
b
a
a
a
a
a
a
a
a
a
a
a
a
a
a
a
a
a
a
"}
(5,1,1) = {"
a
a
a
a
a
a
a
a
a
a
a
a
a
a
a
a
a
a
b
C
C
C
C
C
C
C
C
C
C
C
C
C
C
C
C
C
b
a
a
a
a
a
a
a
a
a
a
a
a
a
a
a
a
a
a
"}
(6,1,1) = {"
a
a
a
a
a
a
a
a
a
a
a
a
a
a
a
a
a
a
b
C
C
C
C
C
C
C
C
C
C
C
C
C
C
C
C
C
b
a
a
a
a
a
a
a
a
a
a
a
a
a
a
a
a
a
a
"}
(7,1,1) = {"
a
a
a
a
a
a
a
a
a
a
a
a
a
a
a
a
a
a
b
C
C
C
C
C
C
C
C
C
C
C
C
C
C
C
C
C
b
a
a
a
a
a
a
a
a
a
a
a
a
a
a
a
a
a
a
"}
(8,1,1) = {"
a
a
a
a
a
a
a
a
a
a
a
a
a
a
a
a
a
a
b
C
C
C
C
C
C
C
C
C
C
C
C
C
C
C
C
C
b
a
a
a
a
a
a
a
a
a
a
a
a
a
a
a
a
a
a
"}
(9,1,1) = {"
a
a
a
a
a
a
a
a
a
a
a
a
a
a
a
a
a
a
b
C
C
C
C
C
C
C
C
C
C
C
C
C
C
C
C
C
b
a
a
a
a
a
a
a
a
a
a
a
a
a
a
a
a
a
a
"}
(10,1,1) = {"
a
a
a
a
a
a
a
a
a
a
a
a
a
a
a
a
a
a
b
C
C
C
C
C
C
C
C
C
C
C
C
C
C
C
C
C
b
a
a
a
a
a
a
a
a
a
a
a
a
a
a
a
a
a
a
"}
(11,1,1) = {"
a
a
a
a
a
a
a
a
a
a
a
a
a
a
a
a
a
a
b
C
C
C
C
C
C
C
C
C
C
C
C
C
C
C
C
C
b
a
a
a
a
a
a
a
a
a
a
a
a
a
a
a
a
a
a
"}
(12,1,1) = {"
a
a
a
a
a
a
a
a
a
a
a
a
a
a
a
a
a
a
b
C
C
C
C
C
C
C
C
C
C
C
C
C
C
C
C
C
b
a
a
a
a
a
a
a
a
a
a
a
a
a
a
a
a
a
a
"}
(13,1,1) = {"
a
a
a
a
a
a
a
a
a
a
a
a
a
a
a
a
a
b
b
C
C
C
C
C
C
C
C
C
C
C
C
C
C
C
C
C
b
b
a
a
a
a
a
a
a
a
a
a
a
a
a
a
a
a
a
"}
(14,1,1) = {"
a
a
a
a
a
a
a
a
a
a
a
a
a
a
a
a
b
b
C
C
C
C
C
C
C
C
C
C
C
C
C
C
C
C
C
C
C
b
b
a
a
a
a
a
a
a
a
a
a
a
a
a
a
a
a
"}
(15,1,1) = {"
a
a
a
a
a
a
a
a
a
a
a
a
a
a
a
b
b
C
C
C
C
C
C
C
C
C
C
C
C
C
C
C
C
C
C
C
C
C
b
b
a
a
a
a
a
a
a
a
a
a
a
a
a
a
a
"}
(16,1,1) = {"
a
a
a
a
a
a
a
a
a
a
a
a
a
a
b
b
C
C
C
C
C
C
C
C
C
C
C
C
C
C
C
C
C
C
C
C
C
C
C
b
b
a
a
a
a
a
a
a
a
a
a
a
a
a
a
"}
(17,1,1) = {"
a
a
a
a
a
a
a
a
a
a
a
a
a
b
b
c
C
C
C
C
C
C
C
C
C
C
C
C
C
C
C
C
C
C
C
C
C
C
C
c
b
b
a
a
a
a
a
a
a
a
a
a
a
a
a
"}
(18,1,1) = {"
a
a
a
a
a
a
a
a
a
a
a
a
b
b
c
c
C
C
C
C
C
C
C
C
C
C
C
C
C
C
C
C
C
C
C
C
C
C
C
c
c
b
b
a
a
a
a
a
a
a
a
a
a
a
a
"}
(19,1,1) = {"
a
a
a
a
a
a
a
a
a
a
a
b
b
c
c
c
C
C
C
C
C
C
C
C
b
b
b
b
b
b
b
C
C
C
C
C
C
C
C
c
c
c
b
b
a
a
a
a
a
a
a
a
a
a
a
"}
(20,1,1) = {"
a
a
a
a
a
a
a
a
a
a
b
b
c
c
c
c
C
C
C
C
C
C
C
b
b
d
d
d
d
d
b
b
C
C
C
C
C
C
C
c
c
c
c
b
b
a
a
a
a
a
a
a
a
a
a
"}
(21,1,1) = {"
a
a
a
a
a
a
a
a
a
b
b
c
c
c
c
c
c
C
C
C
C
C
b
b
d
d
d
d
d
d
d
b
b
C
C
C
C
C
c
c
c
c
c
c
b
b
a
a
a
a
a
a
a
a
a
"}
(22,1,1) = {"
a
a
a
a
a
a
a
a
b
b
c
c
c
c
c
c
c
c
c
c
c
b
b
d
d
d
y
y
y
d
d
d
b
b
c
c
c
c
c
c
c
c
c
c
c
b
b
a
a
a
a
a
a
a
a
"}
(23,1,1) = {"
a
a
a
a
a
a
a
b
b
c
c
c
c
c
c
c
c
c
c
c
b
b
d
d
d
d
y
z
y
d
d
d
d
b
b
c
c
c
c
c
c
c
c
c
c
c
b
b
a
a
a
a
a
a
a
"}
(24,1,1) = {"
a
a
a
a
a
a
b
b
c
c
c
c
c
c
c
c
c
c
c
b
b
d
u
d
d
d
d
d
d
d
d
d
u
d
b
b
c
c
c
c
c
c
c
c
c
c
c
b
b
a
a
a
a
a
a
"}
(25,1,1) = {"
a
a
a
a
a
b
b
c
c
c
c
c
c
c
c
c
c
c
b
b
d
d
d
u
d
d
d
d
d
d
d
u
d
d
d
b
b
c
c
c
c
c
c
c
c
c
c
c
b
b
a
a
a
a
a
"}
(26,1,1) = {"
a
a
a
a
b
b
c
c
c
c
c
c
c
c
c
c
c
b
b
d
d
d
d
d
d
d
d
d
d
d
d
d
d
d
d
d
b
b
c
c
c
c
c
c
c
c
c
c
c
b
b
a
a
a
a
"}
(27,1,1) = {"
a
a
a
b
b
c
c
c
c
c
c
c
c
c
c
c
b
b
d
d
d
d
d
d
d
d
v
d
d
v
d
d
d
d
d
d
d
b
b
c
c
c
c
c
c
c
c
c
c
c
b
b
a
a
a
"}
(28,1,1) = {"
a
a
b
b
c
c
c
c
c
c
c
c
c
c
c
b
b
d
d
d
d
d
d
d
d
d
d
d
d
d
d
d
d
d
d
d
d
d
b
b
c
c
c
c
c
c
c
c
c
c
c
b
b
a
a
"}
(29,1,1) = {"
a
b
b
c
c
c
c
c
c
c
c
c
c
c
b
b
d
d
d
d
d
d
d
d
v
d
d
d
d
d
d
d
d
d
d
d
d
d
d
b
b
c
c
c
c
c
c
c
c
c
c
c
b
b
a
"}
(30,1,1) = {"
b
b
c
c
c
c
c
c
c
c
c
c
c
d
b
d
d
d
d
d
d
d
v
d
d
d
d
d
d
d
d
d
d
d
d
d
d
d
d
d
b
d
c
c
c
c
c
c
c
c
c
c
c
b
b
"}
(31,1,1) = {"
b
c
c
c
c
c
c
c
c
c
c
c
d
d
d
d
d
d
d
d
d
d
d
d
d
d
d
d
d
d
v
d
d
d
d
d
d
d
d
d
d
d
d
c
c
c
c
c
c
c
c
c
c
c
b
"}
(32,1,1) = {"
b
c
c
c
c
c
c
c
c
c
c
b
d
d
d
d
d
d
d
d
v
d
d
d
d
d
d
d
d
d
d
d
d
d
d
d
d
d
d
d
d
v
d
b
c
c
c
c
c
c
c
c
c
c
b
"}
(33,1,1) = {"
b
c
c
c
c
c
c
c
c
c
b
b
d
d
v
d
d
d
d
d
d
d
d
d
d
d
d
d
d
d
d
d
d
d
d
d
d
d
d
d
d
d
d
b
b
c
c
c
c
c
c
c
c
c
b
"}
(34,1,1) = {"
b
c
c
c
c
c
c
c
c
b
b
d
d
d
d
d
d
d
v
d
d
d
d
d
d
d
d
d
d
d
d
d
v
d
d
d
d
d
d
v
d
d
d
d
b
b
c
c
c
c
c
c
c
c
b
"}
(35,1,1) = {"
b
c
c
c
c
c
c
c
b
b
d
d
d
d
d
d
v
d
d
d
d
d
d
d
d
d
d
d
d
d
d
d
d
d
d
v
d
d
d
d
d
d
d
d
d
b
b
c
c
c
c
c
c
c
b
"}
(36,1,1) = {"
b
c
c
c
c
c
c
c
b
d
d
d
d
d
d
d
d
d
d
d
d
d
d
d
d
d
d
d
d
d
d
d
d
d
d
d
d
d
d
d
d
d
d
d
d
d
b
c
c
c
c
c
c
c
b
"}
(37,1,1) = {"
b
c
c
c
c
c
c
c
b
d
d
d
d
d
d
d
d
d
d
d
d
d
d
d
d
d
d
d
d
d
d
d
v
d
d
d
d
d
d
d
d
d
d
d
d
d
b
c
c
c
c
c
c
c
b
"}
(38,1,1) = {"
b
c
c
c
c
c
c
c
b
d
d
d
d
d
d
d
d
d
d
d
d
d
d
d
d
u
u
u
u
u
d
d
d
d
d
d
d
d
d
d
v
d
d
d
d
d
b
c
c
c
c
c
c
c
b
"}
(39,1,1) = {"
b
c
c
c
c
c
c
c
b
d
y
y
d
d
d
d
v
d
d
d
d
d
d
d
d
d
d
d
d
u
d
d
d
d
d
d
d
d
d
d
d
d
d
d
d
d
b
c
c
c
c
c
c
c
b
"}
(40,1,1) = {"
b
c
c
c
c
c
c
c
b
d
y
z
d
d
d
d
d
d
d
v
d
d
v
d
d
d
d
d
d
u
d
d
v
d
d
d
d
d
d
d
d
d
d
d
d
d
b
c
c
c
c
c
c
c
b
"}
(41,1,1) = {"
b
c
c
c
c
c
c
c
b
d
y
y
d
d
d
d
d
d
d
d
d
d
d
v
d
v
d
A
d
u
d
d
d
d
d
d
d
d
d
d
d
d
d
d
d
d
b
c
c
c
c
c
c
c
b
"}
(42,1,1) = {"
b
c
c
c
c
c
c
c
b
d
d
d
d
d
d
v
d
d
d
d
d
d
d
d
d
d
d
d
d
u
d
d
d
d
d
d
d
d
d
d
d
d
d
d
d
d
b
c
c
c
c
c
c
c
b
"}
(43,1,1) = {"
b
c
c
c
c
c
c
c
b
d
d
d
d
d
d
d
d
d
d
d
d
d
d
d
d
d
d
d
d
u
d
d
v
d
d
d
d
d
d
d
d
v
d
d
d
d
b
c
c
c
c
c
c
c
b
"}
(44,1,1) = {"
b
c
c
c
c
c
c
c
b
d
d
d
d
d
d
d
d
d
d
d
d
d
d
d
d
u
u
u
u
u
d
d
d
d
d
d
d
d
d
d
d
d
d
d
d
d
b
c
c
c
c
c
c
c
b
"}
(45,1,1) = {"
b
c
c
c
c
c
c
c
b
d
d
d
d
d
v
d
d
d
d
d
d
d
d
d
d
d
d
d
d
d
d
v
d
d
d
d
d
d
d
d
d
d
u
u
u
d
b
c
c
c
c
c
c
c
b
"}
(46,1,1) = {"
b
c
c
c
c
c
c
c
b
u
u
u
u
d
d
d
d
d
d
d
d
d
d
d
d
d
d
d
d
d
d
d
d
d
d
d
d
d
d
d
d
d
d
d
u
d
b
c
c
c
c
c
c
c
b
"}
(47,1,1) = {"
b
c
c
c
c
c
c
c
b
u
d
d
d
d
d
d
d
d
d
d
d
d
d
d
d
d
d
d
d
d
d
d
d
d
v
d
d
d
d
d
d
d
y
y
u
d
b
c
c
c
c
c
c
c
b
"}
(48,1,1) = {"
b
c
c
c
c
c
c
c
b
u
d
d
d
d
d
d
d
d
d
d
d
d
d
d
d
d
d
d
v
d
d
d
d
d
d
d
d
d
d
v
d
d
y
y
u
d
b
c
c
c
c
c
c
c
b
"}
(49,1,1) = {"
b
c
c
c
c
c
c
c
b
u
d
A
d
v
d
d
d
d
d
d
d
d
d
d
d
d
d
d
d
d
d
d
u
d
d
d
d
d
d
d
d
d
y
y
u
d
b
c
c
c
c
c
c
c
b
"}
(50,1,1) = {"
b
c
c
c
c
c
c
c
b
u
d
d
d
d
d
d
d
d
d
d
d
d
d
d
d
d
d
v
d
y
y
d
d
u
d
d
d
d
d
d
d
d
d
d
u
d
b
c
c
c
c
c
c
c
b
"}
(51,1,1) = {"
b
c
c
c
c
c
c
c
b
u
d
d
d
d
d
d
d
d
d
d
d
d
d
d
d
d
d
d
d
y
y
d
d
d
u
d
d
v
d
d
d
u
u
u
u
d
b
c
c
c
c
c
c
c
b
"}
(52,1,1) = {"
b
c
c
c
c
c
c
c
b
u
u
u
u
d
d
v
d
d
d
d
d
d
d
d
d
d
v
d
d
y
y
d
d
u
d
d
d
d
d
d
d
d
d
d
d
d
b
c
c
c
c
c
c
c
b
"}
(53,1,1) = {"
b
c
c
c
c
c
c
c
b
d
d
d
d
d
d
d
d
d
v
d
d
d
d
d
d
d
d
d
d
d
d
d
u
d
d
d
d
d
d
d
d
d
d
d
d
d
b
c
c
c
c
c
c
c
b
"}
(54,1,1) = {"
b
c
c
c
c
c
c
c
b
d
d
d
d
d
d
d
d
d
d
d
v
d
d
d
d
v
d
u
d
d
d
u
d
d
d
d
d
d
d
d
d
d
d
d
d
d
b
c
c
c
c
c
c
c
b
"}
(55,1,1) = {"
b
c
c
c
c
c
c
c
b
d
d
d
d
d
d
d
v
d
d
d
d
d
d
v
d
d
d
d
u
d
u
d
d
d
d
d
v
d
d
d
d
d
d
d
d
d
b
c
c
c
c
c
c
c
b
"}
(56,1,1) = {"
b
c
c
c
c
c
c
c
d
d
d
d
d
d
d
d
d
d
d
u
u
u
u
d
d
v
d
d
d
u
d
d
d
d
d
d
d
d
d
d
d
d
d
d
d
d
d
c
c
c
c
c
c
c
b
"}
(57,1,1) = {"
b
c
c
c
c
c
c
c
d
d
v
d
v
d
v
d
d
d
d
d
d
d
u
d
d
d
d
d
d
d
d
d
d
d
d
d
d
d
d
d
d
d
d
d
d
d
d
c
c
c
c
c
c
c
b
"}
(58,1,1) = {"
b
c
c
c
c
c
c
c
d
d
d
d
d
d
d
d
d
v
d
y
y
d
u
d
d
d
d
d
d
d
d
d
d
d
d
d
v
d
d
d
d
d
d
d
d
v
d
c
c
c
c
c
c
c
b
"}
(59,1,1) = {"
b
c
c
c
c
c
c
c
b
d
d
d
d
d
d
d
d
d
d
z
y
d
u
d
d
d
d
d
d
d
d
d
d
d
d
d
d
u
u
u
u
d
d
d
d
d
b
c
c
c
c
c
c
c
b
"}
(60,1,1) = {"
b
c
c
c
c
c
c
c
b
d
d
d
d
d
d
d
d
d
d
y
y
d
u
d
d
d
d
v
d
d
d
d
d
d
d
d
d
d
d
d
u
d
d
d
d
d
b
c
c
c
c
c
c
c
b
"}
(61,1,1) = {"
b
c
c
c
c
c
c
c
b
d
d
d
d
d
d
d
d
d
d
d
d
d
u
d
d
d
d
d
d
d
d
d
d
d
d
d
v
d
d
d
u
d
v
d
d
d
b
c
c
c
c
c
c
c
b
"}
(62,1,1) = {"
b
c
c
c
c
c
c
c
b
d
d
d
d
d
d
d
d
d
v
u
u
u
u
d
d
d
d
d
d
d
d
d
d
d
d
d
d
d
A
d
d
d
d
d
d
d
b
c
c
c
c
c
c
c
b
"}
(63,1,1) = {"
b
c
c
c
c
c
c
c
b
d
d
d
d
d
d
d
d
d
d
d
d
d
d
d
d
d
d
d
d
d
d
d
d
d
d
d
d
d
d
d
d
d
d
d
d
d
b
c
c
c
c
c
c
c
b
"}
(64,1,1) = {"
b
c
c
c
c
c
c
c
b
d
d
d
d
d
d
v
d
d
d
d
d
d
d
d
d
d
d
d
d
v
d
d
v
d
d
d
d
d
d
d
d
d
d
d
d
d
b
c
c
c
c
c
c
c
b
"}
(65,1,1) = {"
b
c
c
c
c
c
c
c
b
d
d
d
d
d
d
d
d
d
d
d
d
d
d
d
d
d
d
d
d
d
d
d
d
d
d
d
d
d
d
v
d
d
d
d
d
d
b
c
c
c
c
c
c
c
b
"}
(66,1,1) = {"
b
c
c
c
c
c
c
c
b
d
d
d
d
d
d
d
d
d
d
d
d
d
d
d
d
d
d
d
d
d
d
d
d
d
d
d
d
d
d
d
d
d
d
d
d
d
b
c
c
c
c
c
c
c
b
"}
(67,1,1) = {"
b
c
c
c
c
c
c
c
b
d
d
d
d
v
d
d
d
d
d
d
d
d
d
d
d
d
d
d
d
d
d
d
d
d
d
d
v
d
d
d
d
d
d
d
d
d
b
c
c
c
c
c
c
c
b
"}
(68,1,1) = {"
b
c
c
c
c
c
c
c
b
d
d
d
d
d
d
d
d
d
d
d
d
d
d
d
d
d
d
v
d
d
d
d
d
d
d
d
d
d
d
d
d
d
d
d
d
d
b
c
c
c
c
c
c
c
b
"}
(69,1,1) = {"
b
c
c
c
c
c
c
c
b
d
d
d
d
d
d
d
d
d
d
d
d
d
d
v
d
d
d
d
d
d
d
d
d
d
d
d
d
d
d
d
d
d
d
d
d
d
b
c
c
c
c
c
c
c
b
"}
(70,1,1) = {"
b
c
c
c
c
c
c
c
b
d
d
d
d
d
d
v
d
d
d
d
d
v
d
d
d
d
d
u
u
u
u
u
u
u
u
u
d
v
d
d
d
d
d
d
d
d
b
c
c
c
c
c
c
c
b
"}
(71,1,1) = {"
b
c
c
c
j
c
c
c
b
d
d
d
d
d
d
d
d
d
v
d
d
d
d
d
d
d
d
u
d
d
d
d
d
d
d
u
d
d
d
d
d
d
d
d
d
d
b
c
c
c
c
c
c
c
b
"}
(72,1,1) = {"
b
c
c
c
c
c
c
c
b
d
d
d
d
d
d
d
d
d
d
d
d
d
d
d
v
d
d
d
d
d
d
d
d
d
d
d
d
d
v
d
d
d
d
d
d
d
b
c
c
c
c
c
c
c
b
"}
(73,1,1) = {"
b
c
c
c
c
c
c
c
b
d
d
d
d
d
d
d
d
d
d
d
d
d
d
d
d
d
d
d
d
d
Z
Z
Z
d
d
d
d
d
d
d
d
d
d
d
d
d
b
c
c
c
c
c
c
c
b
"}
(74,1,1) = {"
b
c
c
c
c
c
c
c
b
d
d
d
d
d
d
d
d
d
d
d
d
d
d
d
d
v
d
v
v
d
Z
Z
Z
d
v
v
d
v
d
d
d
d
d
d
d
d
b
c
c
c
c
c
c
c
b
"}
(75,1,1) = {"
b
c
c
c
c
c
c
c
b
d
d
d
d
d
d
v
d
d
d
d
d
d
d
d
d
d
d
d
d
d
Z
Z
Z
d
d
d
d
d
d
d
v
d
d
d
d
d
b
c
c
c
c
c
c
c
b
"}
(76,1,1) = {"
b
c
c
c
c
c
c
c
b
d
d
d
d
d
d
d
d
d
d
d
d
d
d
d
d
d
d
d
d
d
d
d
d
d
d
d
d
d
d
d
d
d
d
d
d
d
b
c
c
c
c
c
c
c
b
"}
(77,1,1) = {"
b
c
c
c
c
c
c
c
d
d
d
d
v
d
d
d
d
d
d
d
d
d
d
d
d
d
d
u
d
d
d
d
d
d
d
u
d
d
d
d
d
d
v
d
d
d
d
c
c
c
c
c
c
c
b
"}
(78,1,1) = {"
b
c
c
c
c
c
c
c
d
d
d
d
d
d
d
d
v
d
d
d
d
d
d
d
d
d
d
u
u
u
u
u
u
u
u
u
d
d
v
d
d
d
d
d
d
d
d
c
c
c
c
c
c
c
b
"}
(79,1,1) = {"
b
c
c
c
c
c
c
c
d
v
d
d
d
d
d
d
d
d
d
d
d
d
d
d
d
d
d
d
d
d
d
d
d
d
d
d
d
d
d
d
d
d
d
d
d
v
d
c
c
c
c
c
c
c
b
"}
(80,1,1) = {"
b
c
c
c
c
c
c
c
d
d
d
d
d
d
d
d
d
d
d
d
d
d
d
d
d
d
d
d
d
d
d
d
d
d
d
d
d
d
d
d
d
d
d
d
d
d
d
c
c
c
c
c
c
c
b
"}
(81,1,1) = {"
b
c
c
c
c
c
c
c
e
e
e
e
e
e
e
e
e
e
e
e
e
e
e
e
e
e
e
e
e
e
e
e
e
e
e
e
e
e
e
e
e
e
e
e
e
e
e
c
c
c
c
c
c
c
b
"}
(82,1,1) = {"
b
c
c
c
c
c
c
c
d
d
d
d
d
d
d
d
v
d
d
d
d
d
d
d
d
d
d
d
d
d
d
d
d
d
d
d
d
d
d
d
d
d
d
d
d
d
d
c
c
c
c
c
c
c
b
"}
(83,1,1) = {"
b
c
c
c
c
c
c
c
d
v
d
d
d
d
d
d
d
d
d
d
d
d
d
d
d
d
d
d
d
d
d
d
d
d
d
d
d
d
v
d
d
d
d
d
d
v
d
c
c
c
c
c
c
c
b
"}
(84,1,1) = {"
b
c
c
c
c
c
c
c
d
d
d
d
d
d
d
d
d
d
d
d
d
d
d
d
d
d
d
d
d
d
d
d
d
d
d
d
d
d
d
d
d
d
v
d
d
d
d
c
c
c
c
c
c
c
b
"}
(85,1,1) = {"
b
c
c
c
c
c
c
c
d
d
d
d
v
d
d
d
d
d
d
d
d
d
d
d
d
d
d
d
d
d
d
d
d
d
d
d
d
d
d
d
d
d
d
d
d
d
d
c
c
c
c
c
c
c
b
"}
(86,1,1) = {"
b
c
c
c
c
c
c
c
b
d
d
d
d
d
d
v
d
d
d
d
d
d
d
d
d
d
d
d
d
d
d
d
d
d
d
d
d
d
d
v
d
d
d
d
d
d
b
c
c
c
c
c
c
c
b
"}
(87,1,1) = {"
b
c
c
c
c
c
c
c
b
d
d
d
d
d
d
d
d
d
d
d
d
d
d
d
d
d
d
d
d
d
d
d
d
d
d
d
d
d
d
d
d
d
d
d
d
d
b
c
c
c
c
c
c
c
b
"}
(88,1,1) = {"
b
c
c
c
c
c
c
c
b
d
d
d
d
d
d
d
d
d
d
d
d
d
d
d
d
d
d
d
d
d
d
d
d
d
d
d
d
d
d
d
d
d
d
d
d
d
b
c
c
c
c
c
c
c
b
"}
(89,1,1) = {"
b
c
c
c
c
c
c
c
b
d
d
d
d
d
d
d
d
d
d
d
d
d
d
d
d
d
d
d
d
d
d
d
d
d
d
d
d
d
d
d
d
d
d
d
d
d
b
c
c
c
c
c
c
c
b
"}
(90,1,1) = {"
b
c
c
c
c
c
c
c
b
d
d
d
d
d
d
d
d
d
d
d
d
d
d
d
d
d
d
d
d
d
d
d
d
d
d
d
d
d
d
d
d
d
d
d
d
d
b
c
c
c
c
c
c
c
b
"}
(91,1,1) = {"
b
c
c
c
q
c
c
c
b
d
d
d
d
d
d
d
d
d
d
d
d
d
d
d
d
d
d
d
d
d
d
d
d
d
d
d
d
d
d
d
d
d
d
d
d
d
b
c
c
c
c
c
c
c
b
"}
(92,1,1) = {"
b
c
c
c
c
c
c
c
b
d
d
d
d
d
d
d
d
d
d
d
d
d
d
d
d
d
d
d
d
d
d
d
d
d
d
d
d
d
d
d
d
d
d
d
d
d
b
c
c
c
c
c
c
c
b
"}
(93,1,1) = {"
b
c
c
c
c
c
c
c
b
d
d
d
d
d
d
d
d
d
d
d
d
d
d
d
d
d
d
d
d
d
d
d
d
d
d
d
d
d
d
d
d
d
d
d
d
d
b
c
c
c
c
c
c
c
b
"}
(94,1,1) = {"
b
c
c
c
c
c
c
c
b
d
d
d
d
d
d
d
d
d
d
d
d
d
d
d
d
d
d
d
d
d
d
d
d
d
d
d
d
d
d
d
d
d
d
d
d
d
b
c
c
c
c
c
c
c
b
"}
(95,1,1) = {"
b
c
c
c
c
c
c
c
b
d
d
d
d
d
d
d
d
d
d
d
d
d
d
d
d
d
d
d
d
d
d
d
d
d
d
d
d
d
d
d
d
d
d
d
d
d
b
c
c
c
c
c
c
c
b
"}
(96,1,1) = {"
b
c
c
c
c
c
c
c
b
d
d
d
d
d
d
d
d
d
d
d
d
d
d
d
d
d
d
d
d
d
d
d
d
d
d
d
d
d
d
d
d
d
d
d
d
d
b
c
c
c
c
c
c
c
b
"}
(97,1,1) = {"
b
c
c
c
c
c
c
c
b
d
d
d
d
d
d
d
d
d
d
d
d
d
d
d
d
d
d
d
d
d
d
d
d
d
d
d
d
d
d
d
d
d
d
d
d
d
b
c
c
c
c
c
c
c
b
"}
(98,1,1) = {"
b
c
c
c
c
c
c
c
b
d
d
d
d
d
d
d
d
d
d
d
d
d
d
d
d
d
d
d
d
d
d
d
d
d
d
d
d
d
d
d
d
d
d
d
d
d
b
c
c
c
c
c
c
c
b
"}
(99,1,1) = {"
b
c
c
c
c
c
c
c
b
d
d
d
d
d
d
d
d
d
d
d
d
d
d
d
d
d
d
d
d
d
d
d
d
d
d
d
d
d
d
d
d
d
d
d
d
d
b
c
c
c
c
c
c
c
b
"}
(100,1,1) = {"
b
c
c
c
c
c
c
c
b
d
d
d
d
d
d
d
d
d
d
d
d
d
d
d
d
d
d
d
d
d
d
d
d
d
d
d
d
d
d
d
d
d
d
d
d
d
b
c
c
c
c
c
c
c
b
"}
(101,1,1) = {"
b
c
c
c
c
c
c
c
b
d
d
d
d
d
d
d
d
d
d
d
d
d
d
d
d
d
d
d
d
d
d
d
d
d
d
d
d
d
d
d
d
d
d
d
d
d
b
c
c
c
c
c
c
c
b
"}
(102,1,1) = {"
b
c
c
c
c
c
c
c
b
d
d
d
d
d
d
d
d
d
d
d
d
d
d
d
d
d
d
d
d
d
d
d
d
d
d
d
d
d
d
d
d
d
d
d
d
d
b
c
c
c
c
c
c
c
b
"}
(103,1,1) = {"
b
c
c
c
c
c
c
c
d
d
d
d
d
d
d
d
d
d
d
d
d
d
d
d
d
d
d
d
d
d
d
d
d
d
d
d
d
d
d
d
d
d
d
d
d
d
d
c
c
c
c
c
c
c
b
"}
(104,1,1) = {"
b
c
c
c
c
c
c
c
d
d
d
d
d
d
d
d
d
d
d
d
d
d
d
d
d
d
d
d
d
d
d
d
d
d
d
d
d
d
d
d
d
d
d
d
d
d
d
c
c
c
c
c
c
c
b
"}
(105,1,1) = {"
b
c
c
c
c
c
c
c
d
d
d
d
d
d
d
d
d
d
d
d
d
d
d
d
d
d
d
d
d
d
d
d
d
d
d
d
d
d
d
d
d
d
d
d
d
d
d
c
c
c
c
c
c
c
b
"}
(106,1,1) = {"
b
c
c
c
c
c
c
c
b
d
d
d
d
d
d
d
d
d
d
d
d
d
d
d
d
d
d
d
d
d
d
d
d
d
d
d
d
d
d
d
d
d
d
d
d
d
b
c
c
c
c
c
c
c
b
"}
(107,1,1) = {"
b
c
c
c
c
c
c
c
b
d
d
d
d
d
d
d
d
d
d
d
d
d
d
d
d
d
d
d
d
d
d
d
d
d
d
d
d
d
d
d
d
d
d
d
d
d
b
c
c
c
c
c
c
c
b
"}
(108,1,1) = {"
b
c
c
c
c
c
c
c
b
d
d
d
d
d
d
d
d
d
d
d
d
d
d
d
d
d
d
d
d
d
d
d
d
d
d
d
d
d
d
d
d
d
d
d
d
d
b
c
c
c
c
c
c
c
b
"}
(109,1,1) = {"
b
c
c
c
c
c
c
c
b
d
d
d
d
d
d
d
d
d
d
d
d
d
d
d
d
d
d
d
d
d
d
d
d
d
d
d
d
d
d
d
d
d
d
d
d
d
b
c
c
c
c
c
c
c
b
"}
(110,1,1) = {"
b
c
c
c
c
c
c
c
b
d
d
d
d
d
d
d
d
d
d
d
d
d
d
d
d
d
d
d
d
d
d
d
d
d
d
d
d
d
d
d
d
d
d
d
d
d
b
c
c
c
c
c
c
c
b
"}
(111,1,1) = {"
b
c
c
c
c
c
c
c
b
d
d
d
d
d
d
d
d
d
d
d
d
d
d
d
d
d
d
d
d
d
d
d
d
d
d
d
d
d
d
d
d
d
d
d
d
d
b
c
c
c
c
c
c
c
b
"}
(112,1,1) = {"
b
c
c
c
c
c
c
c
b
d
d
d
d
d
d
d
d
d
d
d
d
d
d
d
d
d
d
d
d
d
d
d
d
d
d
d
d
d
d
d
d
d
d
d
d
d
b
c
c
c
c
c
c
c
b
"}
(113,1,1) = {"
b
c
c
c
c
c
c
c
b
d
d
d
d
d
d
d
d
d
d
d
d
d
d
d
d
d
d
d
d
d
d
d
d
d
d
d
d
d
d
d
d
d
d
d
d
d
b
c
c
c
c
c
c
c
b
"}
(114,1,1) = {"
b
c
c
c
c
c
c
c
b
d
d
d
d
d
d
d
d
d
d
d
d
d
d
d
d
d
d
d
d
d
d
d
d
d
d
d
d
d
d
d
d
d
d
d
d
d
b
c
c
c
c
c
c
c
b
"}
(115,1,1) = {"
b
c
c
c
c
c
c
c
b
d
d
d
d
d
d
d
d
d
d
d
d
d
d
d
d
d
d
d
d
d
d
d
d
d
d
d
d
d
d
d
d
d
d
d
d
d
b
c
c
c
c
c
c
c
b
"}
(116,1,1) = {"
b
c
c
c
c
c
c
c
b
d
d
d
d
d
d
d
d
d
d
d
d
d
d
d
d
d
d
d
d
d
d
d
d
d
d
d
d
d
d
d
d
d
d
d
d
d
b
c
c
c
c
c
c
c
b
"}
(117,1,1) = {"
b
c
c
c
c
c
c
c
b
d
d
d
d
d
d
d
d
d
d
d
d
d
d
d
d
d
d
d
d
d
d
d
d
d
d
d
d
d
d
d
d
d
d
d
d
d
b
c
c
c
c
c
c
c
b
"}
(118,1,1) = {"
b
c
c
c
c
c
c
c
b
d
d
d
d
d
d
d
d
d
d
d
d
d
d
d
d
d
d
d
d
d
d
d
d
d
d
d
d
d
d
d
d
d
d
d
d
d
b
c
c
c
c
c
c
c
b
"}
(119,1,1) = {"
b
c
c
c
c
c
c
c
b
d
d
d
d
d
d
d
d
d
d
d
d
d
d
d
d
d
d
d
d
d
d
d
d
d
d
d
d
d
d
d
d
d
d
d
d
d
b
c
c
c
c
c
c
c
b
"}
(120,1,1) = {"
b
c
c
c
c
c
c
c
b
d
d
d
d
d
d
d
d
d
d
d
d
d
d
d
d
d
d
d
d
d
d
d
d
d
d
d
d
d
d
d
d
d
d
d
d
d
b
c
c
c
c
c
c
c
b
"}
(121,1,1) = {"
b
c
c
c
c
c
c
c
b
d
d
d
d
d
d
d
d
d
d
d
d
d
d
d
d
d
d
d
d
d
d
d
d
d
d
d
d
d
d
d
d
d
d
d
d
d
b
c
c
c
c
c
c
c
b
"}
(122,1,1) = {"
b
c
c
c
c
c
c
c
b
d
d
d
d
d
d
d
d
d
d
d
d
d
d
d
d
d
d
d
d
d
d
d
d
d
d
d
d
d
d
d
d
d
d
d
d
d
b
c
c
c
c
c
c
c
b
"}
(123,1,1) = {"
b
c
c
c
c
c
c
c
b
d
d
d
d
d
d
d
d
d
d
d
d
d
d
d
d
d
d
d
d
d
d
d
d
d
d
d
d
d
d
d
d
d
d
d
d
d
b
c
c
c
c
c
c
c
b
"}
(124,1,1) = {"
b
c
c
c
c
c
c
c
b
d
d
d
d
d
d
d
d
d
d
d
d
d
d
d
d
d
d
d
d
d
d
d
d
d
d
d
d
d
d
d
d
d
d
d
d
d
b
c
c
c
c
c
c
c
b
"}
(125,1,1) = {"
b
c
c
c
c
c
c
c
b
d
d
d
d
d
d
d
d
d
d
d
d
d
d
d
d
d
d
d
d
d
d
d
d
d
d
d
d
d
d
d
d
d
d
d
d
d
b
c
c
c
c
c
c
c
b
"}
(126,1,1) = {"
b
c
c
c
c
c
c
c
b
d
d
d
d
d
d
d
d
d
d
d
d
d
d
d
d
d
d
d
d
d
d
d
d
d
d
d
d
d
d
d
d
d
d
d
d
d
b
c
c
c
c
c
c
c
b
"}
(127,1,1) = {"
b
c
c
c
c
c
c
c
b
d
d
d
d
d
d
d
d
d
d
d
d
d
d
d
d
d
d
d
d
d
d
d
d
d
d
d
d
d
d
d
d
d
d
d
d
d
b
c
c
c
c
c
c
c
b
"}
(128,1,1) = {"
b
c
c
c
c
c
c
c
b
b
d
d
d
d
d
d
d
d
d
d
d
d
d
d
d
d
d
d
d
d
d
d
d
d
d
d
d
d
d
d
d
d
d
d
d
b
b
c
c
c
c
c
c
c
b
"}
(129,1,1) = {"
b
c
c
c
c
c
c
c
c
b
b
d
d
d
d
d
d
d
d
d
d
d
d
d
d
d
d
d
d
d
d
d
d
d
d
d
d
d
d
d
d
d
d
d
b
b
c
c
c
c
c
c
c
c
b
"}
(130,1,1) = {"
b
c
c
c
c
c
c
c
c
c
b
b
d
d
d
d
d
d
d
d
d
d
d
d
d
d
d
d
d
d
d
d
d
d
d
d
d
d
d
d
d
d
d
b
b
c
c
c
c
c
c
c
c
c
b
"}
(131,1,1) = {"
b
c
c
c
c
c
c
c
c
c
c
b
d
d
d
d
d
d
d
d
d
d
d
d
d
d
d
d
d
d
d
d
d
d
d
d
d
d
d
d
d
d
d
b
c
c
c
c
c
c
c
c
c
c
b
"}
(132,1,1) = {"
b
c
c
c
c
c
c
c
c
c
c
c
d
d
d
d
d
d
d
d
d
d
d
d
d
d
d
d
d
d
d
d
d
d
d
d
d
d
d
d
d
d
d
c
c
c
c
c
c
c
c
c
c
c
b
"}
(133,1,1) = {"
b
b
c
c
c
c
c
c
c
c
c
c
c
d
b
d
d
d
d
d
d
d
d
d
d
d
d
d
d
d
d
d
d
d
d
d
d
d
d
d
b
d
c
c
c
c
c
c
c
c
c
c
c
b
b
"}
(134,1,1) = {"
a
b
b
c
c
c
c
c
c
c
c
c
c
c
b
b
d
d
d
d
d
d
d
d
d
d
d
d
d
d
d
d
d
d
d
d
d
d
d
b
b
c
c
c
c
c
c
c
c
c
c
c
b
b
a
"}
(135,1,1) = {"
a
a
b
b
c
c
c
c
c
c
c
c
c
c
c
b
b
d
d
d
d
d
d
d
d
d
d
d
d
d
d
d
d
d
d
d
d
d
b
b
c
c
c
c
c
c
c
c
c
c
c
b
b
a
a
"}
(136,1,1) = {"
a
a
a
b
b
c
c
c
c
c
c
c
c
c
c
c
b
b
d
d
d
d
d
d
d
d
d
d
d
d
d
d
d
d
d
d
d
b
b
c
c
c
c
c
c
c
c
c
c
c
b
b
a
a
a
"}
(137,1,1) = {"
a
a
a
a
b
b
c
c
c
c
c
c
c
c
c
c
c
b
b
d
d
d
d
d
d
d
d
d
d
d
d
d
d
d
d
d
b
b
c
c
c
c
c
c
c
c
c
c
c
b
b
a
a
a
a
"}
(138,1,1) = {"
a
a
a
a
a
b
b
c
c
c
c
c
c
c
c
c
c
c
b
b
d
d
d
d
d
d
d
d
d
d
d
d
d
d
d
b
b
c
c
c
c
c
c
c
c
c
c
c
b
b
a
a
a
a
a
"}
(139,1,1) = {"
a
a
a
a
a
a
b
b
c
c
c
c
c
c
c
c
c
c
c
b
b
d
d
d
d
d
d
d
d
d
d
d
d
d
b
b
c
c
c
c
c
c
c
c
c
c
c
b
b
a
a
a
a
a
a
"}
(140,1,1) = {"
a
a
a
a
a
a
a
b
b
c
c
c
c
c
c
c
c
c
c
c
b
b
d
d
d
d
d
d
d
d
d
d
d
b
b
c
c
c
c
c
c
c
c
c
c
c
b
b
a
a
a
a
a
a
a
"}
(141,1,1) = {"
a
a
a
a
a
a
a
a
b
b
c
c
c
c
c
c
c
c
c
c
c
b
b
d
d
d
d
d
d
d
d
d
b
b
c
c
c
c
c
c
c
c
c
c
c
b
b
a
a
a
a
a
a
a
a
"}
(142,1,1) = {"
a
a
a
a
a
a
a
a
a
b
b
c
c
c
c
c
c
C
C
C
C
C
b
b
d
d
d
d
d
d
d
b
b
C
C
C
C
C
c
c
c
c
c
c
b
b
a
a
a
a
a
a
a
a
a
"}
(143,1,1) = {"
a
a
a
a
a
a
a
a
a
a
b
b
c
c
c
c
C
C
C
C
C
C
C
b
b
d
d
d
d
d
b
b
C
C
C
C
C
C
C
c
c
c
c
b
b
a
a
a
a
a
a
a
a
a
a
"}
(144,1,1) = {"
a
a
a
a
a
a
a
a
a
a
a
b
b
c
c
c
C
C
C
C
C
C
C
C
b
b
b
b
b
b
b
C
C
C
C
C
C
C
C
c
c
c
b
b
a
a
a
a
a
a
a
a
a
a
a
"}
(145,1,1) = {"
a
a
a
a
a
a
a
a
a
a
a
a
b
b
c
c
C
C
C
C
C
C
C
C
C
C
C
C
C
C
C
C
C
C
C
C
C
C
C
c
c
b
b
a
a
a
a
a
a
a
a
a
a
a
a
"}
(146,1,1) = {"
a
a
a
a
a
a
a
a
a
a
a
a
a
b
b
c
C
C
C
C
C
C
C
C
C
C
C
C
C
C
C
C
C
C
C
C
C
C
C
c
b
b
a
a
a
a
a
a
a
a
a
a
a
a
a
"}
(147,1,1) = {"
a
a
a
a
a
a
a
a
a
a
a
a
a
a
b
b
C
C
C
C
C
C
C
C
C
C
C
C
C
C
C
C
C
C
C
C
C
C
C
b
b
a
a
a
a
a
a
a
a
a
a
a
a
a
a
"}
(148,1,1) = {"
a
a
a
a
a
a
a
a
a
a
a
a
a
a
a
b
b
C
C
C
C
C
C
C
C
C
C
C
C
C
C
C
C
C
C
C
C
C
b
b
a
a
a
a
a
a
a
a
a
a
a
a
a
a
a
"}
(149,1,1) = {"
a
a
a
a
a
a
a
a
a
a
a
a
a
a
a
a
b
b
C
C
C
C
C
C
C
C
C
C
C
C
C
C
C
C
C
C
C
b
b
a
a
a
a
a
a
a
a
a
a
a
a
a
a
a
a
"}
(150,1,1) = {"
a
a
a
a
a
a
a
a
a
a
a
a
a
a
a
a
a
b
b
C
C
C
C
C
C
C
C
C
C
C
C
C
C
C
C
C
b
b
a
a
a
a
a
a
a
a
a
a
a
a
a
a
a
a
a
"}
(151,1,1) = {"
a
a
a
a
a
a
a
a
a
a
a
a
a
a
a
a
a
a
b
C
C
C
C
C
C
C
C
C
C
C
C
C
C
C
C
C
b
a
a
a
a
a
a
a
a
a
a
a
a
a
a
a
a
a
a
"}
(152,1,1) = {"
a
a
a
a
a
a
a
a
a
a
a
a
a
a
a
a
a
a
b
C
C
C
C
C
C
C
C
C
C
C
C
C
C
C
C
C
b
a
a
a
a
a
a
a
a
a
a
a
a
a
a
a
a
a
a
"}
(153,1,1) = {"
a
a
a
a
a
a
a
a
a
a
a
a
a
a
a
a
a
a
b
C
C
C
C
C
C
C
C
C
C
C
C
C
C
C
C
C
b
a
a
a
a
a
a
a
a
a
a
a
a
a
a
a
a
a
a
"}
(154,1,1) = {"
a
a
a
a
a
a
a
a
a
a
a
a
a
a
a
a
a
a
b
C
C
C
C
C
C
C
C
C
C
C
C
C
C
C
C
C
b
a
a
a
a
a
a
a
a
a
a
a
a
a
a
a
a
a
a
"}
(155,1,1) = {"
a
a
a
a
a
a
a
a
a
a
a
a
a
a
a
a
a
a
b
C
C
C
C
C
C
C
C
C
C
C
C
C
C
C
C
C
b
a
a
a
a
a
a
a
a
a
a
a
a
a
a
a
a
a
a
"}
(156,1,1) = {"
a
a
a
a
a
a
a
a
a
a
a
a
a
a
a
a
a
a
b
C
C
C
C
C
C
C
C
C
C
C
C
C
C
C
C
C
b
a
a
a
a
a
a
a
a
a
a
a
a
a
a
a
a
a
a
"}
(157,1,1) = {"
a
a
a
a
a
a
a
a
a
a
a
a
a
a
a
a
a
a
b
C
C
C
C
C
C
C
C
C
C
C
C
C
C
C
C
C
b
a
a
a
a
a
a
a
a
a
a
a
a
a
a
a
a
a
a
"}
(158,1,1) = {"
a
a
a
a
a
a
a
a
a
a
a
a
a
a
a
a
a
a
b
C
C
C
C
C
C
C
C
C
C
C
C
C
C
C
C
C
b
a
a
a
a
a
a
a
a
a
a
a
a
a
a
a
a
a
a
"}
(159,1,1) = {"
a
a
a
a
a
a
a
a
a
a
a
a
a
a
a
a
a
a
b
b
C
C
C
C
C
C
C
C
C
C
C
C
C
C
C
b
b
a
a
a
a
a
a
a
a
a
a
a
a
a
a
a
a
a
a
"}
(160,1,1) = {"
a
a
a
a
a
a
a
a
a
a
a
a
a
a
a
a
a
a
a
b
b
C
C
C
C
C
C
P
C
C
C
C
C
C
b
b
a
a
a
a
a
a
a
a
a
a
a
a
a
a
a
a
a
a
a
"}
(161,1,1) = {"
a
a
a
a
a
a
a
a
a
a
a
a
a
a
a
a
a
a
a
a
b
b
C
C
C
C
C
C
C
C
C
C
C
b
b
a
a
a
a
a
a
a
a
a
a
a
a
a
a
a
a
a
a
a
a
"}
(162,1,1) = {"
a
a
a
a
a
a
a
a
a
a
a
a
a
a
a
a
a
a
a
a
a
b
b
b
b
b
b
b
b
b
b
b
b
b
a
a
a
a
a
a
a
a
a
a
a
a
a
a
a
a
a
a
a
a
a
"}
