//MAP CONVERTED BY dmm2tgm.py THIS HEADER COMMENT PREVENTS RECONVERSION, DO NOT REMOVE
"ai" = (
/turf/closed/wall/r_wall,
/area/lv624/lazarus/armory)
"aj" = (
/turf/closed/wall/r_wall,
/area/lv624/lazarus/security)
"av" = (
/turf/open/floor/red/northeast,
/area/lv624/lazarus/security)
"ax" = (
/turf/open/floor/white,
/area/lv624/lazarus/main_hall)
"az" = (
/turf/closed/wall/strata_ice/jungle,
/area/lv624/ground/jungle/east_central_jungle)
"aD" = (
/obj/effect/decal/cleanable/cobweb2,
/obj/item/reagent_container/hypospray/autoinjector/tricord,
/obj/structure/surface/rack,
/obj/item/reagent_container/hypospray/autoinjector/tricord,
/obj/effect/landmark/crap_item,
/obj/effect/landmark/crap_item,
/turf/open/floor/cult,
/area/lv624/lazarus/armory)
"aE" = (
/turf/open/floor/cult,
/area/lv624/lazarus/armory)
"aF" = (
/obj/structure/machinery/light/small{
	dir = 1
	},
/obj/structure/surface/rack,
/obj/item/weapon/gun/pistol/highpower,
/obj/item/ammo_magazine/pistol/highpower,
/obj/item/ammo_magazine/pistol/highpower,
/obj/item/ammo_magazine/pistol/highpower,
/turf/open/floor/cult,
/area/lv624/lazarus/armory)
"aG" = (
/obj/structure/machinery/light/small{
	dir = 8
	},
/turf/open/floor/red/northeast,
/area/lv624/lazarus/security)
"aH" = (
/obj/structure/window/reinforced{
	dir = 4
	},
/obj/structure/surface/table,
/obj/item/weapon/gun/revolver/cmb,
/obj/item/ammo_magazine/revolver/cmb,
/obj/item/ammo_magazine/revolver/cmb,
/obj/item/ammo_magazine/revolver/cmb,
/turf/open/floor/red/northeast,
/area/lv624/lazarus/security)
"aI" = (
/obj/structure/surface/rack,
/obj/effect/landmark/crap_item,
/obj/effect/landmark/crap_item,
/obj/item/reagent_container/food/snacks/sliceable/cheesewheel/mature{
	pixel_y = 6
	},
/obj/item/reagent_container/food/snacks/cheesewedge/extramature{
	pixel_x = -4;
	pixel_y = -3
	},
/turf/open/floor/cult,
/area/lv624/lazarus/armory)
"aJ" = (
/obj/structure/machinery/door_control{
	id = "garage_blast";
	name = "Garage Shutters";
	pixel_x = -26;
	range = 200
	},
/obj/structure/surface/rack,
/obj/item/reagent_container/food/snacks/sliceable/cheesewheel/mature{
	pixel_y = 8
	},
/obj/item/reagent_container/food/snacks/sliceable/cheesewheel/mature{
	pixel_y = -6
	},
/turf/open/floor/cult,
/area/lv624/lazarus/armory)
"aK" = (
/obj/structure/machinery/deployable/barrier,
/obj/effect/decal/cleanable/cobweb,
/turf/open/floor/cult,
/area/lv624/lazarus/armory)
"aL" = (
/turf/open/floor/whiteyellowcorner/east,
/area/lv624/lazarus/main_hall)
"aN" = (
/obj/effect/landmark/objective_landmark/medium,
/turf/open/floor/cult,
/area/lv624/lazarus/armory)
"aO" = (
/obj/structure/machinery/door/airlock/almayer/secure/colony{
	locked = 1;
	name = "\improper Nexus Dome Armory"
	},
/turf/open/floor/cult,
/area/lv624/lazarus/armory)
"aP" = (
/obj/structure/surface/rack,
/obj/item/storage/box/mousetraps{
	pixel_x = -5
	},
/obj/item/paper/lv_624/cheese{
	pixel_x = 8;
	pixel_y = -4
	},
/turf/open/floor/cult,
/area/lv624/lazarus/armory)
"aR" = (
/obj/structure/barricade/wooden{
	dir = 8
	},
/turf/open/floor/white,
/area/lv624/lazarus/main_hall)
"aS" = (
/turf/open/floor/whiteyellow/north,
/area/lv624/lazarus/main_hall)
"aT" = (
/obj/structure/surface/rack,
/obj/item/weapon/gun/shotgun/pump,
/obj/item/ammo_magazine/shotgun/slugs,
/turf/open/floor/cult,
/area/lv624/lazarus/armory)
"aU" = (
/obj/effect/landmark/crap_item,
/turf/open/floor/cult,
/area/lv624/lazarus/armory)
"aV" = (
/obj/structure/surface/rack,
/obj/item/reagent_container/food/snacks/cheesewedge/verymature{
	pixel_x = -7;
	pixel_y = -3
	},
/obj/item/reagent_container/food/snacks/cheesewedge/verymature{
	pixel_x = 6;
	pixel_y = -3
	},
/obj/item/reagent_container/food/snacks/cheesewedge/verymature{
	pixel_y = 6
	},
/obj/structure/machinery/power/apc/directional/no_power/west,
/turf/open/floor/cult,
/area/lv624/lazarus/armory)
"aW" = (
/obj/structure/machinery/light/small,
/obj/effect/landmark/crap_item,
/turf/open/floor/white,
/area/lv624/lazarus/main_hall)
"aX" = (
/obj/structure/target/syndicate,
/turf/open/floor/red/northeast,
/area/lv624/lazarus/security)
"aY" = (
/obj/structure/surface/rack,
/obj/effect/landmark/crap_item,
/obj/effect/landmark/crap_item,
/obj/item/reagent_container/food/snacks/sliceable/cheesewheel/verymature,
/obj/item/reagent_container/food/snacks/sliceable/cheesewheel/verymature,
/turf/open/floor/cult,
/area/lv624/lazarus/armory)
"aZ" = (
/obj/structure/machinery/deployable/barrier,
/turf/open/floor/cult,
/area/lv624/lazarus/armory)
"hu" = (
/obj/item/stack/sheet/wood,
/turf/open/floor/white,
/area/lv624/lazarus/main_hall)
"Un" = (
/turf/open/floor/whiteyellow/east,
/area/lv624/lazarus/main_hall)
"XB" = (
/obj/item/phone{
	desc = "A model of an ancient Earth communication device.";
	force = 8
	},
/obj/structure/surface/rack{
	layer = 2.5
	},
/obj/structure/window/reinforced{
	dir = 8
	},
/obj/structure/window/reinforced{
	dir = 1
	},
/obj/structure/window/reinforced,
/turf/open/floor/wood,
/area/lv624/lazarus/main_hall)

(1,1,1) = {"
ax
ax
ax
ax
ai
ai
ai
ai
az
az
"}
(2,1,1) = {"
hu
aR
aR
aR
ai
aK
aZ
ai
ai
ai
"}
(3,1,1) = {"
ax
ax
aW
ai
ai
aF
aE
aV
aJ
ai
"}
(4,1,1) = {"
ax
ax
ax
ai
aT
aE
aE
aN
aU
ai
"}
(5,1,1) = {"
ax
ax
ax
ai
aD
aY
aI
aP
aE
ai
"}
(6,1,1) = {"
Un
aL
ax
ai
ai
ai
ai
ai
aO
ai
"}
(7,1,1) = {"
XB
aS
ax
aj
aX
aG
av
aH
av
aj
"}
