//MAP CONVERTED BY dmm2tgm.py THIS HEADER COMMENT PREVENTS RECONVERSION, DO NOT REMOVE
"a" = (
/turf/open/auto_turf/snow/layer0,
/area/shiva/exterior/cp_lz2)
"b" = (
/obj/structure/machinery/door/poddoor/shutters/almayer{
	density = 0;
	dir = 2;
	id = "sslz_shutters";
	name = "\improper Landing Zone Shutters"
	},
/turf/open/floor/plating/plating_catwalk/shiva,
/area/shiva/exterior/lz2_fortress)
"d" = (
/obj/item/lightstick/red/spoke/planted{
	pixel_x = 12;
	pixel_y = 25
	},
/turf/open/floor/shiva{
	icon_state = "radiator_tile"
	},
/area/shiva/exterior/lz2_fortress)
"e" = (
/obj/structure/machinery/door_control{
	id = "sslz_shutters";
	pixel_x = -22
	},
/turf/open/floor/shiva{
	icon_state = "radiator_tile"
	},
/area/shiva/exterior/lz2_fortress)
"f" = (
/turf/open/floor/shiva{
	dir = 1
	},
/area/shiva/exterior/lz2_fortress)
"g" = (
/turf/open/auto_turf/snow/layer2,
/area/shiva/exterior/cp_lz2)
"l" = (
/turf/closed/wall/shiva/prefabricated/reinforced/hull,
/area/shiva/exterior/lz2_fortress)
"o" = (
/obj/structure/machinery/door_control{
	id = "sslz_shutters";
	pixel_x = -22
	},
/turf/open/floor/shiva{
	dir = 1
	},
/area/shiva/exterior/lz2_fortress)
"r" = (
/turf/open/auto_turf/snow/layer4,
/area/shiva/exterior/cp_lz2)
"t" = (
/obj/structure/machinery/door/poddoor/shutters/almayer{
	density = 0;
	dir = 2;
	id = "slz_shutters";
	name = "\improper Landing Zone Shutters"
	},
/turf/open/floor/plating/plating_catwalk/shiva,
/area/shiva/exterior/lz2_fortress)
"v" = (
/obj/item/lightstick/red/spoke/planted{
	layer = 3.1;
	pixel_x = -13;
	pixel_y = 25
	},
/turf/open/auto_turf/snow/layer1,
/area/shiva/exterior/cp_lz2)
"x" = (
/obj/structure/machinery/door_control{
	id = "slz_shutters";
	pixel_x = -22
	},
/turf/open/floor/shiva{
	dir = 1
	},
/area/shiva/exterior/lz2_fortress)
"y" = (
/obj/effect/landmark/objective_landmark/science,
/turf/open/floor/shiva{
	dir = 1
	},
/area/shiva/exterior/lz2_fortress)
"B" = (
/turf/open/floor/shiva{
	dir = 1;
	icon_state = "multi_tiles"
	},
/area/shiva/exterior/lz2_fortress)
"F" = (
/obj/structure/machinery/door_control{
	id = "sslz_shutters";
	pixel_x = 25
	},
/turf/open/floor/shiva{
	dir = 1
	},
/area/shiva/exterior/lz2_fortress)
"L" = (
/obj/structure/machinery/door_control{
	id = "slz_shutters";
	pixel_x = -7
	},
/turf/closed/wall/shiva/prefabricated/reinforced/hull,
/area/shiva/exterior/lz2_fortress)
"S" = (
/obj/item/lightstick/red/spoke/planted{
	layer = 3.1;
	pixel_x = -13;
	pixel_y = 25
	},
/obj/structure/machinery/door_control{
	id = "slz_shutters";
	pixel_x = -22
	},
/turf/open/floor/shiva{
	icon_state = "radiator_tile"
	},
/area/shiva/exterior/lz2_fortress)
"U" = (
/turf/open/floor/shiva{
	icon_state = "floor3"
	},
/area/shiva/exterior/lz2_fortress)
"W" = (
/obj/structure/machinery/door_control{
	id = "sslz_shutters";
	pixel_x = 25
	},
/turf/open/floor/shiva{
	icon_state = "radiator_tile"
	},
/area/shiva/exterior/lz2_fortress)
"X" = (
/obj/item/lightstick/red/spoke/planted{
	pixel_x = 12;
	pixel_y = 25
	},
/turf/open/auto_turf/snow/layer1,
/area/shiva/exterior/cp_lz2)
"Y" = (
/obj/structure/foamed_metal,
/turf/open/floor/shiva{
	dir = 1
	},
/area/shiva/exterior/lz2_fortress)

(1,1,1) = {"
f
l
l
l
l
l
l
r
"}
(2,1,1) = {"
f
l
l
l
l
l
l
r
"}
(3,1,1) = {"
f
S
t
x
o
b
e
v
"}
(4,1,1) = {"
U
B
t
f
f
b
B
a
"}
(5,1,1) = {"
U
B
t
f
f
b
B
a
"}
(6,1,1) = {"
f
d
t
f
F
b
W
X
"}
(7,1,1) = {"
y
L
l
L
l
l
l
g
"}
(8,1,1) = {"
Y
l
l
l
l
l
l
g
"}
