//MAP CONVERTED BY dmm2tgm.py THIS HEADER COMMENT PREVENTS RECONVERSION, DO NOT REMOVE
"a" = (
/turf/closed/wall/shiva/ice,
/area/bigredv2/caves)
"b" = (
/obj/structure/surface/rack,
/obj/item/tool/shovel,
/turf/open/auto_turf/snow/layer0,
/area/bigredv2/outside/lz1_north_cas)
"c" = (
/obj/structure/surface/rack,
/obj/item/tool/pickaxe,
/obj/item/tool/pickaxe,
/turf/open/auto_turf/snow/layer0,
/area/bigredv2/outside/lz1_north_cas)
"d" = (
/obj/structure/surface/rack,
/obj/item/clothing/mask/gas,
/obj/item/clothing/mask/gas,
/turf/open/auto_turf/snow/layer0,
/area/bigredv2/outside/lz1_north_cas)
"e" = (
/turf/open/auto_turf/snow/layer0,
/area/bigredv2/outside/lz1_north_cas)
"f" = (
/obj/structure/surface/table,
/obj/item/storage/toolbox,
/turf/open/auto_turf/snow/layer0,
/area/bigredv2/outside/lz1_north_cas)
"g" = (
/obj/structure/surface/table,
/obj/effect/spawner/random/technology_scanner,
/turf/open/auto_turf/snow/layer0,
/area/bigredv2/outside/lz1_north_cas)
"h" = (
/obj/structure/surface/table,
/obj/item/tool/pickaxe,
/turf/open/auto_turf/snow/layer0,
/area/bigredv2/outside/lz1_north_cas)
"i" = (
/obj/item/ore,
/turf/open/auto_turf/snow/layer0,
/area/bigredv2/outside/lz1_north_cas)
"j" = (
/obj/effect/decal/remains/human,
/turf/open/auto_turf/snow/layer0,
/area/bigredv2/outside/lz1_north_cas)
"k" = (
/obj/structure/barricade/wooden{
	desc = "This barricade is heavily reinforced. Nothing short of blasting it open seems like it'll do the trick, that or melting the breams supporting it...";
	dir = 4;
	health = 25000
	},
/turf/open/auto_turf/snow/layer0,
/area/bigredv2/outside/lz1_north_cas)
"l" = (
/obj/structure/surface/rack,
/obj/item/lightstick/red,
/obj/item/lightstick/red,
/obj/item/lightstick/red,
/obj/item/lightstick/red,
/obj/item/storage/box/lightstick/red,
/obj/structure/blocker/forcefield/multitile_vehicles,
/turf/open/auto_turf/snow/layer0,
/area/bigredv2/outside/lz1_north_cas)
"m" = (
/obj/item/tool/shovel,
/turf/open/auto_turf/snow/layer0,
/area/bigredv2/outside/lz1_north_cas)
"n" = (
/turf/closed/wall/solaris/reinforced,
/area/bigredv2/outside/space_port)
"o" = (
/obj/item/tool/pickaxe,
/turf/open/auto_turf/ice/layer1,
/area/bigredv2/outside/lz1_north_cas)
"p" = (
/obj/item/tool/warning_cone,
/turf/open/auto_turf/ice/layer1,
/area/bigredv2/outside/lz1_north_cas)
"q" = (
/obj/structure/surface/table,
/obj/item/clothing/mask/gas,
/obj/structure/blocker/forcefield/multitile_vehicles,
/turf/open/auto_turf/ice/layer1,
/area/bigredv2/outside/lz1_north_cas)
"r" = (
/obj/structure/surface/table,
/obj/item/pizzabox,
/obj/structure/blocker/forcefield/multitile_vehicles,
/turf/open/auto_turf/ice/layer1,
/area/bigredv2/outside/lz1_north_cas)
"s" = (
/obj/structure/surface/table,
/obj/item/device/flashlight,
/obj/structure/blocker/forcefield/multitile_vehicles,
/turf/open/auto_turf/ice/layer1,
/area/bigredv2/outside/lz1_north_cas)
"t" = (
/obj/structure/ore_box,
/obj/structure/blocker/forcefield/multitile_vehicles,
/turf/open/auto_turf/ice/layer1,
/area/bigredv2/outside/lz1_north_cas)
"u" = (
/obj/structure/sign/safety/hazard,
/turf/closed/wall/solaris/reinforced,
/area/bigredv2/outside/space_port)
"v" = (
/obj/structure/machinery/door/airlock/almayer/maint/colony{
	dir = 1;
	name = "\improper Mining Operations"
	},
/turf/open/floor/plating,
/area/bigredv2/outside/space_port)
"y" = (
/turf/open/auto_turf/ice/layer1,
/area/bigredv2/outside/lz1_north_cas)
"A" = (
/obj/structure/blocker/forcefield/multitile_vehicles,
/turf/open/auto_turf/snow/layer0,
/area/bigredv2/outside/lz1_north_cas)
"G" = (
/obj/effect/decal/remains/human,
/turf/open/auto_turf/ice/layer1,
/area/bigredv2/outside/lz1_north_cas)
"I" = (
/obj/item/ore,
/turf/open/auto_turf/ice/layer1,
/area/bigredv2/outside/lz1_north_cas)
"P" = (
/obj/item/ore,
/obj/structure/blocker/forcefield/multitile_vehicles,
/turf/open/auto_turf/snow/layer0,
/area/bigredv2/outside/lz1_north_cas)
"U" = (
/obj/item/ore,
/obj/structure/blocker/forcefield/multitile_vehicles,
/turf/open/auto_turf/ice/layer1,
/area/bigredv2/outside/lz1_north_cas)
"V" = (
/obj/structure/barricade/wooden{
	desc = "This barricade is heavily reinforced. Nothing short of blasting it open seems like it'll do the trick, that or melting the breams supporting it...";
	dir = 4;
	health = 25000
	},
/turf/open/auto_turf/ice/layer1,
/area/bigredv2/outside/lz1_north_cas)
"W" = (
/obj/structure/blocker/forcefield/multitile_vehicles,
/turf/open/auto_turf/ice/layer1,
/area/bigredv2/outside/lz1_north_cas)

(1,1,1) = {"
a
a
a
a
a
l
n
n
n
n
"}
(2,1,1) = {"
a
a
a
a
i
A
P
A
A
u
"}
(3,1,1) = {"
a
a
a
d
e
m
e
e
A
v
"}
(4,1,1) = {"
a
a
b
e
j
e
e
I
W
u
"}
(5,1,1) = {"
a
a
c
e
e
i
e
y
q
n
"}
(6,1,1) = {"
a
a
a
f
e
e
e
y
r
n
"}
(7,1,1) = {"
a
a
a
g
e
i
o
y
s
n
"}
(8,1,1) = {"
a
a
a
h
e
e
G
y
U
n
"}
(9,1,1) = {"
a
a
a
a
k
V
y
p
t
n
"}
(10,1,1) = {"
a
a
a
e
e
y
V
V
a
n
"}
