//MAP CONVERTED BY dmm2tgm.py THIS HEADER COMMENT PREVENTS RECONVERSION, DO NOT REMOVE
"aa" = (
/obj/structure/machinery/landinglight/ds1/delaythree{
	dir = 8
	},
/turf/open/floor{
	dir = 8;
	icon_state = "asteroidwarning"
	},
/area/bigredv2/outside/space_port)
"ab" = (
/turf/open/floor{
	dir = 4;
	icon_state = "asteroidwarning"
	},
/area/bigredv2/outside/space_port)
"ac" = (
/turf/closed/wall/solaris/reinforced,
/area/bigredv2/outside/space_port)
"ad" = (
/obj/structure/window/framed/solaris/reinforced,
/turf/open/floor/plating,
/area/bigredv2/outside/space_port)
"ae" = (
/obj/structure/window_frame/solaris,
/turf/open/floor/plating,
/area/bigredv2/outside/space_port)
"ah" = (
/obj/structure/window_frame/solaris,
/obj/item/shard,
/turf/open/floor/plating,
/area/bigredv2/outside/space_port)
"ai" = (
/obj/structure/window/framed/solaris/reinforced,
/obj/structure/machinery/door/poddoor/shutters/almayer{
	id = "Spaceport2";
	name = "\improper Spaceport Shutters"
	},
/turf/open/floor/plating,
/area/bigredv2/outside/space_port)
"aj" = (
/obj/structure/machinery/light{
	dir = 4
	},
/turf/closed/wall/solaris/reinforced,
/area/bigredv2/outside/space_port)
"ak" = (
/turf/open/floor{
	dir = 1;
	icon_state = "asteroidfloor"
	},
/area/bigredv2/outside/space_port)
"al" = (
/obj/item/shard,
/turf/open/floor{
	dir = 1;
	icon_state = "asteroidfloor"
	},
/area/bigredv2/outside/space_port)
"am" = (
/obj/structure/largecrate/random/barrel,
/turf/open/floor{
	dir = 1;
	icon_state = "asteroidfloor"
	},
/area/bigredv2/outside/space_port)
"an" = (
/obj/structure/surface/rack,
/obj/effect/spawner/random/toolbox,
/turf/open/floor{
	dir = 9;
	icon_state = "darkgreen2"
	},
/area/bigredv2/outside/space_port)
"ao" = (
/obj/structure/machinery/disposal,
/turf/open/floor{
	dir = 1;
	icon_state = "darkgreen2"
	},
/area/bigredv2/outside/space_port)
"ap" = (
/obj/item/shard,
/turf/open/floor{
	dir = 1;
	icon_state = "darkgreen2"
	},
/area/bigredv2/outside/space_port)
"aq" = (
/turf/open/floor{
	dir = 1;
	icon_state = "darkgreen2"
	},
/area/bigredv2/outside/space_port)
"ar" = (
/obj/structure/noticeboard{
	pixel_y = 30
	},
/turf/open/floor{
	dir = 1;
	icon_state = "darkgreen2"
	},
/area/bigredv2/outside/space_port)
"as" = (
/obj/structure/machinery/vending/cigarette/colony,
/turf/open/floor{
	dir = 5;
	icon_state = "darkgreen2"
	},
/area/bigredv2/outside/space_port)
"at" = (
/turf/open/asphalt/cement{
	icon_state = "cement2"
	},
/area/bigredv2/outside/space_port)
"au" = (
/obj/effect/decal/cleanable/dirt,
/turf/open/asphalt/cement{
	icon_state = "cement4"
	},
/area/bigredv2/outside/space_port)
"av" = (
/obj/effect/landmark/crap_item,
/turf/open/asphalt/cement{
	icon_state = "cement9"
	},
/area/bigredv2/outside/space_port)
"aw" = (
/turf/open/floor{
	icon_state = "dark"
	},
/area/bigredv2/outside/space_port)
"ax" = (
/obj/structure/pipes/standard/simple/hidden/green{
	dir = 6
	},
/obj/effect/decal/cleanable/dirt,
/turf/open/floor{
	icon_state = "dark"
	},
/area/bigredv2/outside/space_port)
"ay" = (
/obj/structure/pipes/standard/simple/hidden/green{
	dir = 4
	},
/turf/open/floor{
	icon_state = "dark"
	},
/area/bigredv2/outside/space_port)
"az" = (
/obj/structure/pipes/vents/pump{
	dir = 8
	},
/turf/open/floor{
	icon_state = "dark"
	},
/area/bigredv2/outside/space_port)
"aA" = (
/obj/effect/decal/cleanable/dirt,
/turf/open/floor{
	icon_state = "dark"
	},
/area/bigredv2/outside/space_port)
"aB" = (
/obj/structure/filingcabinet,
/turf/open/floor{
	dir = 4;
	icon_state = "darkgreen2"
	},
/area/bigredv2/outside/space_port)
"aC" = (
/obj/structure/pipes/standard/simple/hidden/green{
	dir = 6
	},
/turf/open/floor{
	dir = 1;
	icon_state = "asteroidfloor"
	},
/area/bigredv2/outside/space_port)
"aD" = (
/obj/structure/pipes/standard/simple/hidden/green{
	dir = 4
	},
/turf/open/floor{
	dir = 1;
	icon_state = "asteroidfloor"
	},
/area/bigredv2/outside/space_port)
"aE" = (
/obj/structure/pipes/standard/simple/hidden/green{
	dir = 4
	},
/obj/effect/decal/cleanable/dirt,
/turf/open/asphalt/cement,
/area/bigredv2/outside/space_port)
"aF" = (
/obj/structure/pipes/standard/manifold/hidden/green{
	dir = 1
	},
/turf/open/asphalt/cement,
/area/bigredv2/outside/space_port)
"aG" = (
/obj/structure/pipes/standard/simple/hidden/green{
	dir = 4
	},
/turf/open/asphalt/cement{
	icon_state = "cement1";
	dir = 1
	},
/area/bigredv2/outside/space_port)
"aI" = (
/obj/structure/pipes/standard/simple/hidden/green{
	dir = 4
	},
/obj/structure/machinery/door/airlock/multi_tile/almayer/generic{
	dir = 1;
	name = "\improper Spaceport"
	},
/turf/open/floor{
	icon_state = "dark"
	},
/area/bigredv2/outside/space_port)
"aJ" = (
/obj/structure/pipes/standard/simple/hidden/green{
	dir = 9
	},
/turf/open/floor{
	icon_state = "dark"
	},
/area/bigredv2/outside/space_port)
"aK" = (
/obj/effect/decal/cleanable/blood,
/turf/open/floor{
	icon_state = "dark"
	},
/area/bigredv2/outside/space_port)
"aL" = (
/obj/structure/surface/table,
/obj/item/device/flashlight/lamp,
/obj/structure/machinery/door_control{
	id = "Spaceport2";
	name = "Storm Shutters";
	pixel_x = 32
	},
/turf/open/floor{
	dir = 4;
	icon_state = "darkgreen2"
	},
/area/bigredv2/outside/space_port)
"aM" = (
/obj/structure/pipes/standard/simple/hidden/green,
/turf/open/floor{
	dir = 1;
	icon_state = "asteroidfloor"
	},
/area/bigredv2/outside/space_port)
"aN" = (
/obj/effect/decal/cleanable/dirt,
/turf/open/asphalt/cement{
	icon_state = "cement12"
	},
/area/bigredv2/outside/space_port)
"aO" = (
/turf/open/asphalt/cement{
	icon_state = "cement12"
	},
/area/bigredv2/outside/space_port)
"aP" = (
/obj/structure/window/framed/solaris/reinforced,
/obj/structure/machinery/door/poddoor/shutters/almayer{
	dir = 4;
	id = "Spaceport2";
	name = "\improper Spaceport Shutters"
	},
/turf/open/floor/plating,
/area/bigredv2/outside/space_port)
"aQ" = (
/turf/open/floor{
	dir = 8;
	icon_state = "darkgreen2"
	},
/area/bigredv2/outside/space_port)
"aR" = (
/obj/structure/bed/chair/office/dark,
/turf/open/floor{
	icon_state = "dark"
	},
/area/bigredv2/outside/space_port)
"aS" = (
/obj/structure/bed/chair/office/dark{
	dir = 4;
	layer = 3.25
	},
/turf/open/floor{
	icon_state = "dark"
	},
/area/bigredv2/outside/space_port)
"aT" = (
/obj/structure/surface/table,
/turf/open/floor{
	dir = 4;
	icon_state = "darkgreen2"
	},
/area/bigredv2/outside/space_port)
"aU" = (
/obj/structure/pipes/standard/simple/hidden/green{
	dir = 9
	},
/turf/open/floor{
	dir = 4;
	icon_state = "asteroidwarning"
	},
/area/bigredv2/outside/space_port)
"aV" = (
/obj/structure/largecrate,
/turf/open/floor{
	dir = 1;
	icon_state = "asteroidfloor"
	},
/area/bigredv2/outside/space_port)
"aW" = (
/obj/effect/decal/cleanable/dirt,
/turf/open/asphalt/cement{
	icon_state = "cement14"
	},
/area/bigredv2/outside/space_port)
"aX" = (
/obj/structure/pipes/standard/simple/hidden/green,
/obj/effect/decal/cleanable/dirt,
/turf/open/asphalt/cement,
/area/bigredv2/outside/space_port)
"aY" = (
/obj/structure/surface/table,
/obj/effect/landmark/crap_item,
/turf/open/floor{
	dir = 10;
	icon_state = "darkgreen2"
	},
/area/bigredv2/outside/space_port)
"aZ" = (
/obj/structure/surface/table,
/obj/structure/machinery/computer/cameras{
	dir = 1
	},
/turf/open/floor{
	icon_state = "darkgreen2"
	},
/area/bigredv2/outside/space_port)
"ba" = (
/obj/structure/surface/table,
/obj/item/device/radio,
/turf/open/floor{
	icon_state = "darkgreen2"
	},
/area/bigredv2/outside/space_port)
"bb" = (
/turf/open/floor{
	icon_state = "darkgreen2"
	},
/area/bigredv2/outside/space_port)
"bc" = (
/obj/effect/decal/cleanable/dirt,
/turf/open/floor{
	icon_state = "darkgreen2"
	},
/area/bigredv2/outside/space_port)
"bd" = (
/obj/structure/surface/table,
/obj/item/paper,
/obj/item/tool/pen,
/turf/open/floor{
	icon_state = "darkgreen2"
	},
/area/bigredv2/outside/space_port)
"be" = (
/obj/structure/surface/table,
/obj/item/paper_bin,
/turf/open/floor{
	dir = 6;
	icon_state = "darkgreen2"
	},
/area/bigredv2/outside/space_port)
"bh" = (
/turf/closed/wall/solaris/rock,
/area/bigredv2/caves)
"bi" = (
/turf/open/mars,
/area/bigredv2/outside/nw)
"bj" = (
/turf/open/mars{
	icon_state = "mars_dirt_11"
	},
/area/bigredv2/outside/nw)
"bk" = (
/obj/effect/decal/cleanable/dirt,
/turf/open/mars_cave{
	icon_state = "mars_dirt_4"
	},
/area/bigredv2/outside/nw)
"bl" = (
/turf/open/mars_cave{
	icon_state = "mars_dirt_4"
	},
/area/bigredv2/outside/nw)
"bm" = (
/turf/open/floor{
	dir = 10;
	icon_state = "asteroidwarning"
	},
/area/bigredv2/outside/nw)
"bn" = (
/turf/open/floor{
	icon_state = "asteroidwarning"
	},
/area/bigredv2/outside/nw)
"bo" = (
/obj/item/stack/rods,
/obj/effect/decal/cleanable/dirt,
/turf/open/floor{
	icon_state = "asteroidwarning"
	},
/area/bigredv2/outside/nw)
"bp" = (
/obj/item/stack/sheet/metal,
/obj/item/stack/rods,
/obj/effect/decal/cleanable/dirt,
/turf/open/floor{
	icon_state = "asteroidwarning"
	},
/area/bigredv2/outside/nw)
"bq" = (
/obj/structure/lz_sign/solaris_sign,
/turf/open/floor{
	icon_state = "asteroidwarning"
	},
/area/bigredv2/outside/nw)
"br" = (
/obj/item/stack/rods,
/obj/item/stack/rods,
/obj/effect/decal/cleanable/dirt,
/turf/open/floor{
	icon_state = "asteroidwarning"
	},
/area/bigredv2/outside/nw)
"bs" = (
/turf/open/mars{
	icon_state = "mars_dirt_12"
	},
/area/bigredv2/outside/nw)
"bt" = (
/turf/open/mars{
	icon_state = "mars_dirt_13"
	},
/area/bigredv2/outside/nw)
"bu" = (
/obj/structure/fence,
/turf/open/mars_cave{
	icon_state = "mars_dirt_4"
	},
/area/bigredv2/outside/nw)
"bv" = (
/turf/open/asphalt/cement_sunbleached{
	icon_state = "cement_sunbleached3"
	},
/area/bigredv2/outside/nw)
"bx" = (
/obj/effect/decal/strata_decals/grime/grime2{
	dir = 8
	},
/turf/open/asphalt/cement_sunbleached{
	icon_state = "cement_sunbleached1"
	},
/area/bigredv2/outside/nw)
"by" = (
/obj/effect/decal/cleanable/dirt,
/turf/open/mars,
/area/bigredv2/outside/nw)
"bz" = (
/obj/structure/pipes/standard/simple/hidden/green,
/obj/effect/decal/strata_decals/grime/grime4,
/turf/open/asphalt/cement_sunbleached,
/area/bigredv2/outside/nw)
"bA" = (
/turf/open/mars{
	icon_state = "mars_dirt_10"
	},
/area/bigredv2/outside/nw)
"bB" = (
/obj/structure/fence,
/turf/open/mars{
	icon_state = "mars_dirt_10"
	},
/area/bigredv2/outside/nw)
"bC" = (
/obj/effect/decal/cleanable/dirt,
/turf/open/mars{
	icon_state = "mars_dirt_11"
	},
/area/bigredv2/outside/nw)
"bD" = (
/obj/effect/decal/cleanable/dirt,
/obj/structure/largecrate,
/turf/open/floor{
	dir = 9;
	icon_state = "asteroidwarning"
	},
/area/bigredv2/outside/nw)
"bE" = (
/turf/open/floor{
	dir = 1;
	icon_state = "asteroidwarning"
	},
/area/bigredv2/outside/nw)
"bF" = (
/obj/effect/decal/cleanable/dirt,
/turf/open/floor{
	dir = 8;
	icon_state = "asteroidwarning"
	},
/area/bigredv2/outside/nw)
"bG" = (
/turf/open/asphalt/cement_sunbleached,
/area/bigredv2/outside/nw)
"bH" = (
/obj/structure/cargo_container/wy/left,
/turf/open/floor{
	dir = 1;
	icon_state = "asteroidfloor"
	},
/area/bigredv2/outside/nw)
"bI" = (
/obj/structure/cargo_container/wy/mid,
/turf/open/floor{
	dir = 1;
	icon_state = "asteroidfloor"
	},
/area/bigredv2/outside/nw)
"bJ" = (
/obj/structure/cargo_container/wy/right,
/turf/open/floor{
	dir = 4;
	icon_state = "asteroidwarning"
	},
/area/bigredv2/outside/nw)
"bL" = (
/obj/structure/pipes/standard/simple/hidden/green{
	dir = 5
	},
/turf/open/asphalt/cement_sunbleached,
/area/bigredv2/outside/nw)
"bM" = (
/obj/structure/pipes/standard/simple/hidden/green{
	dir = 4
	},
/turf/open/asphalt/cement_sunbleached,
/area/bigredv2/outside/nw)
"bN" = (
/obj/structure/pipes/standard/simple/hidden/green{
	dir = 10
	},
/turf/open/asphalt/cement_sunbleached,
/area/bigredv2/outside/nw)
"bP" = (
/obj/structure/cargo_container/kelland/left,
/turf/open/floor{
	icon_state = "asteroidwarning"
	},
/area/bigredv2/outside/nw)
"bQ" = (
/obj/structure/cargo_container/kelland/right,
/turf/open/floor{
	icon_state = "asteroidwarning"
	},
/area/bigredv2/outside/nw)
"bS" = (
/obj/effect/decal/cleanable/dirt,
/turf/open/asphalt/cement_sunbleached,
/area/bigredv2/outside/nw)
"bT" = (
/obj/structure/fence,
/turf/open/mars,
/area/bigredv2/outside/nw)
"bU" = (
/turf/open/asphalt/cement_sunbleached{
	icon_state = "cement_sunbleached1"
	},
/area/bigredv2/outside/nw)
"bV" = (
/obj/structure/pipes/standard/simple/hidden/green,
/turf/open/asphalt/cement_sunbleached{
	icon_state = "cement_sunbleached1"
	},
/area/bigredv2/outside/nw)
"bW" = (
/obj/structure/fence,
/turf/open/mars{
	icon_state = "mars_dirt_3"
	},
/area/bigredv2/outside/nw)
"bX" = (
/obj/effect/decal/cleanable/dirt,
/turf/open/floor{
	icon_state = "asteroidwarning"
	},
/area/bigredv2/outside/nw)
"bY" = (
/turf/template_noop,
/area/template_noop)
"bZ" = (
/obj/effect/decal/cleanable/dirt,
/turf/open/asphalt/cement_sunbleached{
	icon_state = "cement_sunbleached4"
	},
/area/bigredv2/outside/nw)
"ca" = (
/turf/open/mars{
	icon_state = "mars_dirt_9"
	},
/area/bigredv2/outside/nw)
"cb" = (
/turf/open/mars{
	icon_state = "mars_dirt_14"
	},
/area/bigredv2/outside/nw)
"cc" = (
/obj/effect/decal/cleanable/blood,
/obj/effect/landmark/corpsespawner/engineer,
/turf/open/floor{
	icon_state = "dark"
	},
/area/bigredv2/outside/space_port)
"cy" = (
/obj/structure/pipes/standard/simple/hidden/green{
	dir = 4
	},
/turf/open/asphalt/cement,
/area/bigredv2/outside/space_port)
"ef" = (
/obj/item/trash/cigbutt,
/turf/open/asphalt/cement_sunbleached{
	icon_state = "cement_sunbleached12"
	},
/area/bigredv2/outside/nw)
"if" = (
/obj/effect/decal/strata_decals/grime/grime1{
	dir = 1
	},
/turf/open/asphalt/cement_sunbleached{
	icon_state = "cement_sunbleached12"
	},
/area/bigredv2/outside/nw)
"iA" = (
/turf/open/asphalt/cement_sunbleached{
	icon_state = "cement_sunbleached9"
	},
/area/bigredv2/outside/nw)
"iR" = (
/obj/effect/decal/strata_decals/grime/grime3,
/turf/open/asphalt/cement_sunbleached{
	icon_state = "cement_sunbleached3"
	},
/area/bigredv2/outside/nw)
"jA" = (
/turf/open/floor{
	dir = 5;
	icon_state = "asteroidwarning"
	},
/area/bigredv2/outside/nw)
"km" = (
/turf/open/asphalt/cement{
	icon_state = "cement15"
	},
/area/bigredv2/outside/space_port)
"mX" = (
/obj/item/trash/popcorn{
	pixel_y = 9
	},
/turf/open/asphalt/cement_sunbleached{
	icon_state = "cement_sunbleached4"
	},
/area/bigredv2/outside/nw)
"qe" = (
/obj/item/trash/waffles{
	pixel_x = -6;
	pixel_y = 10
	},
/turf/open/asphalt/cement_sunbleached{
	icon_state = "cement_sunbleached4"
	},
/area/bigredv2/outside/nw)
"qJ" = (
/turf/open/asphalt/cement_sunbleached{
	icon_state = "cement_sunbleached15"
	},
/area/bigredv2/outside/nw)
"sb" = (
/obj/effect/decal/cleanable/dirt,
/turf/open/asphalt/cement_sunbleached{
	icon_state = "cement_sunbleached3"
	},
/area/bigredv2/outside/nw)
"tH" = (
/obj/effect/decal/strata_decals/grime/grime4,
/turf/open/asphalt/cement_sunbleached,
/area/bigredv2/outside/nw)
"uR" = (
/obj/structure/pipes/standard/simple/hidden/green,
/turf/open/asphalt/cement_sunbleached,
/area/bigredv2/outside/nw)
"vr" = (
/obj/effect/decal/strata_decals/grime/grime4,
/turf/open/asphalt/cement_sunbleached{
	icon_state = "cement_sunbleached3"
	},
/area/bigredv2/outside/nw)
"xv" = (
/obj/item/trash/cigbutt{
	pixel_x = 7;
	pixel_y = 7
	},
/turf/open/asphalt/cement_sunbleached,
/area/bigredv2/outside/nw)
"zD" = (
/obj/effect/decal/strata_decals/grime/grime1{
	dir = 4
	},
/turf/open/asphalt/cement_sunbleached{
	icon_state = "cement_sunbleached3"
	},
/area/bigredv2/outside/nw)
"AY" = (
/obj/effect/decal/strata_decals/grime/grime2{
	dir = 4
	},
/turf/open/asphalt/cement_sunbleached{
	icon_state = "cement_sunbleached3"
	},
/area/bigredv2/outside/nw)
"Bn" = (
/obj/structure/pipes/standard/simple/hidden/green,
/turf/open/asphalt/cement{
	icon_state = "cement12"
	},
/area/bigredv2/outside/space_port)
"DS" = (
/turf/open/floor{
	dir = 6;
	icon_state = "asteroidwarning"
	},
/area/bigredv2/outside/nw)
"Ed" = (
/obj/effect/decal/cleanable/dirt,
/turf/open/asphalt/cement_sunbleached{
	icon_state = "cement_sunbleached12"
	},
/area/bigredv2/outside/nw)
"Fq" = (
/obj/effect/decal/strata_decals/grime/grime3,
/turf/open/asphalt/cement_sunbleached,
/area/bigredv2/outside/nw)
"Fx" = (
/obj/structure/pipes/standard/simple/hidden/green,
/turf/open/asphalt/cement,
/area/bigredv2/outside/space_port)
"GS" = (
/obj/item/trash/hotdog{
	pixel_x = -12;
	pixel_y = -11
	},
/turf/open/asphalt/cement_sunbleached{
	icon_state = "cement_sunbleached3"
	},
/area/bigredv2/outside/nw)
"Hn" = (
/obj/item/trash/cigbutt{
	pixel_x = -6;
	pixel_y = -9
	},
/turf/open/asphalt/cement_sunbleached{
	icon_state = "cement_sunbleached2"
	},
/area/bigredv2/outside/nw)
"HS" = (
/obj/effect/decal/cleanable/dirt,
/turf/open/asphalt/cement{
	icon_state = "cement3"
	},
/area/bigredv2/outside/space_port)
"Ii" = (
/turf/open/asphalt/cement{
	icon_state = "cement4"
	},
/area/bigredv2/outside/space_port)
"Mr" = (
/turf/open/asphalt/cement{
	icon_state = "cement1";
	dir = 1
	},
/area/bigredv2/outside/space_port)
"Pj" = (
/turf/open/asphalt/cement_sunbleached{
	icon_state = "cement_sunbleached12"
	},
/area/bigredv2/outside/nw)
"QT" = (
/turf/open/asphalt/cement_sunbleached{
	icon_state = "cement_sunbleached4"
	},
/area/bigredv2/outside/nw)
"Uu" = (
/obj/structure/pipes/standard/simple/hidden/green{
	dir = 4
	},
/turf/open/asphalt/cement{
	icon_state = "cement3"
	},
/area/bigredv2/outside/space_port)
"Wv" = (
/obj/effect/decal/strata_decals/grime/grime2,
/turf/open/asphalt/cement_sunbleached{
	icon_state = "cement_sunbleached9"
	},
/area/bigredv2/outside/nw)
"Ww" = (
/obj/structure/pipes/standard/simple/hidden/green,
/turf/open/asphalt/cement_sunbleached{
	icon_state = "cement_sunbleached4"
	},
/area/bigredv2/outside/nw)
"WL" = (
/obj/effect/decal/cleanable/blood/gibs/body,
/turf/open/asphalt/cement_sunbleached,
/area/bigredv2/outside/nw)
"Xr" = (
/turf/open/asphalt/cement,
/area/bigredv2/outside/space_port)

(1,1,1) = {"
aa
ak
ak
ak
ak
aD
ac
bh
bh
by
by
by
bY
bY
bY
bY
bY
bY
bi
"}
(2,1,1) = {"
ab
ab
ak
aC
aM
aU
ac
bi
bt
bj
bC
bj
iA
bU
bY
bY
bU
qJ
bi
"}
(3,1,1) = {"
ac
ac
at
Uu
aW
ac
ac
bj
bk
bu
bu
bu
bT
bT
QT
Pj
bi
bi
bi
"}
(4,1,1) = {"
ac
ak
Ii
aE
aN
aV
ac
bk
bk
bu
bD
bF
bm
bT
bZ
Ed
bi
bi
bi
"}
(5,1,1) = {"
ad
ak
Ii
cy
aO
ak
ac
bl
bl
bu
bE
bH
bP
bT
bZ
Pj
bi
bi
bi
"}
(6,1,1) = {"
ae
al
au
cy
aO
aV
ac
bm
bk
bu
bE
bI
bQ
bT
QT
Pj
by
bi
bi
"}
(7,1,1) = {"
ac
ak
au
aE
aO
ak
ac
bn
bu
bu
jA
bJ
DS
bT
QT
Pj
bi
bi
bi
"}
(8,1,1) = {"
ac
am
au
aE
Xr
HS
aW
Hn
vr
sb
sb
bv
AY
bv
bG
bG
bv
GS
bv
"}
(9,1,1) = {"
ad
ak
Ii
aF
Fx
aX
Bn
Ww
uR
uR
uR
bL
bG
Fq
bG
bG
bG
Fq
bS
"}
(10,1,1) = {"
ad
ak
av
aG
Mr
Mr
km
Wv
bx
bU
bG
bM
bS
bU
bU
bU
bU
bU
bU
"}
(11,1,1) = {"
ac
am
ak
aD
ak
ak
ac
bq
bu
bu
QT
bM
if
bu
bl
bl
bl
bl
bl
"}
(12,1,1) = {"
ac
ac
aw
aI
aP
aP
ac
bn
bl
bu
bZ
bM
Pj
bu
bl
bl
bl
bl
bl
"}
(13,1,1) = {"
ac
an
ax
aJ
aQ
aY
ac
bn
bs
bl
QT
bM
bS
bv
bv
zD
iR
bv
bv
"}
(14,1,1) = {"
ac
ao
ay
aA
aR
aZ
ac
bo
bi
bA
QT
bM
bG
tH
WL
bG
bG
bG
bG
"}
(15,1,1) = {"
ae
ap
az
aw
aK
ba
ai
bX
bi
bA
qe
bN
bz
bV
bV
bV
bV
bV
bV
"}
(16,1,1) = {"
ah
aq
aw
aA
aA
bb
ai
bp
bi
bB
mX
bG
Pj
bu
bu
bs
bs
bl
bl
"}
(17,1,1) = {"
ai
aq
aA
cc
aw
bc
ai
bn
bi
bB
QT
xv
ef
bu
ca
bi
bi
cb
bs
"}
(18,1,1) = {"
ac
ar
aw
aA
aS
bd
ac
br
bi
bB
QT
bG
Pj
bW
bi
bi
bi
bi
bi
"}
(19,1,1) = {"
aj
as
aB
aL
aT
be
ac
bX
bi
bB
QT
bG
if
bW
bi
bi
bi
bi
bi
"}
