//MAP CONVERTED BY dmm2tgm.py THIS HEADER COMMENT PREVENTS RECONVERSION, DO NOT REMOVE
"ax" = (
/obj/effect/landmark/corpsespawner/pmc,
/turf/open/floor{
	icon_state = "wood"
	},
/area/template_noop)
"bM" = (
/turf/open/mars_cave{
	icon_state = "mars_dirt_4";
	tag = "icon-mars_dirt_4"
	},
/area/template_noop)
"cd" = (
/obj/structure/surface/table/woodentable,
/obj/item/storage/firstaid/regular,
/turf/open/floor{
	icon_state = "wood"
	},
/area/template_noop)
"ct" = (
/obj/structure/machinery/cm_vending/sorted/boozeomat,
/obj/structure/machinery/light{
	dir = 4;
	tag = "icon-tube1 (EAST)"
	},
/turf/open/floor{
	icon_state = "wood"
	},
/area/template_noop)
"eC" = (
/turf/open/floor,
/area/template_noop)
"eQ" = (
/obj/structure/machinery/reagentgrinder,
/obj/structure/surface/table/woodentable,
/turf/open/floor{
	icon_state = "wood"
	},
/area/template_noop)
"fa" = (
/obj/structure/surface/table/woodentable,
/obj/item/storage/firstaid/adv,
/turf/open/floor{
	icon_state = "wood"
	},
/area/template_noop)
"fi" = (
/obj/structure/machinery/alarm{
	dir = 4;
	pixel_x = -30
	},
/turf/open/floor{
	dir = 8;
	icon_state = "carpet15-15";
	tag = "icon-carpet15-15 (WEST)"
	},
/area/template_noop)
"fz" = (
/obj/structure/bed/chair/wood/normal{
	dir = 8;
	tag = ""
	},
/obj/item/ammo_casing/bullet,
/obj/effect/landmark/survivor_spawner,
/turf/open/floor{
	icon_state = "wood"
	},
/area/template_noop)
"fG" = (
/obj/structure/barricade/metal/wired{
	icon_state = "metal_2"
	},
/obj/item/ammo_casing/bullet,
/turf/open/floor{
	icon_state = "wood"
	},
/area/template_noop)
"fJ" = (
/obj/structure/pipes/standard/simple/hidden/green{
	dir = 6
	},
/obj/structure/barricade/plasteel/wired{
	icon_state = "plasteel_2"
	},
/obj/effect/landmark/survivor_spawner,
/turf/open/floor{
	icon_state = "wood"
	},
/area/template_noop)
"fS" = (
/obj/structure/machinery/door/airlock/almayer/medical/glass{
	dir = 1;
	name = "\improper Recreation"
	},
/obj/structure/machinery/door/poddoor/shutters/almayer{
	id = "Bar Complex";
	name = "\improper Bar Complex Shutters"
	},
/turf/open/floor{
	icon_state = "wood"
	},
/area/template_noop)
"gv" = (
/turf/open/floor{
	dir = 8;
	icon_state = "carpet15-15";
	tag = "icon-carpet15-15 (WEST)"
	},
/area/template_noop)
"gM" = (
/obj/structure/bed,
/turf/open/floor{
	icon_state = "wood"
	},
/area/template_noop)
"gV" = (
/obj/structure/pipes/standard/manifold/hidden/green,
/turf/open/floor{
	icon_state = "wood"
	},
/area/template_noop)
"ha" = (
/obj/structure/reagent_dispensers/beerkeg,
/turf/open/floor{
	icon_state = "wood"
	},
/area/template_noop)
"he" = (
/turf/open/floor{
	dir = 8;
	icon_state = "carpet11-12";
	tag = "icon-carpet11-12 (WEST)"
	},
/area/template_noop)
"hz" = (
/obj/structure/pipes/standard/simple/hidden/green,
/turf/open/floor{
	icon_state = "wood"
	},
/area/template_noop)
"hP" = (
/obj/structure/pipes/standard/simple/hidden/green{
	dir = 4
	},
/turf/open/floor{
	icon_state = "wood"
	},
/area/template_noop)
"ic" = (
/obj/effect/landmark/corpsespawner,
/turf/open/floor{
	icon_state = "wood"
	},
/area/template_noop)
"iq" = (
/obj/structure/pipes/standard/manifold/hidden/green{
	dir = 1
	},
/turf/open/floor{
	icon_state = "wood"
	},
/area/template_noop)
"iD" = (
/obj/structure/machinery/chem_dispenser/soda{
	density = 0;
	pixel_y = 32
	},
/obj/structure/machinery/door_control{
	id = "Bar Complex";
	name = "Storm Shutters";
	pixel_x = 32
	},
/obj/structure/machinery/camera/autoname{
	dir = 8
	},
/turf/open/floor{
	icon_state = "wood"
	},
/area/template_noop)
"jD" = (
/obj/structure/machinery/light,
/obj/structure/barricade/metal/wired{
	icon_state = "metal_2"
	},
/obj/item/ammo_casing/bullet,
/obj/effect/landmark/survivor_spawner,
/turf/open/floor{
	icon_state = "wood"
	},
/area/template_noop)
"kp" = (
/obj/structure/machinery/door/airlock/multi_tile/almayer/generic{
	name = "\improper Bar"
	},
/obj/structure/machinery/door/poddoor/shutters/almayer{
	id = "Bar Complex";
	name = "\improper Bar Complex Shutters"
	},
/turf/open/floor{
	icon_state = "wood"
	},
/area/template_noop)
"lb" = (
/obj/structure/bed/stool,
/turf/open/floor{
	icon_state = "wood"
	},
/area/template_noop)
"lq" = (
/obj/structure/machinery/computer/arcade,
/turf/open/floor{
	icon_state = "wood"
	},
/area/template_noop)
"lI" = (
/obj/structure/window/framed/solaris,
/obj/structure/machinery/door/poddoor/shutters/almayer{
	dir = 4;
	id = "Bar Complex";
	name = "\improper Bar Complex Shutters"
	},
/turf/open/floor/plating,
/area/template_noop)
"md" = (
/obj/structure/pipes/standard/simple/hidden/green{
	dir = 4
	},
/obj/structure/surface/table/woodentable,
/obj/item/stack/sheet/wood/large_stack,
/obj/item/stack/sheet/wood/large_stack,
/turf/open/floor{
	icon_state = "wood"
	},
/area/template_noop)
"mi" = (
/turf/open/floor{
	icon_state = "wood"
	},
/area/template_noop)
"nK" = (
/obj/structure/bed/stool,
/obj/structure/pipes/standard/simple/hidden/green{
	dir = 4
	},
/obj/effect/landmark/survivor_spawner,
/turf/open/floor{
	icon_state = "wood"
	},
/area/template_noop)
"nV" = (
/obj/structure/machinery/camera/autoname,
/obj/structure/pipes/standard/simple/hidden/green{
	dir = 10
	},
/obj/structure/barricade/plasteel/wired{
	dir = 8
	},
/turf/open/floor{
	icon_state = "wood"
	},
/area/template_noop)
"nX" = (
/obj/effect/landmark/survivor_spawner,
/turf/open/floor{
	icon_state = "wood"
	},
/area/template_noop)
"ob" = (
/obj/structure/barricade/metal/wired{
	icon_state = "metal_2"
	},
/obj/effect/landmark/survivor_spawner,
/turf/open/floor{
	icon_state = "wood"
	},
/area/template_noop)
"oe" = (
/obj/structure/pipes/standard/simple/hidden/green{
	dir = 4
	},
/obj/structure/machinery/door/poddoor/shutters/almayer{
	dir = 4;
	id = "Bar Complex";
	name = "\improper Bar Complex Shutters"
	},
/turf/open/floor{
	icon_state = "wood"
	},
/area/template_noop)
"oA" = (
/obj/effect/decal/cleanable/blood,
/turf/open/floor{
	dir = 8;
	icon_state = "carpet15-15";
	tag = "icon-carpet15-15 (WEST)"
	},
/area/template_noop)
"oD" = (
/obj/structure/barricade/plasteel/wired{
	dir = 1;
	icon_state = "plasteel_2"
	},
/turf/open/floor{
	icon_state = "wood"
	},
/area/template_noop)
"oK" = (
/obj/structure/surface/table/woodentable,
/obj/structure/pipes/vents/pump{
	dir = 8
	},
/turf/open/floor{
	icon_state = "wood"
	},
/area/template_noop)
"pf" = (
/obj/structure/barricade/metal/wired{
	icon_state = "metal_2";
	dir = 8
	},
/obj/effect/landmark/corpsespawner/engineer,
/obj/effect/landmark/survivor_spawner,
/turf/open/floor{
	icon_state = "wood"
	},
/area/template_noop)
"pL" = (
/obj/structure/barricade/metal/wired{
	icon_state = "metal_2"
	},
/obj/structure/barricade/plasteel/wired{
	dir = 4;
	icon_state = "plasteel_2"
	},
/obj/effect/landmark/survivor_spawner,
/turf/open/floor{
	icon_state = "wood"
	},
/area/template_noop)
"qj" = (
/turf/open/floor/plating,
/area/template_noop)
"qQ" = (
/obj/effect/decal/cleanable/blood{
	icon_state = "gib6";
	tag = "icon-gib6"
	},
/turf/open/floor{
	icon_state = "wood"
	},
/area/template_noop)
"qS" = (
/obj/structure/window/framed/solaris,
/obj/structure/machinery/door/poddoor/shutters/almayer{
	id = "Bar Complex";
	name = "\improper Bar Complex Shutters"
	},
/turf/open/floor/plating,
/area/template_noop)
"qX" = (
/obj/structure/pipes/standard/simple/hidden/green,
/turf/open/floor/plating,
/area/template_noop)
"qY" = (
/obj/structure/machinery/light{
	dir = 8
	},
/turf/open/floor{
	icon_state = "wood"
	},
/area/template_noop)
"rb" = (
/obj/structure/pipes/standard/simple/hidden/green{
	dir = 9
	},
/turf/open/floor{
	icon_state = "wood"
	},
/area/template_noop)
"rd" = (
/obj/structure/barricade/plasteel/wired{
	dir = 1;
	icon_state = "plasteel_2"
	},
/obj/effect/landmark/survivor_spawner,
/turf/open/floor{
	dir = 8;
	icon_state = "carpet15-15";
	tag = "icon-carpet15-15 (WEST)"
	},
/area/template_noop)
"rp" = (
/obj/structure/pipes/standard/simple/hidden/green,
/obj/structure/machinery/door/airlock/almayer/maint{
	dir = 1;
	name = "\improper Bar Maintenance";
	req_one_access = null
	},
/obj/structure/machinery/door/poddoor/shutters/almayer{
	id = "Bar Complex";
	name = "\improper Bar Complex Shutters"
	},
/turf/open/floor/plating,
/area/template_noop)
"ry" = (
/obj/effect/landmark/survivor_spawner,
/turf/open/floor{
	dir = 8;
	icon_state = "carpet15-15";
	tag = "icon-carpet15-15 (WEST)"
	},
/area/template_noop)
"rD" = (
/obj/structure/pipes/standard/simple/hidden/green,
/obj/item/ammo_casing/bullet,
/turf/open/floor{
	icon_state = "wood"
	},
/area/template_noop)
"sg" = (
/obj/structure/barricade/metal/wired{
	icon_state = "metal_2"
	},
/obj/structure/barricade/metal/wired{
	icon_state = "metal_2";
	dir = 8
	},
/obj/effect/landmark/survivor_spawner,
/turf/open/floor{
	icon_state = "wood"
	},
/area/template_noop)
"tj" = (
/obj/structure/surface/table/woodentable,
/obj/item/toy/beach_ball,
/obj/effect/landmark/item_pool_spawner/survivor_ammo/buckshot,
/turf/open/floor{
	icon_state = "wood"
	},
/area/template_noop)
"tq" = (
/obj/structure/barricade/metal/wired{
	icon_state = "metal_2";
	dir = 8
	},
/obj/effect/landmark/corpsespawner/chef,
/obj/effect/landmark/survivor_spawner,
/turf/open/floor{
	icon_state = "wood"
	},
/area/template_noop)
"ts" = (
/turf/open/floor{
	dir = 8;
	icon_state = "carpet9-4";
	tag = "icon-carpet9-4 (WEST)"
	},
/area/template_noop)
"tF" = (
/obj/structure/reagent_dispensers/fueltank,
/turf/open/floor{
	icon_state = "wood"
	},
/area/template_noop)
"tH" = (
/obj/structure/machinery/light,
/obj/structure/pipes/standard/simple/hidden/green{
	dir = 4
	},
/turf/open/floor,
/area/template_noop)
"tK" = (
/obj/structure/machinery/light{
	dir = 1;
	tag = "icon-tube1 (NORTH)"
	},
/turf/open/floor/plating,
/area/template_noop)
"tR" = (
/obj/structure/barricade/metal/wired{
	dir = 1;
	icon_state = "metal_2"
	},
/turf/open/floor{
	icon_state = "wood"
	},
/area/template_noop)
"ul" = (
/obj/item/paper_bin,
/obj/structure/barricade/metal/wired{
	icon_state = "metal_2"
	},
/turf/open/floor{
	icon_state = "wood"
	},
/area/template_noop)
"uu" = (
/obj/structure/machinery/power/apc,
/turf/open/floor{
	icon_state = "wood"
	},
/area/template_noop)
"uR" = (
/obj/structure/pipes/standard/simple/hidden/green,
/obj/structure/barricade/plasteel/wired{
	dir = 1;
	icon_state = "plasteel_2"
	},
/obj/effect/landmark/survivor_spawner,
/turf/open/floor{
	icon_state = "wood"
	},
/area/template_noop)
"uZ" = (
/obj/structure/pipes/standard/manifold/hidden/green,
/turf/open/floor,
/area/template_noop)
"vc" = (
/obj/structure/machinery/door_control{
	id = "Dormitories";
	name = "Storm Shutters";
	pixel_y = -32
	},
/obj/structure/machinery/camera/autoname{
	dir = 1
	},
/turf/open/floor{
	icon_state = "wood"
	},
/area/template_noop)
"vv" = (
/obj/structure/pipes/standard/simple/hidden/green{
	dir = 4
	},
/obj/structure/barricade/plasteel/wired{
	dir = 4;
	icon_state = "plasteel_2"
	},
/obj/effect/landmark/survivor_spawner,
/turf/open/floor{
	icon_state = "wood"
	},
/area/template_noop)
"vQ" = (
/obj/effect/decal/cleanable/blood,
/obj/effect/landmark/corpsespawner/pmc,
/turf/open/floor{
	icon_state = "wood"
	},
/area/template_noop)
"yz" = (
/obj/structure/machinery/squeezer,
/turf/open/floor{
	icon_state = "wood"
	},
/area/template_noop)
"zm" = (
/obj/structure/bed/stool,
/obj/effect/landmark/survivor_spawner,
/turf/open/floor{
	icon_state = "wood"
	},
/area/template_noop)
"zV" = (
/obj/structure/machinery/door/airlock/multi_tile/almayer/generic{
	dir = 1;
	name = "\improper Bar"
	},
/obj/structure/machinery/door/poddoor/shutters/almayer{
	dir = 4;
	id = "Bar Complex";
	name = "\improper Bar Complex Shutters"
	},
/turf/open/floor{
	icon_state = "wood"
	},
/area/template_noop)
"Ac" = (
/obj/structure/pipes/standard/simple/hidden/green,
/obj/effect/decal/cleanable/dirt,
/turf/open/floor{
	icon_state = "grimy"
	},
/area/template_noop)
"AI" = (
/obj/structure/surface/table/woodentable,
/obj/structure/largecrate/guns/merc{
	name = "\improper dodgy crate"
	},
/obj/structure/largecrate/guns/merc{
	name = "\improper dodgy crate"
	},
/obj/structure/largecrate/guns/merc{
	name = "\improper dodgy crate"
	},
/turf/open/floor{
	icon_state = "wood"
	},
/area/template_noop)
"Bm" = (
/obj/effect/decal/cleanable/dirt,
/turf/open/floor{
	icon_state = "grimy"
	},
/area/template_noop)
"BN" = (
/obj/structure/pipes/standard/simple/hidden/green{
	dir = 10
	},
/turf/open/floor/plating,
/area/template_noop)
"Cb" = (
/obj/structure/pipes/standard/simple/hidden/green{
	dir = 4
	},
/obj/structure/machinery/alarm{
	dir = 1;
	pixel_y = -30;
	tag = "icon-alarm0 (NORTH)"
	},
/turf/open/floor,
/area/template_noop)
"Cm" = (
/obj/structure/closet/boxinggloves,
/turf/open/floor{
	icon_state = "wood"
	},
/area/template_noop)
"Cn" = (
/obj/structure/bed/chair/wood/normal{
	dir = 4;
	tag = ""
	},
/obj/effect/landmark/survivor_spawner,
/turf/open/floor{
	icon_state = "wood"
	},
/area/template_noop)
"CB" = (
/obj/structure/pipes/standard/simple/hidden/green,
/obj/effect/landmark/corpsespawner/doctor,
/turf/open/floor{
	icon_state = "wood"
	},
/area/template_noop)
"Dc" = (
/obj/structure/pipes/standard/simple/hidden/green{
	dir = 4
	},
/obj/structure/surface/table/woodentable,
/obj/item/stack/sheet/metal/large_stack,
/obj/item/stack/sheet/metal/large_stack,
/obj/item/ammo_casing/bullet,
/turf/open/floor{
	icon_state = "wood"
	},
/area/template_noop)
"Dr" = (
/obj/effect/decal/cleanable/blood,
/turf/open/floor{
	icon_state = "wood"
	},
/area/template_noop)
"Ea" = (
/obj/structure/machinery/light{
	dir = 1
	},
/turf/open/floor{
	dir = 8;
	icon_state = "carpet15-15";
	tag = "icon-carpet15-15 (WEST)"
	},
/area/template_noop)
"Eb" = (
/turf/open/floor{
	dir = 8;
	icon_state = "carpet13-5";
	tag = "icon-carpet13-5 (WEST)"
	},
/area/template_noop)
"Fa" = (
/obj/structure/bed/chair/wood/normal{
	dir = 8;
	tag = ""
	},
/obj/effect/landmark/survivor_spawner,
/turf/open/floor{
	icon_state = "wood"
	},
/area/template_noop)
"Fz" = (
/obj/structure/barricade/plasteel/wired{
	icon_state = "plasteel_2"
	},
/obj/effect/landmark/survivor_spawner,
/turf/open/floor{
	icon_state = "wood"
	},
/area/template_noop)
"FC" = (
/obj/structure/pipes/standard/simple/hidden/green,
/obj/effect/landmark/corpsespawner/colonist,
/turf/open/floor{
	icon_state = "wood"
	},
/area/template_noop)
"FP" = (
/obj/structure/surface/table/woodentable,
/obj/structure/largecrate/merc/ammo,
/obj/structure/largecrate/merc/ammo,
/obj/structure/largecrate/merc/ammo,
/turf/open/floor{
	icon_state = "wood"
	},
/area/template_noop)
"Gc" = (
/obj/structure/surface/table/woodentable,
/obj/effect/landmark/item_pool_spawner/survivor_ammo/buckshot,
/turf/open/floor{
	icon_state = "wood"
	},
/area/template_noop)
"Gi" = (
/obj/effect/decal/cleanable/blood{
	layer = 3
	},
/obj/structure/barricade/metal/wired{
	icon_state = "metal_2"
	},
/obj/effect/landmark/survivor_spawner,
/turf/open/floor{
	icon_state = "wood"
	},
/area/template_noop)
"Gt" = (
/obj/structure/barricade/plasteel/wired{
	dir = 1;
	icon_state = "plasteel_2"
	},
/turf/open/floor{
	dir = 8;
	icon_state = "carpet15-15";
	tag = "icon-carpet15-15 (WEST)"
	},
/area/template_noop)
"GX" = (
/obj/structure/surface/table/woodentable,
/obj/item/stack/sandbags/large_stack,
/obj/item/stack/sandbags/large_stack,
/obj/item/tool/shovel/etool,
/obj/item/stack/sandbags_empty/full,
/obj/item/stack/sandbags_empty/full,
/turf/open/floor{
	icon_state = "wood"
	},
/area/template_noop)
"HC" = (
/obj/structure/pipes/standard/simple/hidden/green{
	dir = 4
	},
/turf/open/floor/plating,
/area/template_noop)
"Ic" = (
/obj/structure/pipes/standard/manifold/hidden/green{
	dir = 8
	},
/turf/open/floor/plating,
/area/template_noop)
"In" = (
/obj/structure/pipes/vents/pump{
	dir = 1
	},
/turf/open/floor{
	icon_state = "wood"
	},
/area/template_noop)
"IA" = (
/turf/open/floor{
	icon_state = "grimy"
	},
/area/template_noop)
"IP" = (
/obj/structure/machinery/door/airlock/almayer/generic{
	dir = 1;
	name = "\improper Bar Backroom"
	},
/turf/open/floor{
	icon_state = "wood"
	},
/area/template_noop)
"Jk" = (
/obj/structure/pipes/standard/simple/hidden/green,
/obj/item/ammo_casing/bullet,
/obj/item/ammo_casing/bullet,
/turf/open/floor{
	icon_state = "wood"
	},
/area/template_noop)
"Kv" = (
/obj/structure/bed/chair/wood/normal{
	dir = 4;
	tag = ""
	},
/obj/effect/landmark/survivor_spawner,
/obj/effect/landmark/corpsespawner/pmc,
/turf/open/floor{
	icon_state = "wood"
	},
/area/template_noop)
"KB" = (
/obj/structure/barricade/plasteel/wired,
/turf/open/floor{
	icon_state = "wood"
	},
/area/template_noop)
"Ld" = (
/turf/open/floor{
	icon_state = "asteroidwarning";
	tag = "icon-asteroidwarning"
	},
/area/template_noop)
"Li" = (
/obj/item/device/radio/intercom{
	freerange = 1;
	frequency = 1469;
	name = "General Listening Channel";
	pixel_x = 30
	},
/turf/open/floor{
	icon_state = "wood"
	},
/area/template_noop)
"LT" = (
/obj/structure/machinery/light{
	dir = 8;
	tag = "icon-tube1 (WEST)"
	},
/turf/open/floor{
	icon_state = "wood"
	},
/area/template_noop)
"Mr" = (
/obj/structure/surface/table/woodentable,
/obj/item/tool/weldpack,
/obj/item/tool/weldingtool,
/obj/item/clothing/glasses/welding,
/turf/open/floor{
	icon_state = "wood"
	},
/area/template_noop)
"Nm" = (
/obj/structure/pipes/standard/simple/hidden/green{
	dir = 4
	},
/obj/structure/machinery/door/airlock/almayer/generic{
	name = "\improper Bar Backroom"
	},
/turf/open/floor{
	icon_state = "wood"
	},
/area/template_noop)
"Nn" = (
/obj/structure/surface/table/woodentable,
/obj/item/ammo_box/magazine/shotgun/buckshot,
/obj/item/clothing/suit/armor/vest,
/obj/item/clothing/suit/armor/vest,
/obj/item/clothing/suit/armor/vest,
/obj/item/ammo_casing/bullet,
/turf/open/floor{
	icon_state = "wood"
	},
/area/template_noop)
"Ou" = (
/obj/structure/pipes/standard/simple/hidden/green{
	dir = 4
	},
/obj/structure/barricade/wooden{
	desc = "This barricade is heavily reinforced. Nothing short of blasting it open seems like it'll do the trick, that or melting the breams supporting it...";
	dir = 4;
	health = 25000
	},
/turf/open/floor/plating,
/area/template_noop)
"Qn" = (
/obj/structure/pipes/standard/simple/hidden/green{
	dir = 5
	},
/obj/structure/bed/chair/wood/normal{
	dir = 4;
	tag = ""
	},
/obj/effect/landmark/survivor_spawner,
/turf/open/floor{
	icon_state = "wood"
	},
/area/template_noop)
"Qz" = (
/obj/structure/pipes/standard/manifold/hidden/green{
	dir = 8
	},
/obj/structure/barricade/plasteel/wired{
	dir = 1;
	icon_state = "plasteel_2"
	},
/turf/open/floor{
	icon_state = "wood"
	},
/area/template_noop)
"QA" = (
/obj/effect/landmark/corpsespawner/colonist,
/turf/open/floor{
	icon_state = "wood"
	},
/area/template_noop)
"QG" = (
/obj/structure/machinery/light,
/turf/open/floor{
	icon_state = "wood"
	},
/area/template_noop)
"QK" = (
/turf/closed/wall/solaris,
/area/template_noop)
"Rs" = (
/obj/structure/pipes/standard/simple/hidden/green{
	dir = 4
	},
/obj/structure/barricade/wooden{
	desc = "This barricade is heavily reinforced. Nothing short of blasting it open seems like it'll do the trick, that or melting the breams supporting it...";
	dir = 8;
	health = 25000
	},
/turf/open/floor/plating,
/area/template_noop)
"Si" = (
/obj/structure/surface/table/woodentable,
/obj/item/device/radio,
/obj/effect/landmark/item_pool_spawner/survivor_ammo/buckshot,
/turf/open/floor{
	icon_state = "wood"
	},
/area/template_noop)
"SD" = (
/obj/structure/pipes/standard/simple/hidden/green{
	dir = 4
	},
/obj/effect/decal/cleanable/dirt,
/turf/open/floor{
	dir = 1;
	icon_state = "asteroidfloor";
	tag = "icon-asteroidfloor (NORTH)"
	},
/area/template_noop)
"SE" = (
/obj/structure/pipes/standard/simple/hidden/green,
/obj/effect/landmark/corpsespawner/pmc,
/turf/open/floor{
	icon_state = "wood"
	},
/area/template_noop)
"SF" = (
/obj/item/ammo_casing/bullet,
/turf/open/floor{
	dir = 8;
	icon_state = "carpet13-5";
	tag = "icon-carpet13-5 (WEST)"
	},
/area/template_noop)
"SX" = (
/obj/structure/machinery/light{
	dir = 1
	},
/turf/open/floor{
	icon_state = "wood"
	},
/area/template_noop)
"Tc" = (
/obj/structure/pipes/vents/pump,
/obj/structure/bed/chair/wood/normal{
	dir = 4;
	tag = ""
	},
/obj/effect/landmark/survivor_spawner,
/turf/open/floor{
	icon_state = "wood"
	},
/area/template_noop)
"Ts" = (
/obj/structure/pipes/standard/manifold/hidden/green{
	dir = 8
	},
/turf/open/floor{
	icon_state = "wood"
	},
/area/template_noop)
"TF" = (
/obj/structure/machinery/cm_vending/sorted/boozeomat,
/turf/open/floor{
	icon_state = "wood"
	},
/area/template_noop)
"Uq" = (
/obj/structure/pipes/standard/simple/hidden/green{
	dir = 4
	},
/turf/open/floor,
/area/template_noop)
"UC" = (
/obj/structure/bed/stool,
/obj/item/ammo_casing/bullet,
/turf/open/floor{
	icon_state = "wood"
	},
/area/template_noop)
"UF" = (
/obj/structure/bed,
/obj/effect/landmark/survivor_spawner,
/turf/open/floor{
	icon_state = "wood"
	},
/area/template_noop)
"UL" = (
/obj/structure/barricade/plasteel/wired{
	icon_state = "plasteel_2"
	},
/turf/open/floor{
	icon_state = "wood"
	},
/area/template_noop)
"UX" = (
/obj/effect/decal/cleanable/blood/gibs/body,
/obj/structure/pipes/standard/simple/hidden/green,
/turf/open/floor{
	icon_state = "wood"
	},
/area/template_noop)
"Wd" = (
/obj/structure/pipes/standard/simple/hidden/green{
	dir = 4
	},
/obj/structure/bed/chair/wood/normal{
	dir = 8;
	tag = ""
	},
/obj/item/ammo_casing/bullet,
/obj/effect/landmark/survivor_spawner,
/turf/open/floor{
	icon_state = "wood"
	},
/area/template_noop)
"Wm" = (
/obj/structure/reagent_dispensers/beerkeg,
/obj/structure/machinery/light{
	dir = 4;
	tag = "icon-tube1 (EAST)"
	},
/turf/open/floor{
	icon_state = "wood"
	},
/area/template_noop)
"Wn" = (
/obj/effect/landmark/lv624/xeno_tunnel,
/turf/open/mars_cave{
	icon_state = "mars_dirt_4";
	tag = "icon-mars_dirt_4"
	},
/area/template_noop)
"Wq" = (
/obj/structure/closet/athletic_mixed,
/obj/structure/machinery/light{
	dir = 8
	},
/turf/open/floor{
	icon_state = "wood"
	},
/area/template_noop)
"Xl" = (
/obj/structure/barricade/metal/wired{
	icon_state = "metal_2";
	dir = 8
	},
/obj/effect/landmark/survivor_spawner,
/turf/open/floor{
	icon_state = "wood"
	},
/area/template_noop)
"Xu" = (
/obj/structure/pipes/standard/simple/hidden/green{
	dir = 4
	},
/obj/structure/machinery/door/airlock/almayer/maint{
	name = "\improper Bar Maintenance";
	req_one_access = null
	},
/turf/open/floor/plating,
/area/template_noop)
"XZ" = (
/obj/structure/surface/table/woodentable,
/turf/open/floor{
	icon_state = "wood"
	},
/area/template_noop)
"Yc" = (
/obj/structure/closet/secure_closet/bar,
/turf/open/floor{
	icon_state = "wood"
	},
/area/template_noop)
"Yd" = (
/obj/item/ammo_casing/bullet,
/turf/open/floor{
	icon_state = "wood"
	},
/area/template_noop)
"Yi" = (
/obj/structure/pipes/standard/simple/hidden/green{
	dir = 4
	},
/obj/item/ammo_casing/bullet,
/turf/open/floor{
	icon_state = "wood"
	},
/area/template_noop)
"Yw" = (
/obj/structure/pipes/standard/simple/hidden/green,
/obj/structure/machinery/door/poddoor/shutters/almayer{
	id = "Bar Complex";
	name = "\improper Bar Complex Shutters"
	},
/turf/open/floor{
	icon_state = "wood"
	},
/area/template_noop)
"ZP" = (
/obj/structure/surface/table/woodentable,
/obj/item/ammo_box/magazine/shotgun,
/obj/item/weapon/gun/shotgun/pump/cmb,
/obj/item/weapon/gun/shotgun/pump/cmb,
/obj/item/weapon/gun/shotgun/pump/cmb,
/turf/open/floor{
	icon_state = "wood"
	},
/area/template_noop)
"ZX" = (
/obj/structure/surface/table/woodentable,
/obj/item/stack/sheet/plasteel/large_stack,
/obj/item/stack/sheet/plasteel/large_stack,
/turf/open/floor{
	icon_state = "wood"
	},
/area/template_noop)

(1,1,1) = {"
Bm
Cb
QK
QK
QK
QK
QK
QK
QK
QK
QK
QK
QK
lI
QK
lI
QK
lI
QK
lI
QK
QK
"}
(2,1,1) = {"
Bm
Uq
QK
tj
Gc
Cm
Wq
Gc
Si
QK
ry
fi
Eb
Xl
mi
Xl
qY
Xl
mi
Xl
mi
QK
"}
(3,1,1) = {"
Ac
uZ
fS
oD
mi
Yd
mi
mi
mi
fS
Gt
gv
Eb
Cn
Tc
FC
SE
Qn
Kv
Yd
ob
qS
"}
(4,1,1) = {"
Bm
tH
QK
tR
mi
mi
mi
Yd
vc
QK
ry
gv
Eb
ZP
AI
mi
Dr
md
GX
mi
mi
QK
"}
(5,1,1) = {"
IA
Uq
fS
oD
UC
lb
lb
lb
lb
fS
rd
oA
SF
Nn
FP
Yd
mi
Dc
ZX
mi
fG
qS
"}
(6,1,1) = {"
eC
Uq
QK
Gc
lq
lq
lq
lq
lq
QK
Ea
gv
SF
fz
Fa
mi
mi
Wd
Fa
nX
mi
QK
"}
(7,1,1) = {"
QK
Xu
QK
QK
QK
QK
QK
QK
QK
QK
he
he
ts
ax
vQ
mi
mi
hP
mi
mi
QG
QK
"}
(8,1,1) = {"
QK
Rs
qj
qj
qj
QK
SX
mi
ax
mi
tR
mi
mi
Yd
Yd
mi
nX
hP
ax
qQ
Fz
kp
"}
(9,1,1) = {"
QK
BN
Ic
qX
qX
rp
Qz
hz
hz
hz
uR
UX
hz
Jk
rD
hz
CB
gV
nX
mi
fJ
Yw
"}
(10,1,1) = {"
QK
tK
HC
qj
qj
QK
hP
QA
mi
vQ
tR
nX
mi
Yd
mi
Dr
mi
iq
rD
Ts
rb
QK
"}
(11,1,1) = {"
QK
qj
Ou
qj
qj
QK
hP
mi
nX
mi
tR
ic
Li
zm
zm
zm
zm
nK
mi
hP
mi
QK
"}
(12,1,1) = {"
QK
QK
Xu
QK
QK
QK
Nm
QK
QK
QK
QK
QK
QK
fa
cd
Mr
XZ
oK
XZ
Yi
Gi
qS
"}
(13,1,1) = {"
LT
QK
SD
Ld
Wn
QK
nV
hz
In
nX
eQ
tF
QK
Xl
tq
Xl
pf
sg
XZ
hP
nX
QK
"}
(14,1,1) = {"
gM
QK
SD
Ld
bM
QK
uu
ic
mi
mi
mi
KB
IP
mi
mi
mi
mi
UL
mi
hP
jD
QK
"}
(15,1,1) = {"
QK
QK
SD
Ld
bM
QK
ha
ha
Wm
yz
Yc
UF
QK
TF
ct
QK
iD
ul
XZ
vv
pL
qS
"}
(16,1,1) = {"
LT
QK
SD
Ld
bM
QK
QK
QK
QK
QK
QK
QK
QK
QK
QK
QK
QK
QK
QK
oe
zV
QK
"}
