//MAP CONVERTED BY dmm2tgm.py THIS HEADER COMMENT PREVENTS RECONVERSION, DO NOT REMOVE
"ac" = (
/turf/open/floor/plating,
/area/bigredv2/outside/space_port)
"ad" = (
/obj/effect/decal/cleanable/blood/gibs/core,
/turf/open/floor/plating,
/area/bigredv2/outside/space_port)
"al" = (
/obj/effect/decal/cleanable/blood/oil,
/turf/open/floor/plating,
/area/bigredv2/outside/space_port)
"an" = (
/turf/closed/wall/solaris,
/area/bigredv2/outside/space_port)
"ax" = (
/obj/structure/window/framed/solaris,
/obj/structure/machinery/door/poddoor/shutters/almayer{
	dir = 4;
	id = "Spaceport";
	name = "\improper Spaceport Shutters"
	},
/turf/open/floor/plating,
/area/bigredv2/outside/space_port)
"aA" = (
/obj/structure/cargo_container/watatsumi/leftmid,
/turf/open/floor/plating,
/area/bigredv2/outside/space_port)
"aB" = (
/obj/structure/cargo_container/watatsumi/rightmid,
/turf/open/floor/plating,
/area/bigredv2/outside/space_port)
"aC" = (
/obj/structure/cargo_container/watatsumi/right,
/turf/open/floor/plating,
/area/bigredv2/outside/space_port)
"aG" = (
/obj/effect/decal/cleanable/blood{
	icon_state = "gib6"
	},
/turf/open/floor/plating,
/area/bigredv2/outside/space_port)
"aP" = (
/obj/structure/window/framed/solaris,
/obj/structure/machinery/door/poddoor/shutters/almayer{
	id = "Spaceport";
	name = "\improper Spaceport Shutters"
	},
/turf/open/floor/plating,
/area/bigredv2/outside/space_port)
"aQ" = (
/obj/effect/decal/cleanable/blood{
	icon_state = "gib6"
	},
/obj/structure/window_frame/solaris,
/turf/open/floor/plating,
/area/bigredv2/outside/space_port)
"aR" = (
/obj/effect/decal/cleanable/dirt,
/obj/structure/window_frame/solaris,
/turf/open/floor/plating,
/area/bigredv2/outside/space_port)
"bd" = (
/obj/effect/decal/cleanable/blood,
/turf/open/floor/plating,
/area/bigredv2/outside/space_port)
"be" = (
/obj/item/shard,
/turf/open/floor/plating,
/area/bigredv2/outside/space_port)
"bg" = (
/obj/effect/landmark/crap_item,
/turf/open/floor/plating,
/area/bigredv2/outside/space_port)
"bi" = (
/obj/structure/cargo_container/grant/left,
/turf/open/floor/plating,
/area/bigredv2/outside/space_port)
"bj" = (
/obj/structure/cargo_container/grant/rightmid,
/turf/open/floor/plating,
/area/bigredv2/outside/space_port)
"bk" = (
/obj/structure/cargo_container/grant/right,
/turf/open/floor/plating,
/area/bigredv2/outside/space_port)
"bm" = (
/obj/structure/cargo_container/arious/rightmid,
/turf/open/floor/plating,
/area/bigredv2/outside/space_port)
"bn" = (
/obj/structure/cargo_container/arious/right,
/turf/open/floor/plating,
/area/bigredv2/outside/space_port)
"bu" = (
/obj/effect/decal/cleanable/blood,
/turf/open/floor/dark,
/area/bigredv2/outside/space_port)
"bR" = (
/obj/structure/cargo_container/grant/rightmid,
/turf/open/floor/plating/plating_catwalk,
/area/bigredv2/outside/space_port)
"dj" = (
/obj/structure/cargo_container/watatsumi/rightmid,
/turf/open/floor/plating/platebot,
/area/bigredv2/outside/space_port)
"dS" = (
/obj/structure/cargo_container/arious/leftmid,
/turf/open/floor/plating/platebotc,
/area/bigredv2/outside/space_port)
"gE" = (
/obj/effect/decal/cleanable/dirt,
/turf/open/floor/asteroidwarning/east,
/area/bigredv2/outside/space_port)
"hi" = (
/obj/structure/largecrate/random/barrel/true_random,
/turf/open/floor/plating/platebot,
/area/bigredv2/outside/space_port)
"hs" = (
/obj/effect/landmark/hunter_primary,
/turf/open/floor/plating/platebot,
/area/bigredv2/outside/space_port)
"hR" = (
/obj/structure/surface/table,
/obj/effect/spawner/random/technology_scanner,
/obj/effect/spawner/random/tool,
/turf/open/floor/darkgreen2,
/area/bigredv2/outside/space_port)
"ig" = (
/obj/structure/bed/chair/office/dark,
/obj/effect/decal/cleanable/blood/gibs/core,
/turf/open/floor/dark,
/area/bigredv2/outside/space_port)
"iu" = (
/obj/structure/machinery/power/apc{
	dir = 8;
	pixel_x = -32;
	start_charge = 0
	},
/turf/open/floor/dark,
/area/bigredv2/outside/space_port)
"jJ" = (
/obj/structure/cargo_container/arious/leftmid,
/turf/open/floor/plating/platebot,
/area/bigredv2/outside/space_port)
"jK" = (
/obj/structure/cargo_container/grant/right,
/turf/open/floor/plating/plating_catwalk,
/area/bigredv2/outside/space_port)
"jP" = (
/obj/effect/decal/cleanable/blood/gibs/up,
/turf/open/floor/dark,
/area/bigredv2/outside/space_port)
"kb" = (
/obj/structure/machinery/blackbox_recorder,
/obj/structure/machinery/light{
	dir = 4
	},
/turf/open/floor/dark,
/area/bigredv2/outside/space_port)
"kB" = (
/obj/structure/cargo_container/watatsumi/leftmid,
/turf/open/floor/plating/platebotc,
/area/bigredv2/outside/space_port)
"mD" = (
/turf/open/floor/darkgreen2,
/area/bigredv2/outside/space_port)
"og" = (
/obj/structure/cargo_container/grant/left,
/turf/open/floor/plating/plating_catwalk,
/area/bigredv2/outside/space_port)
"oM" = (
/obj/effect/decal/cleanable/dirt,
/turf/open/floor/dark,
/area/bigredv2/outside/space_port)
"oZ" = (
/obj/structure/machinery/computer/cameras,
/turf/open/floor/darkgreen2,
/area/bigredv2/outside/space_port)
"ub" = (
/obj/structure/cargo_container/arious/right,
/turf/open/floor/plating/warnplate,
/area/bigredv2/outside/space_port)
"uh" = (
/turf/open/floor/asteroidwarning/east,
/area/bigredv2/outside/space_port)
"vN" = (
/obj/structure/bed/chair/office/dark{
	dir = 4
	},
/turf/open/floor/dark,
/area/bigredv2/outside/space_port)
"vO" = (
/obj/structure/surface/table,
/obj/effect/spawner/random/toolbox,
/obj/effect/spawner/random/tool,
/obj/structure/machinery/camera/autoname{
	dir = 8
	},
/turf/open/floor/dark,
/area/bigredv2/outside/space_port)
"vW" = (
/obj/structure/cargo_container/arious/rightmid,
/turf/open/floor/plating/warnplate,
/area/bigredv2/outside/space_port)
"xF" = (
/obj/structure/machinery/light{
	dir = 1
	},
/turf/open/floor/plating,
/area/bigredv2/outside/space_port)
"xH" = (
/obj/structure/surface/table,
/obj/effect/spawner/random/powercell,
/turf/open/floor/dark,
/area/bigredv2/outside/space_port)
"xN" = (
/obj/structure/surface/table,
/obj/effect/spawner/random/toolbox,
/obj/structure/machinery/door_control{
	id = "Spaceport";
	name = "Storm Shutters";
	pixel_x = 32
	},
/obj/item/tool/pen,
/turf/open/floor/dark,
/area/bigredv2/outside/space_port)
"zL" = (
/obj/structure/surface/table,
/obj/effect/spawner/random/tool,
/obj/effect/spawner/random/tech_supply,
/turf/open/floor/dark,
/area/bigredv2/outside/space_port)
"AU" = (
/obj/structure/surface/table,
/obj/structure/machinery/computer/shuttle/dropship/flight/lz1{
	dir = 4
	},
/turf/open/floor/dark,
/area/bigredv2/landing/console)
"Bz" = (
/turf/open/floor/plating/plating_catwalk,
/area/bigredv2/outside/space_port)
"BG" = (
/obj/structure/cargo_container/arious/rightmid,
/turf/open/floor/plating/platebot,
/area/bigredv2/outside/space_port)
"BJ" = (
/turf/open/floor/plating/warnplate,
/area/bigredv2/outside/space_port)
"Ez" = (
/obj/structure/cargo_container/watatsumi/rightmid,
/turf/open/floor/plating/platebotc,
/area/bigredv2/outside/space_port)
"EW" = (
/obj/structure/surface/table,
/obj/effect/spawner/random/tool,
/turf/open/floor/darkgreen2/southeast,
/area/bigredv2/outside/space_port)
"GR" = (
/obj/structure/surface/table,
/obj/effect/spawner/random/tool,
/obj/effect/landmark/item_pool_spawner/survivor_ammo/buckshot,
/turf/open/floor/dark,
/area/bigredv2/outside/space_port)
"Hy" = (
/obj/structure/cargo_container/watatsumi/leftmid,
/turf/open/floor/plating/platebot,
/area/bigredv2/outside/space_port)
"IY" = (
/obj/item/shard,
/obj/effect/decal/cleanable/dirt,
/turf/open/floor/darkgreen2,
/area/bigredv2/outside/space_port)
"Ji" = (
/turf/open/floor/dark,
/area/bigredv2/outside/space_port)
"Js" = (
/obj/structure/machinery/floodlight/landing,
/turf/open/floor/asteroidplating,
/area/bigredv2/outside/space_port)
"Ju" = (
/obj/structure/cargo_container/arious/right,
/turf/open/floor/plating/platebot,
/area/bigredv2/outside/space_port)
"Kx" = (
/obj/structure/cargo_container/arious/leftmid,
/turf/open/floor/plating/warnplate,
/area/bigredv2/outside/space_port)
"KI" = (
/turf/open/floor/plating/platebot,
/area/bigredv2/outside/space_port)
"Os" = (
/turf/open/floor/plating/platebotc,
/area/bigredv2/outside/space_port)
"PQ" = (
/obj/structure/machinery/disposal,
/obj/structure/machinery/light{
	dir = 8
	},
/turf/open/floor/dark,
/area/bigredv2/outside/space_port)
"Qf" = (
/obj/structure/surface/table,
/obj/effect/spawner/random/tool,
/obj/effect/landmark/item_pool_spawner/survivor_ammo/buckshot,
/turf/open/floor/darkgreen2/southwest,
/area/bigredv2/outside/space_port)
"UH" = (
/obj/structure/machinery/light{
	dir = 4
	},
/turf/open/floor/plating,
/area/bigredv2/outside/space_port)
"UU" = (
/obj/structure/largecrate/random/barrel/true_random,
/turf/open/floor/plating/platebotc,
/area/bigredv2/outside/space_port)
"Yu" = (
/obj/structure/surface/table,
/obj/effect/spawner/random/bomb_supply,
/obj/effect/spawner/random/technology_scanner,
/obj/effect/spawner/random/tool,
/turf/open/floor/darkgreen2,
/area/bigredv2/outside/space_port)
"YS" = (
/obj/structure/machinery/door/airlock/multi_tile/almayer/generic{
	dir = 1;
	name = "\improper Spaceport"
	},
/turf/open/floor/dark,
/area/bigredv2/outside/space_port)

(1,1,1) = {"
uh
uh
uh
uh
uh
uh
uh
uh
Js
uh
gE
uh
gE
gE
uh
uh
uh
"}
(2,1,1) = {"
ac
ac
ac
ac
ac
ac
ac
ac
BJ
Os
Os
Os
Bz
Bz
Os
Os
UU
"}
(3,1,1) = {"
ac
ac
ac
ac
aA
ac
ac
ac
BJ
Os
UU
Os
Bz
Bz
Os
kB
Os
"}
(4,1,1) = {"
ac
ac
ac
ac
aB
ac
ac
ac
BJ
Os
Os
Os
Bz
Bz
Os
Ez
dS
"}
(5,1,1) = {"
ac
ac
ac
ac
aC
ac
ac
ac
Kx
ac
ac
ac
Bz
Bz
ac
aC
bm
"}
(6,1,1) = {"
ad
al
ac
ac
ac
ac
ac
ac
vW
ac
KI
KI
Bz
Bz
KI
KI
bn
"}
(7,1,1) = {"
ac
ac
ac
ac
ac
aG
ac
ac
ub
ac
KI
hi
Bz
Bz
KI
KI
ac
"}
(8,1,1) = {"
ac
ac
ac
ac
ac
ac
ac
ac
BJ
ac
KI
KI
Bz
og
KI
KI
ac
"}
(9,1,1) = {"
ac
UH
ac
ac
ac
UH
ac
ac
BJ
ac
bg
ac
Bz
bR
ac
ac
ac
"}
(10,1,1) = {"
YS
an
an
ax
ax
an
an
ac
BJ
ac
KI
KI
Bz
jK
KI
KI
ac
"}
(11,1,1) = {"
oM
iu
PQ
AU
GR
Qf
an
xF
BJ
ac
KI
KI
Bz
Bz
KI
KI
ac
"}
(12,1,1) = {"
Ji
Ji
Ji
Ji
ig
Yu
aP
ac
BJ
ac
KI
hs
Bz
Bz
KI
hi
ac
"}
(13,1,1) = {"
oM
Ji
oM
Ji
Ji
hR
aP
ac
BJ
ac
ac
ac
Bz
Bz
ac
ac
bi
"}
(14,1,1) = {"
oM
jP
oM
oM
Ji
oZ
an
ac
BJ
bd
KI
KI
Bz
Bz
KI
jJ
bj
"}
(15,1,1) = {"
Ji
Ji
bu
Ji
Ji
IY
aQ
ac
BJ
be
Hy
KI
Bz
Bz
KI
BG
bk
"}
(16,1,1) = {"
Ji
vN
Ji
Ji
oM
mD
aR
ac
BJ
ac
dj
KI
Bz
Bz
KI
Ju
ac
"}
(17,1,1) = {"
vO
xN
kb
xH
zL
EW
aP
ac
BJ
ac
aC
ac
Bz
Bz
ac
ac
ac
"}
