//MAP CONVERTED BY dmm2tgm.py THIS HEADER COMMENT PREVENTS RECONVERSION, DO NOT REMOVE
"ac" = (
/turf/open/floor/plating,
/area/bigredv2/outside/space_port)
"ad" = (
/obj/effect/decal/cleanable/blood/gibs/core,
/turf/open/floor/plating,
/area/bigredv2/outside/space_port)
"al" = (
/obj/effect/decal/cleanable/blood/oil,
/turf/open/floor/plating,
/area/bigredv2/outside/space_port)
"an" = (
/turf/closed/wall/solaris,
/area/bigredv2/outside/space_port)
"ax" = (
/obj/structure/window/framed/solaris,
/obj/structure/machinery/door/poddoor/shutters/almayer{
	dir = 4;
	id = "Spaceport";
	name = "\improper Spaceport Shutters"
	},
/turf/open/floor/plating,
/area/bigredv2/outside/space_port)
"aA" = (
/obj/structure/cargo_container/watatsumi/leftmid,
/turf/open/floor/plating,
/area/bigredv2/outside/space_port)
"aB" = (
/obj/structure/cargo_container/watatsumi/rightmid,
/turf/open/floor/plating,
/area/bigredv2/outside/space_port)
"aC" = (
/obj/structure/cargo_container/watatsumi/right,
/turf/open/floor/plating,
/area/bigredv2/outside/space_port)
"aG" = (
/obj/effect/decal/cleanable/blood{
	icon_state = "gib6"
	},
/turf/open/floor/plating,
/area/bigredv2/outside/space_port)
"aP" = (
/obj/structure/window/framed/solaris,
/obj/structure/machinery/door/poddoor/shutters/almayer{
	id = "Spaceport";
	name = "\improper Spaceport Shutters"
	},
/turf/open/floor/plating,
/area/bigredv2/outside/space_port)
"aQ" = (
/obj/effect/decal/cleanable/blood{
	icon_state = "gib6"
	},
/obj/structure/window_frame/solaris,
/turf/open/floor/plating,
/area/bigredv2/outside/space_port)
"aR" = (
/obj/effect/decal/cleanable/dirt,
/obj/structure/window_frame/solaris,
/turf/open/floor/plating,
/area/bigredv2/outside/space_port)
"bd" = (
/obj/effect/decal/cleanable/blood,
/turf/open/floor/plating,
/area/bigredv2/outside/space_port)
"be" = (
/obj/item/shard,
/turf/open/floor/plating,
/area/bigredv2/outside/space_port)
"bg" = (
/obj/effect/landmark/crap_item,
/turf/open/floor/plating,
/area/bigredv2/outside/space_port)
"bh" = (
/obj/effect/landmark/hunter_primary,
/turf/open/floor/plating,
/area/bigredv2/outside/space_port)
"bi" = (
/obj/structure/cargo_container/grant/left,
/turf/open/floor/plating,
/area/bigredv2/outside/space_port)
"bj" = (
/obj/structure/cargo_container/grant/rightmid,
/turf/open/floor/plating,
/area/bigredv2/outside/space_port)
"bk" = (
/obj/structure/cargo_container/grant/right,
/turf/open/floor/plating,
/area/bigredv2/outside/space_port)
"bl" = (
/obj/structure/cargo_container/arious/leftmid,
/turf/open/floor/plating,
/area/bigredv2/outside/space_port)
"bm" = (
/obj/structure/cargo_container/arious/rightmid,
/turf/open/floor/plating,
/area/bigredv2/outside/space_port)
"bn" = (
/obj/structure/cargo_container/arious/right,
/turf/open/floor/plating,
/area/bigredv2/outside/space_port)
"dS" = (
/obj/structure/cargo_container/arious/leftmid,
/turf/open/floor/plating/warnplate,
/area/bigredv2/outside/space_port)
"ed" = (
/obj/structure/surface/table,
/obj/structure/machinery/computer/shuttle/dropship/flight/lz1{
	dir = 4
	},
/turf/open/floor/dark,
/area/bigredv2/landing/console)
"eo" = (
/obj/structure/surface/table,
/obj/effect/spawner/random/tool,
/obj/effect/spawner/random/tech_supply,
/turf/open/floor/dark,
/area/bigredv2/outside/space_port)
"eU" = (
/obj/structure/surface/table,
/obj/effect/spawner/random/tool,
/obj/effect/landmark/item_pool_spawner/survivor_ammo/buckshot,
/turf/open/floor/darkgreen2/southwest,
/area/bigredv2/outside/space_port)
"eZ" = (
/obj/effect/decal/cleanable/dirt,
/turf/open/floor/asteroidwarning/east,
/area/bigredv2/outside/space_port)
"iY" = (
/turf/open/floor/darkgreen2,
/area/bigredv2/outside/space_port)
"jN" = (
/obj/structure/machinery/disposal,
/obj/structure/machinery/light{
	dir = 8
	},
/turf/open/floor/dark,
/area/bigredv2/outside/space_port)
"lq" = (
/obj/structure/cargo_container/arious/right,
/turf/open/floor/plating/warnplate,
/area/bigredv2/outside/space_port)
"qQ" = (
/turf/open/floor/plating/warnplate,
/area/bigredv2/outside/space_port)
"qY" = (
/obj/structure/machinery/blackbox_recorder,
/obj/structure/machinery/light{
	dir = 4
	},
/turf/open/floor/dark,
/area/bigredv2/outside/space_port)
"sA" = (
/obj/structure/surface/table,
/obj/effect/spawner/random/bomb_supply,
/obj/effect/spawner/random/technology_scanner,
/obj/effect/spawner/random/tool,
/turf/open/floor/darkgreen2,
/area/bigredv2/outside/space_port)
"vF" = (
/obj/item/shard,
/obj/effect/decal/cleanable/dirt,
/turf/open/floor/darkgreen2,
/area/bigredv2/outside/space_port)
"vZ" = (
/turf/open/floor/asteroidwarning/east,
/area/bigredv2/outside/space_port)
"wH" = (
/obj/structure/cargo_container/arious/rightmid,
/turf/open/floor/plating/warnplate,
/area/bigredv2/outside/space_port)
"yC" = (
/turf/open/floor/dark,
/area/bigredv2/outside/space_port)
"AA" = (
/obj/structure/surface/table,
/obj/effect/spawner/random/tool,
/obj/effect/landmark/item_pool_spawner/survivor_ammo/buckshot,
/turf/open/floor/dark,
/area/bigredv2/outside/space_port)
"Ca" = (
/obj/structure/machinery/computer/cameras,
/turf/open/floor/darkgreen2,
/area/bigredv2/outside/space_port)
"ER" = (
/obj/structure/surface/table,
/obj/effect/spawner/random/technology_scanner,
/obj/effect/spawner/random/tool,
/turf/open/floor/darkgreen2,
/area/bigredv2/outside/space_port)
"GZ" = (
/obj/effect/decal/cleanable/blood/gibs/up,
/turf/open/floor/dark,
/area/bigredv2/outside/space_port)
"IV" = (
/obj/structure/machinery/floodlight/landing,
/turf/open/floor/asteroidplating,
/area/bigredv2/outside/space_port)
"Jz" = (
/obj/effect/decal/cleanable/blood,
/turf/open/floor/dark,
/area/bigredv2/outside/space_port)
"Kf" = (
/obj/structure/machinery/light{
	dir = 1
	},
/turf/open/floor/plating,
/area/bigredv2/outside/space_port)
"Lk" = (
/obj/structure/surface/table,
/obj/effect/spawner/random/toolbox,
/obj/structure/machinery/door_control{
	id = "Spaceport";
	name = "Storm Shutters";
	pixel_x = 32
	},
/obj/item/tool/pen,
/turf/open/floor/dark,
/area/bigredv2/outside/space_port)
"LK" = (
/obj/structure/machinery/door/airlock/multi_tile/almayer/generic{
	dir = 1;
	name = "\improper Spaceport"
	},
/turf/open/floor/dark,
/area/bigredv2/outside/space_port)
"PG" = (
/obj/structure/machinery/light{
	dir = 4
	},
/turf/open/floor/plating,
/area/bigredv2/outside/space_port)
"Qr" = (
/obj/structure/surface/table,
/obj/effect/spawner/random/toolbox,
/obj/effect/spawner/random/tool,
/obj/structure/machinery/camera/autoname{
	dir = 8
	},
/turf/open/floor/dark,
/area/bigredv2/outside/space_port)
"QY" = (
/obj/structure/bed/chair/office/dark{
	dir = 4
	},
/turf/open/floor/dark,
/area/bigredv2/outside/space_port)
"Sb" = (
/obj/effect/decal/cleanable/dirt,
/turf/open/floor/dark,
/area/bigredv2/outside/space_port)
"UJ" = (
/obj/structure/surface/table,
/obj/effect/spawner/random/tool,
/turf/open/floor/darkgreen2/southeast,
/area/bigredv2/outside/space_port)
"WG" = (
/obj/structure/machinery/power/apc/directional/no_power/west,
/turf/open/floor/dark,
/area/bigredv2/outside/space_port)
"XY" = (
/obj/structure/surface/table,
/obj/effect/spawner/random/powercell,
/turf/open/floor/dark,
/area/bigredv2/outside/space_port)
"Zp" = (
/obj/structure/bed/chair/office/dark,
/obj/effect/decal/cleanable/blood/gibs/core,
/turf/open/floor/dark,
/area/bigredv2/outside/space_port)

(1,1,1) = {"
vZ
vZ
vZ
vZ
vZ
vZ
vZ
vZ
IV
vZ
eZ
vZ
eZ
eZ
vZ
vZ
vZ
"}
(2,1,1) = {"
ac
ac
ac
ac
ac
ac
ac
ac
qQ
ac
ac
ac
ac
ac
ac
ac
ac
"}
(3,1,1) = {"
ac
ac
ac
ac
aA
ac
ac
ac
qQ
ac
ac
ac
ac
ac
ac
aA
ac
"}
(4,1,1) = {"
ac
ac
ac
ac
aB
ac
ac
ac
qQ
ac
ac
ac
ac
ac
ac
aB
bl
"}
(5,1,1) = {"
ac
ac
ac
ac
aC
ac
ac
ac
dS
ac
ac
ac
ac
ac
ac
aC
bm
"}
(6,1,1) = {"
ad
al
ac
ac
ac
ac
ac
ac
wH
ac
ac
ac
ac
ac
ac
ac
bn
"}
(7,1,1) = {"
ac
ac
ac
ac
ac
aG
ac
ac
lq
ac
ac
ac
ac
ac
ac
ac
ac
"}
(8,1,1) = {"
ac
ac
ac
ac
ac
ac
ac
ac
qQ
ac
ac
ac
ac
bi
ac
ac
ac
"}
(9,1,1) = {"
ac
PG
ac
ac
ac
PG
ac
ac
qQ
ac
bg
ac
ac
bj
ac
ac
ac
"}
(10,1,1) = {"
LK
an
an
ax
ax
an
an
ac
qQ
ac
ac
ac
ac
bk
ac
ac
ac
"}
(11,1,1) = {"
Sb
WG
jN
ed
AA
eU
an
Kf
qQ
ac
ac
ac
ac
ac
ac
ac
ac
"}
(12,1,1) = {"
yC
yC
yC
yC
Zp
sA
aP
ac
qQ
ac
ac
bh
ac
ac
ac
ac
ac
"}
(13,1,1) = {"
Sb
yC
Sb
yC
yC
ER
aP
ac
qQ
ac
ac
ac
ac
ac
ac
ac
bi
"}
(14,1,1) = {"
Sb
GZ
Sb
Sb
yC
Ca
an
ac
qQ
bd
ac
ac
ac
ac
ac
bl
bj
"}
(15,1,1) = {"
yC
yC
Jz
yC
yC
vF
aQ
ac
qQ
be
aA
ac
ac
ac
ac
bm
bk
"}
(16,1,1) = {"
yC
QY
yC
yC
Sb
iY
aR
ac
qQ
ac
aB
ac
ac
ac
ac
bn
ac
"}
(17,1,1) = {"
Qr
Lk
qY
XY
eo
UJ
aP
ac
qQ
ac
aC
ac
ac
ac
ac
ac
ac
"}
