//MAP CONVERTED BY dmm2tgm.py THIS HEADER COMMENT PREVENTS RECONVERSION, DO NOT REMOVE
"ab" = (
/turf/open/floor/asteroidwarning/east,
/area/bigredv2/outside/space_port)
"ac" = (
/turf/open/floor/plating,
/area/bigredv2/outside/space_port)
"ad" = (
/obj/effect/decal/cleanable/blood/gibs/core,
/turf/open/floor/plating,
/area/bigredv2/outside/space_port)
"af" = (
/obj/structure/machinery/door/airlock/multi_tile/almayer/generic{
	dir = 1;
	name = "\improper Spaceport"
	},
/turf/open/floor/dark,
/area/bigredv2/outside/space_port)
"ah" = (
/turf/open/floor/dark,
/area/bigredv2/outside/space_port)
"ai" = (
/obj/effect/decal/cleanable/dirt,
/turf/open/floor/dark,
/area/bigredv2/outside/space_port)
"aj" = (
/obj/structure/surface/table,
/obj/effect/spawner/random/toolbox,
/obj/effect/spawner/random/tool,
/obj/structure/machinery/camera/autoname{
	dir = 8
	},
/turf/open/floor/dark,
/area/bigredv2/outside/space_port)
"al" = (
/obj/effect/decal/cleanable/blood/oil,
/turf/open/floor/plating,
/area/bigredv2/outside/space_port)
"am" = (
/obj/structure/machinery/light{
	dir = 4
	},
/turf/open/floor/plating,
/area/bigredv2/outside/space_port)
"an" = (
/turf/closed/wall/solaris,
/area/bigredv2/outside/space_port)
"ap" = (
/obj/effect/decal/cleanable/blood/gibs/up,
/turf/open/floor/dark,
/area/bigredv2/outside/space_port)
"aq" = (
/obj/structure/bed/chair/office/dark{
	dir = 4
	},
/turf/open/floor/dark,
/area/bigredv2/outside/space_port)
"ar" = (
/obj/structure/surface/table,
/obj/effect/spawner/random/toolbox,
/obj/structure/machinery/door_control{
	id = "Spaceport";
	name = "Storm Shutters";
	pixel_x = 32
	},
/obj/item/tool/pen,
/turf/open/floor/dark,
/area/bigredv2/outside/space_port)
"at" = (
/obj/structure/machinery/disposal,
/obj/structure/machinery/light{
	dir = 8
	},
/turf/open/floor/dark,
/area/bigredv2/outside/space_port)
"au" = (
/obj/effect/decal/cleanable/blood,
/turf/open/floor/dark,
/area/bigredv2/outside/space_port)
"av" = (
/obj/structure/machinery/blackbox_recorder,
/obj/structure/machinery/light{
	dir = 4
	},
/turf/open/floor/dark,
/area/bigredv2/outside/space_port)
"ax" = (
/obj/structure/window/framed/solaris,
/obj/structure/machinery/door/poddoor/shutters/almayer{
	dir = 4;
	id = "Spaceport";
	name = "\improper Spaceport Shutters"
	},
/turf/open/floor/plating,
/area/bigredv2/outside/space_port)
"ay" = (
/obj/structure/surface/table,
/obj/structure/machinery/computer/shuttle/dropship/flight/lz1{
	dir = 4
	},
/turf/open/floor/dark,
/area/bigredv2/landing/console)
"az" = (
/obj/structure/surface/table,
/obj/effect/spawner/random/powercell,
/turf/open/floor/dark,
/area/bigredv2/outside/space_port)
"aA" = (
/obj/structure/cargo_container/watatsumi/leftmid,
/turf/open/floor/plating,
/area/bigredv2/outside/space_port)
"aB" = (
/obj/structure/cargo_container/watatsumi/rightmid,
/turf/open/floor/plating,
/area/bigredv2/outside/space_port)
"aC" = (
/obj/structure/cargo_container/watatsumi/right,
/turf/open/floor/plating,
/area/bigredv2/outside/space_port)
"aD" = (
/obj/structure/surface/table,
/obj/effect/spawner/random/tool,
/obj/effect/landmark/item_pool_spawner/survivor_ammo/buckshot,
/turf/open/floor/dark,
/area/bigredv2/outside/space_port)
"aE" = (
/obj/structure/bed/chair/office/dark,
/obj/effect/decal/cleanable/blood/gibs/core,
/turf/open/floor/dark,
/area/bigredv2/outside/space_port)
"aF" = (
/obj/structure/surface/table,
/obj/effect/spawner/random/tool,
/obj/effect/spawner/random/tech_supply,
/turf/open/floor/dark,
/area/bigredv2/outside/space_port)
"aG" = (
/obj/effect/decal/cleanable/blood{
	icon_state = "gib6"
	},
/turf/open/floor/plating,
/area/bigredv2/outside/space_port)
"aH" = (
/obj/structure/surface/table,
/obj/effect/spawner/random/tool,
/obj/effect/landmark/item_pool_spawner/survivor_ammo/buckshot,
/turf/open/floor/darkgreen2/southwest,
/area/bigredv2/outside/space_port)
"aI" = (
/obj/structure/surface/table,
/obj/effect/spawner/random/bomb_supply,
/obj/effect/spawner/random/technology_scanner,
/obj/effect/spawner/random/tool,
/turf/open/floor/darkgreen2,
/area/bigredv2/outside/space_port)
"aJ" = (
/obj/structure/surface/table,
/obj/effect/spawner/random/technology_scanner,
/obj/effect/spawner/random/tool,
/turf/open/floor/darkgreen2,
/area/bigredv2/outside/space_port)
"aK" = (
/obj/structure/machinery/computer/cameras,
/turf/open/floor/darkgreen2,
/area/bigredv2/outside/space_port)
"aL" = (
/obj/item/shard,
/obj/effect/decal/cleanable/dirt,
/turf/open/floor/darkgreen2,
/area/bigredv2/outside/space_port)
"aM" = (
/turf/open/floor/darkgreen2,
/area/bigredv2/outside/space_port)
"aN" = (
/obj/structure/surface/table,
/obj/effect/spawner/random/tool,
/turf/open/floor/darkgreen2/southeast,
/area/bigredv2/outside/space_port)
"aP" = (
/obj/structure/window/framed/solaris,
/obj/structure/machinery/door/poddoor/shutters/almayer{
	id = "Spaceport";
	name = "\improper Spaceport Shutters"
	},
/turf/open/floor/plating,
/area/bigredv2/outside/space_port)
"aQ" = (
/obj/effect/decal/cleanable/blood{
	icon_state = "gib6"
	},
/obj/structure/window_frame/solaris,
/turf/open/floor/plating,
/area/bigredv2/outside/space_port)
"aR" = (
/obj/effect/decal/cleanable/dirt,
/obj/structure/window_frame/solaris,
/turf/open/floor/plating,
/area/bigredv2/outside/space_port)
"aT" = (
/obj/structure/machinery/light{
	dir = 1
	},
/turf/open/floor/plating,
/area/bigredv2/outside/space_port)
"aU" = (
/obj/structure/machinery/floodlight/landing,
/turf/open/floor/asteroidplating,
/area/bigredv2/outside/space_port)
"aV" = (
/turf/open/floor/plating/warnplate,
/area/bigredv2/outside/space_port)
"aW" = (
/obj/structure/cargo_container/arious/leftmid,
/turf/open/floor/plating/warnplate,
/area/bigredv2/outside/space_port)
"aX" = (
/obj/structure/cargo_container/arious/rightmid,
/turf/open/floor/plating/warnplate,
/area/bigredv2/outside/space_port)
"aY" = (
/obj/structure/cargo_container/arious/right,
/turf/open/floor/plating/warnplate,
/area/bigredv2/outside/space_port)
"bd" = (
/obj/effect/decal/cleanable/blood,
/turf/open/floor/plating,
/area/bigredv2/outside/space_port)
"be" = (
/obj/item/shard,
/turf/open/floor/plating,
/area/bigredv2/outside/space_port)
"bf" = (
/obj/effect/decal/cleanable/dirt,
/turf/open/floor/asteroidwarning/east,
/area/bigredv2/outside/space_port)
"bg" = (
/obj/effect/landmark/crap_item,
/turf/open/floor/plating,
/area/bigredv2/outside/space_port)
"bi" = (
/obj/structure/cargo_container/grant/left,
/turf/open/floor/plating,
/area/bigredv2/outside/space_port)
"bj" = (
/obj/structure/cargo_container/grant/rightmid,
/turf/open/floor/plating,
/area/bigredv2/outside/space_port)
"bk" = (
/obj/structure/cargo_container/grant/right,
/turf/open/floor/plating,
/area/bigredv2/outside/space_port)
"bl" = (
/obj/structure/cargo_container/arious/leftmid,
/turf/open/floor/plating,
/area/bigredv2/outside/space_port)
"bm" = (
/obj/structure/cargo_container/arious/rightmid,
/turf/open/floor/plating,
/area/bigredv2/outside/space_port)
"bn" = (
/obj/structure/cargo_container/arious/right,
/turf/open/floor/plating,
/area/bigredv2/outside/space_port)
"bs" = (
/obj/structure/cargo_container/grant/right,
/turf/open/floor/plating/plating_catwalk,
/area/bigredv2/outside/space_port)
"ch" = (
/obj/structure/cargo_container/arious/rightmid,
/obj/effect/decal/warning_stripes{
	icon_state = "S-corner"
	},
/turf/open/floor/plating,
/area/bigredv2/outside/space_port)
"dg" = (
/obj/effect/decal/warning_stripes{
	icon_state = "NW-in"
	},
/turf/open/floor/plating,
/area/bigredv2/outside/space_port)
"fU" = (
/turf/open/floor/plating/plating_catwalk,
/area/bigredv2/outside/space_port)
"ii" = (
/obj/effect/decal/warning_stripes{
	icon_state = "SE-in"
	},
/turf/open/floor/plating,
/area/bigredv2/outside/space_port)
"kN" = (
/obj/structure/cargo_container/grant/left,
/turf/open/floor/plating/plating_catwalk,
/area/bigredv2/outside/space_port)
"lo" = (
/obj/effect/decal/warning_stripes{
	icon_state = "NE-in"
	},
/turf/open/floor/plating,
/area/bigredv2/outside/space_port)
"mx" = (
/obj/structure/cargo_container/watatsumi/leftmid,
/obj/effect/decal/warning_stripes{
	icon_state = "S-corner"
	},
/turf/open/floor/plating,
/area/bigredv2/outside/space_port)
"oV" = (
/obj/structure/machinery/power/apc/no_power/west,
/turf/open/floor/dark,
/area/bigredv2/outside/space_port)
"tf" = (
/obj/structure/largecrate/random/barrel/true_random,
/obj/effect/decal/warning_stripes{
	icon_state = "NW-in"
	},
/turf/open/floor/plating,
/area/bigredv2/outside/space_port)
"tu" = (
/obj/structure/largecrate/random/barrel/true_random,
/obj/effect/decal/warning_stripes{
	icon_state = "N-corner"
	},
/turf/open/floor/plating,
/area/bigredv2/outside/space_port)
"xP" = (
/obj/structure/largecrate/random/barrel/true_random,
/obj/effect/decal/warning_stripes{
	icon_state = "S-corner"
	},
/turf/open/floor/plating,
/area/bigredv2/outside/space_port)
"yf" = (
/obj/structure/cargo_container/watatsumi/rightmid,
/obj/effect/decal/warning_stripes{
	icon_state = "SW-in"
	},
/turf/open/floor/plating,
/area/bigredv2/outside/space_port)
"yg" = (
/obj/effect/decal/warning_stripes{
	icon_state = "N-corner"
	},
/turf/open/floor/plating,
/area/bigredv2/outside/space_port)
"yZ" = (
/obj/structure/cargo_container/watatsumi/leftmid,
/obj/effect/decal/warning_stripes{
	icon_state = "N-corner"
	},
/turf/open/floor/plating,
/area/bigredv2/outside/space_port)
"Aw" = (
/obj/effect/decal/warning_stripes{
	icon_state = "SW-in"
	},
/turf/open/floor/plating,
/area/bigredv2/outside/space_port)
"DA" = (
/obj/structure/cargo_container/arious/right,
/obj/effect/decal/warning_stripes{
	icon_state = "NW-in"
	},
/turf/open/floor/plating,
/area/bigredv2/outside/space_port)
"In" = (
/obj/structure/cargo_container/arious/leftmid,
/obj/effect/decal/warning_stripes{
	icon_state = "NE-in"
	},
/turf/open/floor/plating,
/area/bigredv2/outside/space_port)
"KQ" = (
/obj/structure/cargo_container/watatsumi/rightmid,
/obj/effect/decal/warning_stripes{
	icon_state = "NW-in"
	},
/turf/open/floor/plating,
/area/bigredv2/outside/space_port)
"NH" = (
/obj/structure/cargo_container/grant/rightmid,
/turf/open/floor/plating/plating_catwalk,
/area/bigredv2/outside/space_port)
"OZ" = (
/obj/effect/landmark/hunter_primary,
/obj/effect/decal/warning_stripes{
	icon_state = "NW-in"
	},
/turf/open/floor/plating,
/area/bigredv2/outside/space_port)
"QA" = (
/obj/structure/largecrate/random/barrel/true_random,
/turf/open/floor/plating,
/area/bigredv2/outside/space_port)
"Ta" = (
/obj/effect/decal/warning_stripes{
	icon_state = "S-corner"
	},
/turf/open/floor/plating,
/area/bigredv2/outside/space_port)
"Ww" = (
/obj/effect/decal/warning_stripes{
	icon_state = "SE-in"
	},
/obj/effect/decal/warning_stripes{
	icon_state = "N-corner"
	},
/turf/open/floor/plating,
/area/bigredv2/outside/space_port)

(1,1,1) = {"
ab
ab
ab
ab
ab
ab
ab
ab
aU
ab
bf
ab
bf
bf
ab
ab
ab
"}
(2,1,1) = {"
ac
ac
ac
ac
ac
ac
ac
ac
aV
ac
ii
lo
fU
fU
ii
lo
QA
"}
(3,1,1) = {"
ac
ac
ac
ac
aA
ac
ac
ac
aV
ac
tu
Ta
fU
fU
yg
mx
ac
"}
(4,1,1) = {"
ac
ac
ac
ac
aB
ac
ac
ac
aV
ac
Aw
dg
fU
fU
Aw
KQ
bl
"}
(5,1,1) = {"
ac
ac
ac
ac
aC
ac
ac
ac
aW
ac
ac
ac
fU
fU
ac
aC
bm
"}
(6,1,1) = {"
ad
al
ac
ac
ac
ac
ac
ac
aX
ac
ii
lo
fU
fU
ii
lo
bn
"}
(7,1,1) = {"
ac
ac
ac
ac
ac
aG
ac
ac
aY
ac
yg
xP
fU
fU
yg
Ta
ac
"}
(8,1,1) = {"
ac
ac
ac
ac
ac
ac
ac
ac
aV
ac
Aw
dg
fU
kN
Aw
dg
ac
"}
(9,1,1) = {"
ac
am
ac
ac
ac
am
ac
ac
aV
ac
bg
ac
fU
NH
ac
ac
ac
"}
(10,1,1) = {"
af
an
an
ax
ax
an
an
ac
aV
ac
ii
lo
fU
bs
ii
lo
ac
"}
(11,1,1) = {"
ai
oV
at
ay
aD
aH
an
aT
aV
ac
yg
Ta
fU
fU
yg
Ta
ac
"}
(12,1,1) = {"
ah
ah
ah
ah
aE
aI
aP
ac
aV
ac
Aw
OZ
fU
fU
Aw
tf
ac
"}
(13,1,1) = {"
ai
ah
ai
ah
ah
aJ
aP
ac
aV
ac
ac
ac
fU
fU
ac
ac
bi
"}
(14,1,1) = {"
ai
ap
ai
ai
ah
aK
an
ac
aV
bd
ii
lo
fU
fU
Ww
In
bj
"}
(15,1,1) = {"
ah
ah
au
ah
ah
aL
aQ
ac
aV
be
yZ
Ta
fU
fU
yg
ch
bk
"}
(16,1,1) = {"
ah
aq
ah
ah
ai
aM
aR
ac
aV
ac
yf
dg
fU
fU
Aw
DA
ac
"}
(17,1,1) = {"
aj
ar
av
az
aF
aN
aP
ac
aV
ac
aC
ac
fU
fU
ac
ac
ac
"}
