//MAP CONVERTED BY dmm2tgm.py THIS HEADER COMMENT PREVENTS RECONVERSION, DO NOT REMOVE
"a" = (
/turf/closed/wall/solaris/rock,
/area/bigredv2/caves)
"d" = (
/turf/closed/wall/solaris/reinforced,
/area/bigredv2/outside/space_port)
"f" = (
/obj/item/tool/warning_cone,
/turf/open/floor/plating,
/area/bigredv2/outside/space_port)
"h" = (
/turf/open/floor/plating,
/area/bigredv2/outside/space_port)
"i" = (
/turf/open/auto_turf/br_caves/layer1,
/area/bigredv2/caves_north)
"j" = (
/obj/structure/blocker/forcefield/vehicles,
/turf/open/auto_turf/br_caves/layer1,
/area/bigredv2/caves_north)
"F" = (
/obj/structure/sign/safety/hazard,
/turf/closed/wall/solaris/reinforced,
/area/bigredv2/outside/space_port)

(1,1,1) = {"
a
a
a
a
a
a
a
d
d
d
f
h
f
d
d
"}
(2,1,1) = {"
a
a
a
a
a
a
a
a
a
d
d
F
d
d
a
"}
(3,1,1) = {"
a
a
a
a
a
a
a
a
a
a
j
j
j
j
a
"}
(4,1,1) = {"
a
a
a
a
a
a
a
a
a
i
i
i
i
i
a
"}
(5,1,1) = {"
a
a
a
a
a
a
a
a
a
i
i
i
i
a
a
"}
(6,1,1) = {"
a
a
a
a
a
a
a
a
i
i
i
i
i
a
a
"}
(7,1,1) = {"
a
a
a
a
a
a
i
i
i
i
i
i
a
a
a
"}
(8,1,1) = {"
a
a
a
a
i
i
i
i
i
i
i
i
a
a
a
"}
(9,1,1) = {"
i
i
i
i
i
i
i
i
i
i
i
i
i
a
a
"}
(10,1,1) = {"
i
i
i
i
i
i
i
i
i
i
i
i
i
i
a
"}
(11,1,1) = {"
i
i
i
i
i
i
i
a
a
i
i
i
i
i
j
"}
(12,1,1) = {"
i
i
i
i
i
i
a
a
a
a
i
i
i
i
j
"}
(13,1,1) = {"
i
i
a
a
a
a
a
a
a
i
i
i
i
i
j
"}
(14,1,1) = {"
i
i
i
a
a
a
a
a
a
i
i
i
i
i
j
"}
(15,1,1) = {"
i
i
i
i
a
a
a
a
i
i
i
i
i
i
j
"}
