//MAP CONVERTED BY dmm2tgm.py THIS HEADER COMMENT PREVENTS RECONVERSION, DO NOT REMOVE
"aa" = (
/turf/closed/wall/solaris/reinforced,
/area/bigredv2/caves/lambda/xenobiology)
"ab" = (
/turf/open/mars_cave{
	icon_state = "mars_cave_11"
	},
/area/bigredv2/caves_lambda)
"ac" = (
/obj/item/tool/pickaxe/drill,
/obj/effect/landmark/structure_spawner/setup/distress/xeno_weed_node,
/turf/open/mars_cave{
	icon_state = "mars_cave_2"
	},
/area/bigredv2/caves_lambda)
"ad" = (
/obj/effect/glowshroom,
/turf/open/mars_cave,
/area/bigredv2/caves_lambda)
"ae" = (
/obj/effect/glowshroom,
/turf/open/mars_cave{
	icon_state = "mars_cave_7"
	},
/area/bigredv2/caves_lambda)
"af" = (
/obj/structure/machinery/vending/hydronutrients,
/obj/structure/machinery/light,
/turf/open/floor{
	dir = 6;
	icon_state = "whitegreen"
	},
/area/bigredv2/caves/lambda/xenobiology)
"ag" = (
/obj/structure/barricade/wooden,
/turf/open/floor{
	dir = 4;
	icon_state = "darkpurplecorners2"
	},
/area/bigredv2/caves/lambda/breakroom)
"ah" = (
/obj/effect/glowshroom,
/turf/open/mars_cave{
	icon_state = "mars_cave_10"
	},
/area/bigredv2/caves_lambda)
"ai" = (
/turf/open/mars_cave{
	icon_state = "mars_cave_6"
	},
/area/bigredv2/caves_lambda)
"aj" = (
/obj/effect/landmark/structure_spawner/setup/distress/xeno_weed_node,
/turf/open/mars_cave{
	icon_state = "mars_cave_11"
	},
/area/bigredv2/caves_lambda)
"ak" = (
/turf/closed/wall/solaris/rock,
/area/bigredv2/caves)
"al" = (
/obj/structure/sign/safety/restrictedarea{
	pixel_x = 8;
	pixel_y = -32
	},
/obj/effect/landmark/structure_spawner/setup/distress/xeno_weed_node,
/turf/open/floor{
	dir = 4;
	icon_state = "darkpurplecorners2"
	},
/area/bigredv2/caves/lambda/breakroom)
"am" = (
/obj/structure/machinery/door_control{
	id = "sci_br";
	name = "Observation Shutters";
	pixel_y = 28
	},
/obj/effect/decal/cleanable/blood/gibs/xeno,
/turf/open/floor{
	icon_state = "darkpurplecorners2"
	},
/area/bigredv2/caves/lambda/breakroom)
"an" = (
/obj/effect/decal/cleanable/mucus,
/obj/structure/machinery/door_control{
	id = "sci_br";
	name = "Observation Shutters";
	pixel_y = 28
	},
/obj/effect/landmark/corpsespawner/pmc,
/obj/effect/decal/cleanable/vomit,
/turf/open/floor{
	icon_state = "darkpurplecorners2"
	},
/area/bigredv2/caves/lambda/breakroom)
"ao" = (
/turf/open/floor{
	icon_state = "darkpurplecorners2"
	},
/area/bigredv2/caves/lambda/breakroom)
"ap" = (
/obj/structure/sign/safety/bulkhead_door,
/turf/closed/wall/solaris/reinforced,
/area/bigredv2/caves/lambda/breakroom)
"aq" = (
/turf/open/floor/almayer{
	dir = 1;
	icon_state = "w-y0"
	},
/area/bigredv2/caves/lambda/breakroom)
"ar" = (
/obj/structure/filingcabinet{
	density = 0;
	layer = 3.1;
	pixel_x = 8;
	pixel_y = 18
	},
/obj/structure/filingcabinet{
	density = 0;
	pixel_x = -8;
	pixel_y = 20
	},
/turf/open/floor/strata{
	dir = 4;
	icon_state = "white_cyan1"
	},
/area/bigredv2/caves/lambda/breakroom)
"as" = (
/obj/structure/filingcabinet{
	pixel_x = 7
	},
/obj/structure/filingcabinet{
	density = 0;
	pixel_x = -7;
	pixel_y = 19
	},
/obj/structure/filingcabinet{
	pixel_x = -9
	},
/turf/open/floor/strata{
	dir = 4;
	icon_state = "white_cyan1"
	},
/area/bigredv2/caves/lambda/breakroom)
"at" = (
/turf/open/floor/plating/almayer,
/area/bigredv2/caves/lambda/breakroom)
"au" = (
/turf/open/floor/strata{
	dir = 4;
	icon_state = "white_cyan1"
	},
/area/bigredv2/caves/lambda/breakroom)
"av" = (
/obj/structure/filingcabinet{
	density = 0;
	pixel_x = 8;
	pixel_y = 20
	},
/obj/structure/filingcabinet{
	density = 0;
	pixel_x = -8;
	pixel_y = 16
	},
/turf/open/floor/strata{
	dir = 4;
	icon_state = "white_cyan1"
	},
/area/bigredv2/caves/lambda/breakroom)
"aw" = (
/obj/structure/inflatable/popped/door,
/turf/open/floor{
	icon_state = "darkpurplecorners2"
	},
/area/bigredv2/caves/lambda/breakroom)
"ax" = (
/obj/structure/machinery/light{
	dir = 1
	},
/obj/effect/decal/cleanable/blood,
/turf/open/floor{
	icon_state = "darkpurplecorners2"
	},
/area/bigredv2/caves/lambda/breakroom)
"aA" = (
/obj/structure/machinery/portable_atmospherics/hydroponics,
/turf/open/floor{
	icon_state = "whitegreen"
	},
/area/bigredv2/caves/lambda/xenobiology)
"aB" = (
/turf/open/floor/almayer{
	dir = 1;
	icon_state = "w-y1"
	},
/area/bigredv2/caves/lambda/breakroom)
"aC" = (
/obj/structure/machinery/light,
/turf/open/floor{
	dir = 4;
	icon_state = "darkpurplecorners2"
	},
/area/bigredv2/caves/lambda/breakroom)
"aD" = (
/obj/structure/inflatable/popped/door,
/turf/open/floor{
	dir = 4;
	icon_state = "darkpurplecorners2"
	},
/area/bigredv2/caves/lambda/breakroom)
"aE" = (
/turf/open/floor{
	dir = 4;
	icon_state = "darkpurplecorners2"
	},
/area/bigredv2/caves/lambda/breakroom)
"aF" = (
/obj/structure/machinery/light{
	dir = 1
	},
/obj/structure/surface/table/reinforced/prison,
/obj/structure/window/reinforced{
	dir = 8
	},
/obj/structure/window/reinforced{
	dir = 4
	},
/obj/structure/machinery/door/window/brigdoor/southright,
/obj/item/clothing/accessory/medal/gold{
	pixel_x = 7;
	pixel_y = 10
	},
/obj/item/clothing/accessory/medal/bronze/science{
	pixel_x = -5
	},
/turf/open/floor/strata{
	dir = 4;
	icon_state = "white_cyan1"
	},
/area/bigredv2/caves/lambda/breakroom)
"aG" = (
/obj/structure/window/framed/solaris/reinforced,
/obj/structure/machinery/door/poddoor/almayer{
	id = "sci_br";
	name = "\improper Lambda Observation Shutters"
	},
/turf/open/floor/plating,
/area/bigredv2/caves/lambda/breakroom)
"aH" = (
/obj/structure/barricade/wooden{
	dir = 1;
	pixel_y = 7
	},
/turf/open/floor{
	icon_state = "darkpurplecorners2"
	},
/area/bigredv2/caves/lambda/breakroom)
"aI" = (
/turf/closed/wall/solaris/reinforced,
/area/bigredv2/caves/lambda/breakroom)
"aJ" = (
/obj/structure/machinery/light,
/turf/open/floor/strata{
	dir = 4;
	icon_state = "white_cyan1"
	},
/area/bigredv2/caves/lambda/breakroom)
"aK" = (
/obj/structure/surface/table/reinforced/prison,
/obj/structure/machinery/door_control{
	id = "vault";
	name = "Vault Lockdown"
	},
/turf/open/floor/strata{
	dir = 4;
	icon_state = "white_cyan1"
	},
/area/bigredv2/caves/lambda/breakroom)
"aL" = (
/obj/structure/surface/table/reinforced/prison,
/obj/item/spacecash/c1000,
/obj/item/spacecash/c1000,
/obj/item/spacecash/c1000,
/obj/item/spacecash/c1000,
/turf/open/floor/strata{
	dir = 4;
	icon_state = "white_cyan1"
	},
/area/bigredv2/caves/lambda/breakroom)
"aM" = (
/turf/open/floor/almayer{
	dir = 1;
	icon_state = "w-y2"
	},
/area/bigredv2/caves/lambda/breakroom)
"aN" = (
/turf/open/mars_cave,
/area/bigredv2/caves_lambda)
"aP" = (
/turf/open/mars_cave{
	icon_state = "mars_cave_7"
	},
/area/bigredv2/caves_lambda)
"aQ" = (
/turf/open/mars_cave{
	icon_state = "mars_cave_18"
	},
/area/bigredv2/caves_lambda)
"aR" = (
/obj/structure/filingcabinet{
	density = 0;
	pixel_x = 8;
	pixel_y = 19
	},
/obj/structure/filingcabinet{
	density = 0;
	pixel_x = -9;
	pixel_y = 20
	},
/turf/open/floor/strata{
	dir = 4;
	icon_state = "white_cyan1"
	},
/area/bigredv2/caves/lambda/breakroom)
"aS" = (
/obj/effect/glowshroom,
/turf/open/mars_cave{
	icon_state = "mars_cave_2"
	},
/area/bigredv2/caves_lambda)
"aT" = (
/turf/open/mars_cave{
	icon_state = "mars_cave_4"
	},
/area/bigredv2/caves_lambda)
"aV" = (
/obj/effect/landmark/structure_spawner/setup/distress/xeno_weed_node,
/turf/open/mars_cave{
	icon_state = "mars_cave_2"
	},
/area/bigredv2/caves_lambda)
"aW" = (
/obj/structure/machinery/door/airlock/almayer/secure/reinforced/colony{
	icon_state = "door_locked"
	},
/obj/structure/machinery/door/poddoor/almayer/closed{
	dir = 4;
	id = "vault";
	name = "Vault Lockdown"
	},
/turf/open/floor{
	icon_state = "delivery"
	},
/area/bigredv2/caves/lambda/breakroom)
"aX" = (
/turf/open/mars_cave{
	icon_state = "mars_cave_8"
	},
/area/bigredv2/caves_lambda)
"aY" = (
/turf/open/mars_cave{
	icon_state = "mars_cave_10"
	},
/area/bigredv2/caves_lambda)
"aZ" = (
/turf/open/mars_cave{
	icon_state = "mars_cave_5"
	},
/area/bigredv2/caves_lambda)
"ba" = (
/turf/open/mars_cave{
	icon_state = "mars_cave_2"
	},
/area/bigredv2/caves_lambda)
"zP" = (
/obj/effect/glowshroom,
/turf/open/mars_cave{
	icon_state = "mars_cave_5"
	},
/area/bigredv2/caves_lambda)

(1,1,1) = {"
aA
aa
ak
ak
ak
aI
am
al
aI
ak
ak
aY
aT
ak
"}
(2,1,1) = {"
af
aa
ak
ak
aY
aG
aw
aD
aG
ai
ai
aZ
ba
aX
"}
(3,1,1) = {"
aa
aa
ah
ai
zP
aG
aH
aE
aG
aP
ba
aP
ai
aZ
"}
(4,1,1) = {"
aa
ae
aP
ba
aZ
aI
ax
aC
aI
ae
ai
ac
ba
aZ
"}
(5,1,1) = {"
ai
ai
aj
aP
aZ
aG
ao
ag
aG
aP
ba
ba
ba
aZ
"}
(6,1,1) = {"
aY
ai
ai
ba
ad
aG
aw
aD
aG
aQ
aN
aS
ba
aZ
"}
(7,1,1) = {"
ba
ba
ak
ak
ak
aI
an
aE
ap
ak
ak
aP
aS
aZ
"}
(8,1,1) = {"
ba
ab
ak
aI
aI
aI
aI
aW
aI
aI
ak
ba
aP
aZ
"}
(9,1,1) = {"
aZ
ak
ak
aI
aR
as
au
au
aK
aI
ak
aY
ba
aZ
"}
(10,1,1) = {"
aZ
ak
ak
aI
au
at
aq
at
au
aI
ak
aP
ba
aZ
"}
(11,1,1) = {"
ab
ak
ak
aI
aF
at
aB
at
aJ
aI
ak
aP
ba
aZ
"}
(12,1,1) = {"
ak
ak
ak
aI
au
at
aM
at
aL
aI
ak
aQ
aV
ba
"}
(13,1,1) = {"
ak
ak
ak
aI
ar
av
aL
aL
aL
aI
ak
ba
ba
ba
"}
(14,1,1) = {"
ak
ak
ak
aI
aI
aI
aI
aI
aI
aI
ak
ba
ba
ba
"}
