//MAP CONVERTED BY dmm2tgm.py THIS HEADER COMMENT PREVENTS RECONVERSION, DO NOT REMOVE
"aa" = (
/obj/structure/barricade/wooden{
	desc = "This barricade is heavily reinforced. Nothing short of blasting it open seems like it'll do the trick, that or melting the breams supporting it...";
	dir = 8;
	health = 25000
	},
/turf/open/floor/plating,
/area/bigredv2/outside/cargo)
"ad" = (
/obj/structure/pipes/standard/simple/hidden/green,
/turf/open/floor,
/area/bigredv2/outside/cargo)
"ae" = (
/obj/structure/largecrate,
/turf/open/floor,
/area/bigredv2/outside/cargo)
"af" = (
/obj/effect/decal/cleanable/dirt,
/turf/open/floor,
/area/bigredv2/outside/cargo)
"ag" = (
/obj/structure/largecrate,
/obj/effect/decal/cleanable/dirt,
/turf/open/floor,
/area/bigredv2/outside/cargo)
"ah" = (
/obj/structure/closet/firecloset/full,
/turf/open/floor,
/area/bigredv2/outside/cargo)
"ai" = (
/turf/closed/wall/solaris,
/area/bigredv2/outside/cargo)
"aj" = (
/obj/structure/surface/table,
/obj/effect/spawner/random/tool,
/obj/effect/landmark/item_pool_spawner/survivor_ammo/buckshot,
/turf/open/floor,
/area/bigredv2/outside/cargo)
"ak" = (
/obj/structure/window/framed/solaris,
/turf/open/floor/plating,
/area/bigredv2/outside/cargo)
"am" = (
/obj/structure/largecrate/cow,
/turf/open/floor,
/area/bigredv2/outside/cargo)
"an" = (
/obj/effect/decal/cleanable/blood,
/turf/open/floor,
/area/bigredv2/outside/cargo)
"ap" = (
/obj/structure/closet/emcloset,
/turf/open/floor,
/area/bigredv2/outside/cargo)
"aq" = (
/obj/structure/surface/table,
/obj/effect/spawner/random/toolbox,
/obj/structure/pipes/vents/pump{
	dir = 4
	},
/obj/effect/landmark/item_pool_spawner/survivor_ammo/buckshot,
/turf/open/floor,
/area/bigredv2/outside/cargo)
"ar" = (
/obj/structure/pipes/standard/simple/hidden/green{
	dir = 4
	},
/obj/effect/decal/cleanable/dirt,
/turf/open/floor,
/area/bigredv2/outside/cargo)
"as" = (
/obj/structure/pipes/standard/simple/hidden/green{
	dir = 10
	},
/obj/effect/decal/cleanable/dirt,
/turf/open/floor,
/area/bigredv2/outside/cargo)
"at" = (
/obj/effect/decal/cleanable/dirt,
/obj/item/tool/lighter/random,
/turf/open/floor,
/area/bigredv2/outside/cargo)
"au" = (
/obj/structure/pipes/standard/simple/hidden/green,
/obj/effect/decal/cleanable/dirt,
/turf/open/floor,
/area/bigredv2/outside/cargo)
"av" = (
/turf/open/floor,
/area/bigredv2/outside/cargo)
"aw" = (
/obj/structure/pipes/standard/simple/hidden/green{
	dir = 6
	},
/turf/open/floor,
/area/bigredv2/outside/cargo)
"ax" = (
/obj/structure/pipes/standard/simple/hidden/green{
	dir = 4
	},
/turf/open/floor,
/area/bigredv2/outside/cargo)
"ay" = (
/obj/structure/pipes/vents/pump{
	dir = 8
	},
/turf/open/floor,
/area/bigredv2/outside/cargo)
"az" = (
/obj/structure/machinery/autolathe,
/turf/open/floor,
/area/bigredv2/outside/cargo)
"aA" = (
/obj/structure/machinery/light,
/turf/open/floor,
/area/bigredv2/outside/cargo)
"aB" = (
/obj/structure/machinery/light{
	dir = 8
	},
/obj/structure/surface/table,
/obj/effect/spawner/random/tool,
/turf/open/floor,
/area/bigredv2/outside/cargo)
"aE" = (
/obj/structure/window/framed/solaris,
/obj/structure/machinery/door/poddoor/shutters/almayer{
	dir = 4;
	id = "Cargonia";
	name = "\improper Cargo Shutters"
	},
/turf/open/floor/plating,
/area/bigredv2/outside/cargo)
"aI" = (
/obj/structure/pipes/standard/manifold/hidden/green{
	dir = 1
	},
/turf/open/floor,
/area/bigredv2/outside/cargo)
"aN" = (
/obj/structure/machinery/light{
	dir = 1
	},
/turf/open/floor,
/area/bigredv2/outside/cargo)
"aV" = (
/obj/effect/decal/cleanable/dirt,
/obj/structure/pipes/standard/manifold/hidden/green{
	dir = 8
	},
/turf/open/floor,
/area/bigredv2/outside/cargo)
"aZ" = (
/obj/structure/surface/table,
/obj/effect/spawner/random/bomb_supply,
/turf/open/floor,
/area/bigredv2/outside/cargo)
"ba" = (
/obj/structure/surface/table,
/obj/item/stack/sheet/glass{
	amount = 30
	},
/turf/open/floor,
/area/bigredv2/outside/cargo)
"bb" = (
/obj/effect/decal/cleanable/dirt,
/obj/structure/pipes/standard/simple/hidden/green,
/turf/open/floor,
/area/bigredv2/outside/cargo)
"bh" = (
/obj/structure/largecrate/random/barrel,
/turf/open/floor,
/area/bigredv2/outside/cargo)
"bm" = (
/obj/item/device/flashlight,
/obj/item/reagent_container/spray/cleaner,
/turf/open/floor,
/area/bigredv2/outside/cargo)
"bp" = (
/obj/structure/pipes/standard/manifold/hidden/green,
/turf/open/floor,
/area/bigredv2/outside/cargo)
"bs" = (
/obj/effect/decal/cleanable/dirt,
/obj/structure/pipes/standard/simple/hidden/green{
	dir = 4
	},
/turf/open/floor,
/area/bigredv2/outside/cargo)
"bt" = (
/obj/effect/decal/cleanable/dirt,
/obj/structure/pipes/vents/pump{
	dir = 8
	},
/turf/open/floor,
/area/bigredv2/outside/cargo)
"bv" = (
/obj/structure/pipes/standard/manifold/hidden/green{
	dir = 8
	},
/turf/open/floor,
/area/bigredv2/outside/cargo)
"bz" = (
/obj/effect/landmark/corpsespawner/security/marshal,
/turf/open/floor,
/area/bigredv2/outside/cargo)
"bA" = (
/obj/structure/machinery/light{
	dir = 8
	},
/turf/open/floor,
/area/bigredv2/outside/cargo)
"bB" = (
/obj/effect/decal/cleanable/dirt,
/obj/item/device/megaphone,
/turf/open/floor,
/area/bigredv2/outside/cargo)
"bD" = (
/obj/effect/decal/cleanable/dirt,
/obj/effect/decal/cleanable/dirt,
/turf/open/floor,
/area/bigredv2/outside/cargo)
"bG" = (
/obj/structure/surface/table,
/obj/effect/spawner/random/bomb_supply,
/obj/effect/spawner/random/tool,
/obj/effect/spawner/random/tool,
/obj/structure/machinery/light{
	dir = 4
	},
/turf/open/floor,
/area/bigredv2/outside/cargo)
"bH" = (
/obj/structure/machinery/camera/autoname{
	dir = 4
	},
/turf/open/floor,
/area/bigredv2/outside/cargo)
"bO" = (
/obj/structure/machinery/door_control{
	id = "Cargonia";
	name = "Storm Shutters";
	pixel_x = 32
	},
/turf/open/floor,
/area/bigredv2/outside/cargo)
"bP" = (
/obj/effect/decal/cleanable/dirt,
/obj/structure/reagent_dispensers/fueltank,
/turf/open/floor,
/area/bigredv2/outside/cargo)
"bQ" = (
/obj/structure/pipes/standard/simple/hidden/green,
/obj/structure/machinery/light{
	dir = 4
	},
/turf/open/floor,
/area/bigredv2/outside/cargo)
"bS" = (
/obj/structure/pipes/standard/simple/hidden/green{
	dir = 5
	},
/turf/open/floor,
/area/bigredv2/outside/cargo)
"bZ" = (
/obj/structure/reagent_dispensers/watertank,
/turf/open/floor,
/area/bigredv2/outside/cargo)
"cb" = (
/obj/structure/filingcabinet,
/obj/effect/landmark/objective_landmark/science,
/turf/open/floor,
/area/bigredv2/outside/cargo)
"cc" = (
/obj/structure/filingcabinet,
/obj/structure/machinery/light{
	dir = 1
	},
/obj/effect/landmark/objective_landmark/close,
/turf/open/floor,
/area/bigredv2/outside/cargo)
"cd" = (
/obj/structure/reagent_dispensers/fueltank,
/turf/open/floor,
/area/bigredv2/outside/cargo)
"cf" = (
/obj/structure/bed/chair/office/dark,
/turf/open/floor,
/area/bigredv2/outside/cargo)
"cg" = (
/obj/structure/surface/table,
/obj/effect/spawner/random/tech_supply,
/obj/effect/spawner/random/tool,
/obj/effect/spawner/random/tool,
/turf/open/floor,
/area/bigredv2/outside/cargo)
"ch" = (
/obj/structure/surface/table,
/turf/open/floor,
/area/bigredv2/outside/cargo)
"ci" = (
/obj/structure/surface/table,
/obj/item/device/radio,
/obj/structure/pipes/vents/pump{
	dir = 1
	},
/turf/open/floor,
/area/bigredv2/outside/cargo)
"cj" = (
/obj/structure/machinery/computer/ordercomp,
/turf/open/floor,
/area/bigredv2/outside/cargo)
"ck" = (
/obj/structure/machinery/camera/autoname{
	dir = 1
	},
/turf/open/floor,
/area/bigredv2/outside/cargo)
"cl" = (
/obj/structure/barricade/wooden{
	desc = "This barricade is heavily reinforced. Nothing short of blasting it open seems like it'll do the trick, that or melting the breams supporting it...";
	health = 25000
	},
/turf/open/floor,
/area/bigredv2/outside/cargo)
"cm" = (
/obj/structure/pipes/standard/simple/hidden/green,
/obj/structure/barricade/wooden{
	desc = "This barricade is heavily reinforced. Nothing short of blasting it open seems like it'll do the trick, that or melting the breams supporting it...";
	health = 25000
	},
/turf/open/floor,
/area/bigredv2/outside/cargo)
"cn" = (
/obj/structure/surface/table,
/obj/effect/spawner/random/toolbox,
/obj/effect/spawner/random/tool,
/obj/structure/pipes/standard/simple/hidden/green,
/turf/open/floor,
/area/bigredv2/outside/cargo)
"co" = (
/obj/structure/surface/table,
/obj/effect/spawner/random/toolbox,
/obj/effect/spawner/random/tool,
/turf/open/floor,
/area/bigredv2/outside/cargo)
"cp" = (
/obj/structure/surface/table,
/obj/effect/spawner/random/toolbox,
/turf/open/floor,
/area/bigredv2/outside/cargo)
"cq" = (
/obj/structure/surface/table,
/obj/effect/spawner/random/tool,
/obj/effect/spawner/random/tool,
/obj/effect/spawner/random/bomb_supply,
/obj/effect/spawner/random/bomb_supply,
/obj/effect/landmark/item_pool_spawner/survivor_ammo/buckshot,
/turf/open/floor,
/area/bigredv2/outside/cargo)
"cr" = (
/obj/structure/surface/table,
/obj/effect/spawner/random/bomb_supply,
/obj/effect/spawner/random/bomb_supply,
/obj/effect/spawner/random/tool,
/obj/effect/landmark/item_pool_spawner/survivor_ammo/buckshot,
/turf/open/floor,
/area/bigredv2/outside/cargo)
"cs" = (
/obj/structure/surface/table,
/obj/effect/spawner/random/bomb_supply,
/obj/effect/spawner/random/bomb_supply,
/turf/open/floor,
/area/bigredv2/outside/cargo)
"ct" = (
/obj/structure/reagent_dispensers/fueltank,
/obj/structure/machinery/light{
	dir = 4
	},
/turf/open/floor,
/area/bigredv2/outside/cargo)
"cu" = (
/obj/structure/window/framed/solaris,
/obj/structure/machinery/door/poddoor/shutters/almayer{
	id = "Cargonia";
	name = "\improper Cargo Shutters"
	},
/turf/open/floor/plating,
/area/bigredv2/outside/cargo)
"cv" = (
/turf/closed/wall/solaris/reinforced,
/area/bigredv2/outside/engineering)
"cU" = (
/obj/effect/decal/cleanable/dirt,
/turf/open/floor/floor4,
/area/bigredv2/outside/cargo)
"en" = (
/obj/structure/machinery/light{
	dir = 8
	},
/turf/open/floor/loadingarea,
/area/bigredv2/outside/cargo)
"eP" = (
/obj/effect/decal/cleanable/dirt,
/obj/effect/landmark/good_item,
/turf/open/floor/bot/north,
/area/bigredv2/outside/cargo)
"gt" = (
/obj/structure/largecrate/random/barrel,
/turf/open/floor/bot/north,
/area/bigredv2/outside/cargo)
"gH" = (
/obj/structure/pipes/standard/simple/hidden/green{
	dir = 4
	},
/turf/open/floor/loadingarea/east,
/area/bigredv2/outside/cargo)
"ji" = (
/obj/structure/pipes/standard/simple/hidden/green{
	dir = 5
	},
/obj/structure/cargo_container/arious/rightmid,
/turf/open/floor/bot/north,
/area/bigredv2/outside/cargo)
"jy" = (
/obj/structure/largecrate,
/obj/structure/pipes/standard/simple/hidden/green{
	dir = 4
	},
/turf/open/floor/bot/north,
/area/bigredv2/outside/cargo)
"jI" = (
/obj/structure/pipes/standard/simple/hidden/green{
	dir = 4
	},
/turf/open/floor/floor4,
/area/bigredv2/outside/cargo)
"kh" = (
/turf/open/floor/loadingarea/west,
/area/bigredv2/outside/cargo)
"kI" = (
/obj/structure/pipes/standard/simple/hidden/green,
/turf/open/floor/delivery,
/area/bigredv2/outside/engineering)
"kS" = (
/obj/structure/pipes/standard/simple/hidden/green,
/obj/structure/largecrate/random/barrel,
/turf/open/floor/bot/north,
/area/bigredv2/outside/cargo)
"lk" = (
/obj/structure/cargo_container/kelland/left,
/turf/open/floor/bot/north,
/area/bigredv2/outside/cargo)
"na" = (
/obj/structure/cargo_container/watatsumi/right,
/turf/open/floor/bot/north,
/area/bigredv2/outside/cargo)
"ok" = (
/turf/open/floor/floor4,
/area/bigredv2/outside/cargo)
"ow" = (
/obj/structure/cargo_container/kelland/right,
/turf/open/floor/bot/north,
/area/bigredv2/outside/cargo)
"qb" = (
/obj/structure/barricade/wooden{
	desc = "This barricade is heavily reinforced. Nothing short of blasting it open seems like it'll do the trick, that or melting the breams supporting it...";
	dir = 8;
	health = 25000
	},
/turf/open/floor/delivery,
/area/bigredv2/outside/cargo)
"qW" = (
/obj/structure/machinery/door/airlock/almayer/engineering/colony{
	name = "\improper Cargo Bay Quartermaster"
	},
/turf/open/floor/delivery,
/area/bigredv2/outside/cargo)
"tQ" = (
/obj/structure/pipes/standard/simple/hidden/green{
	dir = 4
	},
/obj/structure/cargo_container/kelland/left,
/turf/open/floor/bot/north,
/area/bigredv2/outside/cargo)
"tV" = (
/turf/open/floor/delivery,
/area/bigredv2/outside/cargo)
"xh" = (
/obj/structure/cargo_container/arious/leftmid,
/turf/open/floor/bot/north,
/area/bigredv2/outside/cargo)
"xm" = (
/obj/structure/pipes/standard/simple/hidden/green{
	dir = 4
	},
/obj/structure/machinery/door/airlock/almayer/security/glass/colony{
	name = "\improper Cargo Bay Security"
	},
/turf/open/floor/delivery,
/area/bigredv2/outside/cargo)
"xt" = (
/obj/effect/decal/cleanable/dirt,
/obj/structure/cargo_container/watatsumi/leftmid,
/turf/open/floor/bot/north,
/area/bigredv2/outside/cargo)
"yG" = (
/obj/structure/largecrate,
/turf/open/floor/bot/north,
/area/bigredv2/outside/cargo)
"zb" = (
/obj/structure/machinery/power/apc/directional/no_power/north,
/turf/open/floor,
/area/bigredv2/outside/cargo)
"zH" = (
/obj/structure/cargo_container/watatsumi/rightmid,
/turf/open/floor/bot/north,
/area/bigredv2/outside/cargo)
"BY" = (
/turf/open/floor/loadingarea/east,
/area/bigredv2/outside/cargo)
"BZ" = (
/obj/structure/pipes/standard/simple/hidden/green,
/obj/structure/machinery/door/airlock/multi_tile/almayer/generic{
	name = "\improper Cargo Offices"
	},
/turf/open/floor/delivery,
/area/bigredv2/outside/cargo)
"DK" = (
/obj/structure/machinery/door/airlock/multi_tile/almayer/generic{
	dir = 1;
	name = "\improper Cargo Bay"
	},
/turf/open/floor/delivery,
/area/bigredv2/outside/cargo)
"DO" = (
/obj/structure/machinery/door/airlock/multi_tile/almayer/generic{
	name = "\improper Engineering Complex"
	},
/turf/open/floor/delivery,
/area/bigredv2/outside/engineering)
"Gr" = (
/obj/structure/pipes/standard/simple/hidden/green{
	dir = 9
	},
/obj/structure/cargo_container/kelland/right,
/turf/open/floor/bot/north,
/area/bigredv2/outside/cargo)
"Gu" = (
/obj/effect/decal/cleanable/dirt,
/obj/structure/surface/table,
/obj/structure/machinery/light{
	dir = 4
	},
/obj/effect/spawner/random/toolbox,
/turf/open/floor,
/area/bigredv2/outside/cargo)
"HC" = (
/obj/structure/pipes/standard/simple/hidden/green{
	dir = 4
	},
/obj/structure/cargo_container/arious/right,
/turf/open/floor/bot/north,
/area/bigredv2/outside/cargo)
"It" = (
/turf/open/floor/loadingarea,
/area/bigredv2/outside/cargo)
"IL" = (
/obj/effect/decal/cleanable/dirt,
/obj/structure/closet/crate/trashcart,
/turf/open/floor/bot/north,
/area/bigredv2/outside/cargo)
"Jp" = (
/obj/structure/pipes/standard/simple/hidden/green{
	dir = 4
	},
/obj/effect/decal/cleanable/dirt,
/obj/structure/cargo_container/kelland/right,
/turf/open/floor/bot/north,
/area/bigredv2/outside/cargo)
"KO" = (
/obj/effect/decal/cleanable/dirt,
/obj/structure/surface/table,
/obj/effect/spawner/random/tool,
/turf/open/floor,
/area/bigredv2/outside/cargo)
"Mb" = (
/obj/structure/pipes/standard/simple/hidden/green{
	dir = 9
	},
/turf/open/floor/bot/north,
/area/bigredv2/outside/cargo)
"MA" = (
/obj/structure/cargo_container/grant/right,
/turf/open/floor/bot/north,
/area/bigredv2/outside/cargo)
"Oi" = (
/obj/structure/pipes/standard/simple/hidden/green{
	dir = 4
	},
/obj/effect/decal/cleanable/dirt,
/obj/structure/cargo_container/kelland/left,
/turf/open/floor/bot/north,
/area/bigredv2/outside/cargo)
"OA" = (
/obj/structure/largecrate/cow,
/turf/open/floor/loadingarea,
/area/bigredv2/outside/cargo)
"Tv" = (
/turf/open/floor/bot/north,
/area/bigredv2/outside/cargo)
"Ud" = (
/obj/structure/cargo_container/grant/left,
/turf/open/floor/bot/north,
/area/bigredv2/outside/cargo)
"Ux" = (
/obj/effect/decal/cleanable/dirt,
/obj/structure/largecrate,
/turf/open/floor/bot/north,
/area/bigredv2/outside/cargo)
"UV" = (
/obj/structure/cargo_container/grant/rightmid,
/turf/open/floor/bot/north,
/area/bigredv2/outside/cargo)
"Va" = (
/obj/structure/pipes/standard/simple/hidden/green{
	dir = 4
	},
/turf/open/floor/delivery,
/area/bigredv2/outside/cargo)
"Xr" = (
/obj/item/reagent_container/spray/cleaner,
/obj/structure/pipes/standard/simple/hidden/green,
/turf/open/floor/floor4,
/area/bigredv2/outside/cargo)
"Zt" = (
/obj/structure/pipes/standard/simple/hidden/green,
/obj/structure/machinery/door/airlock/almayer/engineering/colony{
	dir = 1;
	name = "\improper Cargo Bay Quartermaster"
	},
/turf/open/floor/delivery,
/area/bigredv2/outside/cargo)
"ZQ" = (
/obj/structure/pipes/standard/simple/hidden/green{
	dir = 4
	},
/obj/effect/decal/cleanable/dirt,
/turf/open/floor/bot/north,
/area/bigredv2/outside/cargo)

(1,1,1) = {"
aa
aa
aa
ai
aE
aE
aE
ai
ai
ai
Va
DK
ai
ai
ai
ai
qW
ai
ai
"}
(2,1,1) = {"
tV
qb
tV
ai
av
av
av
ai
aZ
bA
ax
av
bH
aB
ai
aN
av
cg
ai
"}
(3,1,1) = {"
av
av
av
en
xh
gt
av
ak
ba
ok
jI
ok
ok
av
ai
av
cf
ch
cu
"}
(4,1,1) = {"
ad
ad
au
ad
ji
Ux
av
ak
bh
ok
aI
bb
Xr
ad
Zt
ad
ad
ci
cu
"}
(5,1,1) = {"
ae
av
av
It
HC
eP
av
ai
av
ok
jI
ok
cU
bP
ak
cb
af
cj
cu
"}
(6,1,1) = {"
af
an
av
am
aI
ad
ad
Zt
ad
bQ
bp
bz
KO
Gu
ak
cb
av
av
cu
"}
(7,1,1) = {"
ag
av
av
It
jy
IL
Tv
ai
ai
ai
Va
DK
ai
ai
ai
cc
av
ck
ai
"}
(8,1,1) = {"
av
av
av
av
ar
af
av
af
av
av
ax
af
bA
ae
ai
ak
qW
ak
ai
"}
(9,1,1) = {"
av
av
av
It
ZQ
Ud
av
xt
Tv
av
ax
bB
av
av
av
av
av
aA
cv
"}
(10,1,1) = {"
ap
av
aw
ad
Mb
UV
av
zH
gt
av
aI
ad
ad
ad
bS
af
av
cl
DO
"}
(11,1,1) = {"
ap
av
ax
OA
Tv
MA
av
na
yG
av
ax
av
av
av
aI
ad
ad
cm
kI
"}
(12,1,1) = {"
ah
av
ay
av
av
av
av
av
av
av
bs
bD
BY
av
gH
av
av
cn
cv
"}
(13,1,1) = {"
ai
ai
ai
ai
ak
ak
ak
ai
aN
av
bt
bD
Tv
av
tQ
af
av
co
cv
"}
(14,1,1) = {"
aj
aq
az
ai
av
av
av
ai
zb
av
af
bD
lk
av
Jp
af
av
cp
cv
"}
(15,1,1) = {"
af
ar
aA
ai
af
af
av
ai
av
af
af
af
ow
av
Oi
av
av
aj
cv
"}
(16,1,1) = {"
af
as
ad
BZ
au
aV
ad
BZ
ad
au
bv
au
kS
ad
Gr
av
av
cq
cv
"}
(17,1,1) = {"
av
at
af
tV
af
ar
av
tV
av
af
bs
av
kh
av
kh
av
av
cr
cv
"}
(18,1,1) = {"
av
av
av
ai
aN
ax
av
ai
av
bm
ax
av
av
av
av
av
av
cs
cv
"}
(19,1,1) = {"
ak
ak
ai
ai
ak
xm
ak
ai
av
av
ax
bG
bO
av
bZ
cd
cd
ct
cv
"}
