//MAP CONVERTED BY dmm2tgm.py THIS HEADER COMMENT PREVENTS RECONVERSION, DO NOT REMOVE
"b" = (
/turf/closed/wall/solaris/rock,
/area/bigredv2/caves)
"h" = (
/obj/effect/landmark/structure_spawner/setup/distress/xeno_weed_node,
/turf/open/auto_turf/br_caves/layer1,
/area/bigredv2/caves_lambda)
"j" = (
/obj/effect/landmark/structure_spawner/setup/distress/xeno_weed_node,
/turf/open/auto_turf/br_dirt/layer1,
/area/bigredv2/caves_north)
"n" = (
/turf/open/auto_turf/br_dirt/layer1,
/area/bigredv2/caves_north)
"C" = (
/turf/open/auto_turf/br_dirt/layer2,
/area/bigredv2/caves_north)
"H" = (
/turf/open/auto_turf/br_caves/layer1,
/area/bigredv2/caves_north)
"S" = (
/turf/open/auto_turf/br_caves/layer1,
/area/bigredv2/caves_lambda)
"Z" = (
/obj/effect/landmark/structure_spawner/xvx_hive/xeno_door,
/obj/effect/landmark/structure_spawner/setup/distress/xeno_door,
/turf/open/auto_turf/br_caves/layer1,
/area/bigredv2/caves_lambda)

(1,1,1) = {"
H
H
H
H
C
n
H
H
H
H
"}
(2,1,1) = {"
b
H
H
n
j
n
H
H
H
H
"}
(3,1,1) = {"
b
b
H
C
n
H
H
b
b
b
"}
(4,1,1) = {"
b
b
Z
Z
Z
b
b
b
b
b
"}
(5,1,1) = {"
b
S
S
S
S
S
b
b
b
b
"}
(6,1,1) = {"
b
S
S
S
h
S
S
b
b
b
"}
(7,1,1) = {"
S
S
S
S
S
S
S
b
S
S
"}
(8,1,1) = {"
S
S
S
S
S
S
S
Z
S
S
"}
(9,1,1) = {"
S
h
S
S
S
h
S
Z
S
S
"}
(10,1,1) = {"
S
S
S
S
S
S
S
Z
S
h
"}
