//MAP CONVERTED BY dmm2tgm.py THIS HEADER COMMENT PREVENTS RECONVERSION, DO NOT REMOVE
"aa" = (
/turf/closed/wall/solaris,
/area/bigredv2/outside/filtration_plant)
"ac" = (
/obj/effect/decal/cleanable/dirt,
/obj/structure/pipes/standard/simple/hidden/green{
	dir = 4
	},
/turf/open/floor,
/area/bigredv2/outside/filtration_plant)
"ad" = (
/obj/effect/decal/cleanable/dirt,
/turf/open/floor,
/area/bigredv2/outside/filtration_plant)
"ae" = (
/obj/structure/pipes/vents/pump,
/obj/effect/decal/cleanable/dirt,
/obj/effect/decal/cleanable/dirt,
/turf/open/floor,
/area/bigredv2/outside/filtration_plant)
"af" = (
/obj/effect/decal/cleanable/dirt,
/obj/structure/pipes/standard/simple/hidden/green,
/turf/open/floor,
/area/bigredv2/outside/filtration_plant)
"ah" = (
/obj/structure/window/framed/solaris,
/turf/open/floor/plating,
/area/bigredv2/outside/filtration_plant)
"ai" = (
/turf/open/floor/plating,
/area/bigredv2/outside/filtration_plant)
"aj" = (
/turf/closed/wall/solaris/rock,
/area/bigredv2/caves)
"ak" = (
/obj/structure/closet/wardrobe/atmospherics_yellow,
/turf/open/floor,
/area/bigredv2/outside/filtration_plant)
"al" = (
/obj/structure/surface/table,
/obj/item/tool/lighter/random,
/obj/effect/decal/cleanable/dirt,
/turf/open/floor,
/area/bigredv2/outside/filtration_plant)
"am" = (
/turf/open/floor{
	dir = 1;
	icon_state = "asteroidfloor";
	tag = "icon-asteroidfloor (NORTH)"
	},
/area/bigredv2/outside/se)
"an" = (
/obj/effect/decal/cleanable/dirt,
/obj/effect/decal/cleanable/dirt,
/turf/open/floor,
/area/bigredv2/outside/filtration_plant)
"ap" = (
/obj/structure/reagent_dispensers/watertank,
/turf/open/floor,
/area/bigredv2/outside/filtration_plant)
"aq" = (
/obj/effect/decal/cleanable/dirt,
/obj/structure/machinery/camera/autoname{
	dir = 1
	},
/turf/open/floor,
/area/bigredv2/outside/filtration_plant)
"ar" = (
/obj/structure/pipes/standard/simple/hidden/green{
	dir = 5
	},
/turf/open/floor,
/area/bigredv2/outside/filtration_plant)
"as" = (
/obj/structure/pipes/standard/manifold/hidden/green,
/obj/effect/decal/cleanable/dirt,
/turf/open/floor,
/area/bigredv2/outside/filtration_plant)
"at" = (
/obj/structure/bed/chair{
	dir = 4
	},
/obj/effect/decal/cleanable/dirt,
/turf/open/floor,
/area/bigredv2/outside/filtration_plant)
"au" = (
/obj/structure/machinery/computer/atmos_alert{
	dir = 8
	},
/obj/structure/surface/table,
/turf/open/floor,
/area/bigredv2/outside/filtration_plant)
"av" = (
/obj/item/tool/warning_cone,
/turf/open/floor{
	dir = 9;
	icon_state = "asteroidwarning";
	tag = "icon-asteroidwarning (NORTHWEST)"
	},
/area/bigredv2/outside/se)
"aw" = (
/turf/open/floor{
	dir = 8;
	icon_state = "asteroidwarning";
	tag = "icon-asteroidwarning (WEST)"
	},
/area/bigredv2/outside/se)
"ax" = (
/turf/open/floor{
	dir = 1;
	icon_state = "asteroidwarning";
	tag = "icon-asteroidwarning (NORTH)"
	},
/area/bigredv2/outside/se)
"ay" = (
/obj/effect/decal/cleanable/dirt,
/turf/closed/wall/solaris,
/area/bigredv2/outside/filtration_plant)
"az" = (
/turf/open/floor,
/area/bigredv2/outside/filtration_plant)
"aA" = (
/obj/structure/pipes/standard/simple/hidden/green{
	dir = 4
	},
/obj/structure/machinery/door/airlock/almayer/engineering/colony{
	name = "\improper Atmospherics Condenser Storage";
	},
/turf/open/floor,
/area/bigredv2/outside/filtration_plant)
"aB" = (
/obj/structure/machinery/door/airlock/almayer/engineering/colony{
	dir = 1;
	name = "\improper Atmospherics Condenser";
	},
/turf/open/floor,
/area/bigredv2/outside/filtration_plant)
"aC" = (
/obj/effect/decal/cleanable/dirt,
/obj/structure/pipes/standard/simple/hidden/green{
	dir = 10
	},
/turf/open/floor,
/area/bigredv2/outside/filtration_plant)
"aD" = (
/obj/structure/machinery/door/airlock/almayer/engineering/colony{
	dir = 1;
	name = "\improper Atmospherics Condenser";
	},
/obj/structure/pipes/standard/simple/hidden/green,
/turf/open/floor,
/area/bigredv2/outside/filtration_plant)
"aE" = (
/obj/effect/decal/cleanable/dirt,
/obj/item/device/radio/headset,
/turf/open/floor,
/area/bigredv2/outside/filtration_plant)
"aF" = (
/obj/structure/machinery/portable_atmospherics/powered/scrubber/huge/chan,
/turf/open/floor/plating,
/area/bigredv2/outside/filtration_plant)
"aG" = (
/turf/open/mars{
	icon_state = "mars_dirt_13";
	tag = "icon-mars_dirt_13"
	},
/area/bigredv2/outside/se)
"aH" = (
/obj/effect/decal/cleanable/dirt,
/obj/structure/pipes/standard/manifold/hidden/green{
	dir = 4
	},
/turf/open/floor,
/area/bigredv2/outside/filtration_plant)
"aI" = (
/turf/open/floor{
	dir = 4;
	icon_state = "asteroidwarning";
	tag = "icon-asteroidwarning (EAST)"
	},
/area/bigredv2/outside/se)
"aJ" = (
/turf/open/floor{
	icon_state = "asteroidwarning";
	tag = "icon-asteroidwarning"
	},
/area/bigredv2/outside/se)
"aK" = (
/turf/open/mars{
	icon_state = "mars_dirt_10";
	tag = "icon-mars_dirt_10"
	},
/area/bigredv2/outside/se)
"aL" = (
/obj/structure/reagent_dispensers/fueltank,
/turf/open/floor{
	dir = 1;
	icon_state = "bot"
	},
/area/bigredv2/outside/filtration_plant)
"aM" = (
/obj/structure/reagent_dispensers/watertank,
/turf/open/floor{
	dir = 1;
	icon_state = "bot"
	},
/area/bigredv2/outside/filtration_plant)
"aN" = (
/obj/structure/pipes/standard/simple/hidden/green,
/turf/open/floor,
/area/bigredv2/outside/filtration_plant)
"aO" = (
/obj/structure/pipes/vents/pump,
/turf/open/floor,
/area/bigredv2/outside/filtration_plant)
"aP" = (
/obj/effect/landmark/crap_item,
/turf/open/floor,
/area/bigredv2/outside/filtration_plant)
"aQ" = (
/obj/structure/surface/table,
/obj/effect/landmark/good_item,
/turf/open/floor,
/area/bigredv2/outside/filtration_plant)
"aR" = (
/obj/structure/surface/table,
/obj/effect/spawner/random/toolbox,
/turf/open/floor,
/area/bigredv2/outside/filtration_plant)
"aS" = (
/turf/open/floor{
	dir = 1;
	icon_state = "bot"
	},
/area/bigredv2/outside/filtration_plant)
"aT" = (
/obj/structure/dispenser/oxygen,
/turf/open/floor{
	dir = 1;
	icon_state = "bot"
	},
/area/bigredv2/outside/filtration_plant)
"aV" = (
/obj/effect/decal/warning_stripes{
	icon_state = "U-N";
	tag = "icon-U-N"
	},
/obj/structure/machinery/computer3/server/rack,
/turf/open/floor,
/area/bigredv2/outside/filtration_plant)
"aW" = (
/obj/structure/pipes/standard/manifold/hidden/green,
/turf/open/floor,
/area/bigredv2/outside/filtration_plant)
"aX" = (
/obj/structure/pipes/standard/simple/hidden/green{
	dir = 10
	},
/turf/open/floor,
/area/bigredv2/outside/filtration_plant)
"aY" = (
/turf/closed/wall/solaris/reinforced,
/area/bigredv2/outside/filtration_plant)
"aZ" = (
/obj/structure/machinery/computer/general_air_control,
/turf/open/floor,
/area/bigredv2/outside/filtration_plant)
"bb" = (
/obj/structure/surface/table,
/obj/effect/spawner/random/toolbox,
/obj/structure/machinery/light{
	dir = 1
	},
/turf/open/floor,
/area/bigredv2/outside/filtration_plant)
"bc" = (
/obj/effect/decal/cleanable/dirt,
/obj/structure/surface/rack,
/obj/effect/spawner/random/tool,
/turf/open/floor,
/area/bigredv2/outside/filtration_plant)
"bd" = (
/obj/structure/surface/table,
/obj/effect/spawner/random/tool,
/turf/open/floor,
/area/bigredv2/outside/filtration_plant)
"be" = (
/obj/structure/surface/table,
/obj/item/circuitboard/solar_tracker,
/turf/open/floor,
/area/bigredv2/outside/filtration_plant)
"bf" = (
/obj/structure/machinery/light{
	dir = 1
	},
/turf/open/floor,
/area/bigredv2/outside/filtration_plant)
"bg" = (
/obj/structure/machinery/computer3/server/rack,
/obj/effect/decal/warning_stripes{
	icon_state = "U-S";
	tag = "icon-U-S"
	},
/turf/open/floor,
/area/bigredv2/outside/filtration_plant)
"bh" = (
/obj/effect/decal/warning_stripes{
	icon_state = "U-S";
	tag = "icon-U-S"
	},
/obj/structure/machinery/computer3/server/rack,
/turf/open/floor,
/area/bigredv2/outside/filtration_plant)
"bi" = (
/obj/structure/machinery/light{
	dir = 1;
	tag = "icon-tube1 (NORTH)"
	},
/turf/open/floor,
/area/bigredv2/outside/filtration_plant)
"bj" = (
/obj/structure/surface/rack,
/obj/item/tank/air,
/obj/item/tool/pickaxe,
/turf/open/floor,
/area/bigredv2/outside/filtration_plant)
"bk" = (
/obj/structure/surface/rack,
/obj/effect/spawner/random/tool,
/obj/structure/machinery/light,
/turf/open/floor,
/area/bigredv2/outside/filtration_plant)
"bl" = (
/obj/structure/machinery/door/airlock/almayer/engineering/colony{
	dir = 1;
	name = "\improper Filtration Facility";
	},
/turf/open/floor,
/area/bigredv2/outside/filtration_plant)
"bm" = (
/obj/structure/machinery/door/airlock/almayer/engineering/colony{
	dir = 1;
	name = "\improper Filtration Facility";
	},
/obj/structure/pipes/standard/simple/hidden/green,
/turf/open/floor,
/area/bigredv2/outside/filtration_plant)
"bn" = (
/obj/structure/closet/firecloset/full,
/obj/structure/sign/safety/distribution_pipes{
	pixel_x = 32
	},
/turf/open/floor,
/area/bigredv2/outside/filtration_plant)
"bo" = (
/obj/item/tank/air,
/obj/effect/decal/cleanable/dirt,
/turf/open/floor,
/area/bigredv2/outside/filtration_plant)
"bp" = (
/obj/structure/pipes/vents/pump{
	dir = 4
	},
/turf/open/floor,
/area/bigredv2/outside/filtration_plant)
"bq" = (
/obj/effect/landmark/crap_item,
/obj/structure/pipes/standard/simple/hidden/green{
	dir = 4
	},
/turf/open/floor,
/area/bigredv2/outside/filtration_plant)
"br" = (
/obj/structure/machinery/door/airlock/almayer/engineering/colony{
	name = "\improper Filtration Facility";
	},
/obj/structure/pipes/standard/simple/hidden/green{
	dir = 4
	},
/turf/open/floor,
/area/bigredv2/outside/filtration_plant)
"bt" = (
/obj/effect/decal/cleanable/dirt,
/turf/closed/wall/solaris/reinforced/hull,
/area/bigredv2/outside/filtration_plant)
"bu" = (
/obj/structure/pipes/standard/simple/hidden/green{
	dir = 4
	},
/obj/item/frame/table,
/turf/open/floor,
/area/bigredv2/outside/filtration_plant)
"bv" = (
/obj/structure/machinery/portable_atmospherics/powered/scrubber/huge/chan,
/obj/effect/decal/warning_stripes,
/turf/open/floor/plating,
/area/bigredv2/outside/filtration_plant)
"bw" = (
/turf/closed/wall/solaris/reinforced/hull,
/area/bigredv2/outside/filtration_plant)
"by" = (
/obj/structure/pipes/standard/simple/hidden/green{
	dir = 9
	},
/obj/effect/decal/cleanable/dirt,
/turf/open/floor,
/area/bigredv2/outside/filtration_plant)
"bz" = (
/obj/effect/decal/cleanable/dirt,
/obj/structure/reagent_dispensers/fueltank,
/turf/open/floor{
	dir = 1;
	icon_state = "bot"
	},
/area/bigredv2/outside/filtration_plant)
"bA" = (
/obj/effect/decal/cleanable/dirt,
/obj/structure/window/framed/solaris,
/turf/open/floor/plating,
/area/bigredv2/outside/filtration_plant)
"bB" = (
/obj/structure/surface/table,
/obj/structure/machinery/computer/atmos_alert{
	dir = 4
	},
/turf/open/floor,
/area/bigredv2/outside/filtration_plant)
"bD" = (
/obj/structure/window/framed/solaris/reinforced/hull,
/turf/open/floor/plating,
/area/bigredv2/outside/filtration_plant)
"bE" = (
/obj/structure/cryofeed/right{
	name = "\improper coolant feed"
	},
/turf/open/floor/bluegrid{
	icon_state = "bcircuitoff";
	tag = "icon-bcircuitoff"
	},
/area/bigredv2/outside/filtration_plant)
"bF" = (
/obj/structure/cryofeed,
/turf/open/floor/bluegrid{
	icon_state = "bcircuitoff";
	tag = "icon-bcircuitoff"
	},
/area/bigredv2/outside/filtration_plant)
"bG" = (
/obj/structure/surface/table,
/turf/open/floor,
/area/bigredv2/outside/filtration_plant)
"bH" = (
/obj/structure/machinery/computer/area_atmos/area,
/turf/open/floor,
/area/bigredv2/outside/filtration_plant)
"bI" = (
/obj/structure/window_frame/solaris/reinforced,
/obj/item/shard{
	icon_state = "small";
	tag = "icon-small"
	},
/turf/open/floor/plating,
/area/bigredv2/outside/filtration_plant)
"bJ" = (
/obj/item/weapon/melee/twohanded/fireaxe,
/turf/open/floor,
/area/bigredv2/outside/filtration_plant)
"bK" = (
/turf/open/mars,
/area/bigredv2/outside/se)
"bN" = (
/obj/structure/surface/table,
/obj/effect/spawner/random/technology_scanner,
/turf/open/floor,
/area/bigredv2/outside/filtration_plant)
"bO" = (
/turf/open/mars_cave{
	icon_state = "mars_cave_2";
	tag = "icon-mars_cave_2"
	},
/area/bigredv2/outside/filtration_cave_cas)
"bP" = (
/obj/item/tank/air,
/turf/open/mars_cave{
	icon_state = "mars_cave_2";
	tag = "icon-mars_cave_2"
	},
/area/bigredv2/outside/filtration_cave_cas)
"bQ" = (
/obj/structure/surface/table,
/obj/effect/spawner/random/technology_scanner,
/obj/structure/machinery/light,
/turf/open/floor,
/area/bigredv2/outside/filtration_plant)
"bS" = (
/obj/item/frame/table,
/obj/structure/machinery/light,
/turf/open/floor,
/area/bigredv2/outside/filtration_plant)
"bT" = (
/obj/effect/decal/cleanable/dirt,
/obj/item/frame/table,
/obj/effect/decal/cleanable/dirt,
/turf/open/floor,
/area/bigredv2/outside/filtration_plant)
"bU" = (
/obj/effect/decal/cleanable/dirt,
/obj/structure/surface/table,
/turf/open/floor,
/area/bigredv2/outside/filtration_plant)
"bW" = (
/obj/structure/largecrate/random,
/turf/open/floor{
	dir = 1;
	icon_state = "bot"
	},
/area/bigredv2/outside/filtration_plant)
"bX" = (
/obj/structure/sign/safety/distribution_pipes{
	pixel_x = 32
	},
/turf/closed/wall/solaris/reinforced,
/area/bigredv2/outside/filtration_plant)
"bY" = (
/turf/open/floor{
	dir = 4;
	icon_state = "asteroidwarning";
	tag = "icon-asteroidwarning (EAST)"
	},
/area/bigredv2/outside/filtration_plant)
"bZ" = (
/turf/open/floor{
	dir = 1;
	icon_state = "asteroidfloor";
	tag = "icon-asteroidfloor (NORTH)"
	},
/area/bigredv2/outside/filtration_plant)
"cb" = (
/obj/structure/machinery/door_control{
	id = "FiltrationShutters";
	name = "Airlock Shutters";
	pixel_x = -32
	},
/obj/structure/machinery/light,
/turf/open/floor,
/area/bigredv2/outside/filtration_plant)
"cc" = (
/turf/closed/wall/solaris/rock,
/area/bigredv2/outside/filtration_plant)
"ce" = (
/obj/structure/machinery/light,
/turf/open/floor{
	dir = 1;
	icon_state = "asteroidfloor";
	tag = "icon-asteroidfloor (NORTH)"
	},
/area/bigredv2/outside/filtration_plant)
"cf" = (
/obj/structure/machinery/door/poddoor/shutters/almayer{
	id = "FiltrationShutters";
	name = "\improper Airlock Shutters"
	},
/turf/open/floor{
	icon_state = "delivery"
	},
/area/bigredv2/outside/filtration_plant)
"cg" = (
/obj/structure/machinery/door_control{
	id = "FiltrationShutters";
	name = "Airlock Shutters";
	pixel_y = 25
	},
/turf/open/floor,
/area/bigredv2/outside/filtration_plant)
"ch" = (
/obj/structure/dispenser/oxygen,
/turf/open/mars_cave{
	icon_state = "mars_cave_2";
	tag = "icon-mars_cave_2"
	},
/area/bigredv2/outside/filtration_cave_cas)
"ci" = (
/obj/item/tool/warning_cone,
/turf/open/mars_cave{
	icon_state = "mars_cave_2";
	tag = "icon-mars_cave_2"
	},
/area/bigredv2/outside/filtration_cave_cas)
"cj" = (
/obj/item/tool/pickaxe,
/turf/open/floor,
/area/bigredv2/outside/filtration_plant)
"ck" = (
/obj/effect/decal/warning_stripes{
	icon_state = "E-corner";
	tag = "icon-E-corner"
	},
/turf/open/mars_cave{
	icon_state = "mars_cave_2";
	tag = "icon-mars_cave_2"
	},
/area/bigredv2/outside/filtration_cave_cas)
"cl" = (
/turf/open/floor{
	dir = 1;
	icon_state = "asteroidfloor";
	tag = "icon-asteroidfloor (NORTH)"
	},
/area/bigredv2/outside/s)
"cm" = (
/turf/closed/wall/solaris,
/area/bigredv2/outside/s)
"cn" = (
/obj/effect/decal/cleanable/dirt,
/turf/open/floor{
	dir = 4;
	icon_state = "asteroidwarning";
	tag = "icon-asteroidwarning (EAST)"
	},
/area/bigredv2/outside/filtration_plant)
"jh" = (
/obj/structure/machinery/light,
/turf/open/floor,
/area/bigredv2/outside/filtration_plant)
"ka" = (
/obj/structure/closet/firecloset/full,
/turf/open/floor,
/area/bigredv2/outside/filtration_plant)
"nk" = (
/obj/structure/blocker/forcefield/multitile_vehicles,
/turf/closed/wall/solaris,
/area/bigredv2/outside/filtration_plant)
"np" = (
/obj/item/tank/air,
/turf/open/floor,
/area/bigredv2/outside/filtration_plant)
"tB" = (
/obj/effect/landmark/crap_item,
/turf/open/mars_cave{
	icon_state = "mars_cave_2";
	tag = "icon-mars_cave_2"
	},
/area/bigredv2/outside/filtration_cave_cas)
"zu" = (
/turf/open/mars_cave{
	icon_state = "mars_cave_7";
	tag = "icon-mars_cave_7"
	},
/area/bigredv2/outside/filtration_cave_cas)
"Ms" = (
/obj/structure/machinery/computer3/server/rack,
/obj/effect/decal/warning_stripes{
	icon_state = "U-N";
	tag = "icon-U-N"
	},
/turf/open/floor,
/area/bigredv2/outside/filtration_plant)
"Qx" = (
/obj/effect/decal/cleanable/dirt,
/obj/structure/blocker/forcefield/multitile_vehicles,
/turf/open/floor{
	dir = 4;
	icon_state = "asteroidwarning";
	tag = "icon-asteroidwarning (EAST)"
	},
/area/bigredv2/outside/filtration_plant)
"Rv" = (
/obj/structure/blocker/forcefield/multitile_vehicles,
/turf/open/floor{
	dir = 4;
	icon_state = "asteroidwarning";
	tag = "icon-asteroidwarning (EAST)"
	},
/area/bigredv2/outside/filtration_plant)
"TX" = (
/obj/structure/pipes/standard/simple/hidden/green{
	dir = 4
	},
/turf/open/floor,
/area/bigredv2/outside/filtration_plant)
"UH" = (
/obj/effect/decal/warning_stripes{
	icon_state = "E-corner";
	tag = "icon-E-corner"
	},
/turf/open/mars_cave{
	icon_state = "mars_cave_7";
	tag = "icon-mars_cave_7"
	},
/area/bigredv2/outside/filtration_cave_cas)
"US" = (
/turf/open/floor{
	dir = 8;
	icon_state = "asteroidwarning";
	tag = "icon-asteroidwarning (WEST)"
	},
/area/bigredv2/outside/filtration_plant)
"VW" = (
/obj/structure/cargo_container{
	icon_state = "red 0,0";
	tag = "icon-red 0,0"
	},
/turf/open/floor{
	dir = 1;
	icon_state = "bot"
	},
/area/bigredv2/outside/filtration_plant)
"WD" = (
/obj/structure/blocker/forcefield/multitile_vehicles,
/turf/open/mars_cave{
	icon_state = "mars_cave_2";
	tag = "icon-mars_cave_2"
	},
/area/bigredv2/outside/filtration_cave_cas)
"XC" = (
/obj/structure/cargo_container{
	icon_state = "red 2,0";
	tag = "icon-red 2,0"
	},
/turf/open/floor{
	dir = 1;
	icon_state = "bot"
	},
/area/bigredv2/outside/filtration_plant)
"Yg" = (
/obj/structure/cargo_container{
	icon_state = "red 1,0";
	tag = "icon-red 1,0"
	},
/turf/open/floor{
	dir = 1;
	icon_state = "bot"
	},
/area/bigredv2/outside/filtration_plant)

(1,1,1) = {"
aa
aA
aa
aa
aa
aa
aa
aa
aa
ah
ah
bI
bw
bw
bw
bw
bZ
cl
cl
cl
cl
cl
cl
cl
cm
"}
(2,1,1) = {"
ak
TX
ap
aa
aL
aS
aL
aL
aa
az
az
bJ
bw
cc
cc
bw
bZ
bZ
bZ
bZ
bZ
bZ
bZ
ce
bw
"}
(3,1,1) = {"
ak
TX
jh
aa
bf
az
az
az
bl
az
bp
az
bw
bw
bw
bw
bY
bY
bY
bY
cn
bY
bY
bY
aY
"}
(4,1,1) = {"
ak
TX
az
aa
aT
aM
aT
aS
aa
az
TX
az
bU
bB
bG
aY
cg
az
az
ad
az
ad
az
az
aY
"}
(5,1,1) = {"
aa
aA
aa
aa
aa
aa
aa
aa
aa
bi
bq
az
az
az
cb
aY
bf
ad
ad
ad
az
aS
aS
jh
aY
"}
(6,1,1) = {"
al
ac
aq
aa
az
bg
Ms
az
aa
az
TX
aS
aS
aS
az
cf
az
ad
ad
az
az
aS
VW
az
bw
"}
(7,1,1) = {"
ad
aC
ar
aB
az
az
az
az
bl
az
TX
aL
bW
aS
az
cf
az
az
az
az
az
aS
Yg
az
bw
"}
(8,1,1) = {"
an
ae
as
ah
az
bh
aV
ad
ah
ad
TX
aS
aS
bW
az
cf
az
az
az
az
az
aS
XC
az
bw
"}
(9,1,1) = {"
af
af
aH
aD
aN
aN
ar
az
ah
az
TX
aS
aS
aS
az
cf
az
az
az
az
np
bz
aS
jh
aY
"}
(10,1,1) = {"
ad
aE
at
aa
bf
az
ac
bk
aa
bi
TX
az
az
az
jh
aY
bf
az
az
cj
az
aS
aS
az
aY
"}
(11,1,1) = {"
bG
bH
au
aa
ka
aO
aW
bc
aa
aa
br
aa
bw
bD
bD
bw
az
az
az
az
az
az
az
az
aY
"}
(12,1,1) = {"
ah
ah
ah
aa
ka
az
TX
az
aa
az
TX
bN
bw
bE
bE
bw
US
US
US
US
US
US
US
US
aY
"}
(13,1,1) = {"
ai
aF
ai
aa
aZ
aP
aX
aN
bm
aN
aW
bN
bt
bF
bF
bw
bZ
bZ
bZ
bZ
bZ
bZ
bZ
ce
aY
"}
(14,1,1) = {"
ai
ai
ai
aa
bb
az
az
jh
ay
bf
TX
bQ
bw
bE
bE
bw
Rv
Rv
Rv
Rv
Qx
Rv
Rv
Rv
nk
"}
(15,1,1) = {"
ai
aF
ai
aa
bd
aR
aQ
be
aa
az
TX
bN
bw
bF
bF
bw
WD
bO
ci
bO
bO
ci
bO
bO
bO
"}
(16,1,1) = {"
aa
aa
aa
aa
aa
aa
ay
aa
aa
az
TX
az
bw
bD
bD
bw
WD
ch
bP
bO
bO
bO
bO
bO
bO
"}
(17,1,1) = {"
bK
bK
bK
bK
bK
aY
bi
bj
bj
az
TX
bS
aa
WD
WD
WD
WD
ci
bO
bO
bO
bO
bO
bO
bO
"}
(18,1,1) = {"
av
aw
aw
aw
aw
az
az
az
az
az
bu
ad
ad
WD
bO
bO
bO
bO
bO
bO
bO
bO
bO
bO
bO
"}
(19,1,1) = {"
ax
am
am
am
am
az
az
az
aP
aO
by
az
az
WD
bO
bO
bO
bO
bO
bO
bO
bO
bO
bO
bO
"}
(20,1,1) = {"
ax
am
am
aI
aI
az
az
az
ad
bo
az
bT
az
WD
bO
bO
bO
bO
bO
bO
tB
bO
bO
bO
bO
"}
(21,1,1) = {"
ax
am
aJ
aG
bK
aY
bi
ka
bn
az
az
jh
bX
WD
bO
bO
bO
ci
bO
bO
bO
bO
bO
bO
bO
"}
(22,1,1) = {"
am
am
aJ
bK
bK
aY
aY
aY
aY
ah
bA
ah
aY
WD
bO
bO
bO
bO
bO
bO
bO
zu
bO
bO
bO
"}
(23,1,1) = {"
am
am
aJ
aK
bK
bK
bK
bK
aY
bv
bv
bv
aY
aj
bO
bO
aj
aj
bO
bO
bO
zu
bO
bO
bO
"}
(24,1,1) = {"
am
am
aJ
aK
bK
bK
bK
bK
aY
aY
aY
aY
aY
aj
aj
aj
aj
aj
aj
ck
ck
UH
ck
ck
ck
"}
