//MAP CONVERTED BY dmm2tgm.py THIS HEADER COMMENT PREVENTS RECONVERSION, DO NOT REMOVE
"aa" = (
/turf/closed/wall/solaris/rock,
/area/bigredv2/caves)
"ai" = (
/turf/open/mars,
/area/bigredv2/outside/virology)
"aU" = (
/turf/open/mars,
/area/bigredv2/outside/nw)
"aV" = (
/obj/effect/decal/cleanable/blood,
/turf/open/mars,
/area/bigredv2/outside/nw)
"bc" = (
/turf/closed/wall/solaris/rock,
/area/bigredv2/outside)
"bd" = (
/turf/closed/wall/solaris/reinforced,
/area/bigredv2/outside/virology)
"br" = (
/obj/structure/inflatable/popped,
/turf/open/mars,
/area/bigredv2/outside/virology)
"bJ" = (
/obj/structure/pipes/standard/simple/hidden/green,
/obj/structure/machinery/door/airlock/almayer/research/colony{
	dir = 1;
	name = "\improper Virology Lab Decontamination"
	},
/turf/open/floor/warnwhite/north,
/area/bigredv2/outside/virology)
"bX" = (
/obj/structure/fence,
/turf/open/mars_cave/mars_cave_2,
/area/bigredv2/outside/virology)
"da" = (
/obj/structure/inflatable,
/turf/open/floor/asteroidwarning/northwest,
/area/bigredv2/outside/virology)
"df" = (
/obj/effect/landmark/crap_item,
/turf/open/asphalt/cement_sunbleached/cement_sunbleached12,
/area/bigredv2/outside/nw)
"dk" = (
/obj/effect/decal/cleanable/ash,
/turf/open/mars_cave/mars_dirt_5,
/area/bigredv2/outside/virology)
"gD" = (
/obj/structure/inflatable,
/turf/open/mars/mars_dirt_11,
/area/bigredv2/outside/virology)
"gH" = (
/turf/open/mars_cave/mars_dirt_4,
/area/bigredv2/outside/nw)
"ia" = (
/obj/structure/bed/chair/office/light{
	dir = 4
	},
/turf/open/asphalt/cement_sunbleached,
/area/bigredv2/outside/virology)
"jg" = (
/turf/open/mars_cave/mars_dirt_6,
/area/bigredv2/outside/virology)
"jQ" = (
/obj/structure/machinery/door/poddoor/almayer/open{
	dir = 4;
	id = "viro";
	name = "Virology Lockdown"
	},
/turf/open/asphalt/cement_sunbleached/cement_sunbleached12,
/area/bigredv2/outside/virology)
"kt" = (
/obj/structure/bed/roller,
/turf/open/mars/mars_dirt_10,
/area/bigredv2/outside/virology)
"lY" = (
/turf/open/mars/mars_dirt_12,
/area/bigredv2/outside/virology)
"mu" = (
/obj/structure/sign/safety/biohazard,
/turf/closed/wall/solaris/reinforced,
/area/bigredv2/outside/virology)
"nR" = (
/obj/structure/bed/roller,
/turf/open/asphalt/cement_sunbleached/cement_sunbleached4,
/area/bigredv2/outside/virology)
"oe" = (
/turf/open/asphalt/cement_sunbleached/cement_sunbleached4,
/area/bigredv2/outside/virology)
"ou" = (
/obj/structure/surface/table/almayer,
/obj/item/restraint/handcuffs,
/turf/open/asphalt/cement_sunbleached/cement_sunbleached15,
/area/bigredv2/outside/virology)
"oM" = (
/obj/effect/decal/cleanable/dirt,
/turf/open/asphalt/cement_sunbleached/cement_sunbleached12,
/area/bigredv2/outside/nw)
"oS" = (
/obj/effect/decal/cleanable/ash,
/turf/open/mars_cave/mars_cave_13,
/area/bigredv2/outside/virology)
"pG" = (
/obj/structure/machinery/light,
/turf/open/asphalt/cement_sunbleached/cement_sunbleached12,
/area/bigredv2/outside/virology)
"qc" = (
/obj/structure/inflatable/door,
/turf/open/asphalt/cement_sunbleached/cement_sunbleached3,
/area/bigredv2/outside/virology)
"qW" = (
/obj/structure/inflatable/door,
/turf/open/asphalt/cement_sunbleached,
/area/bigredv2/outside/virology)
"re" = (
/obj/item/weapon/gun/flamer/survivor,
/turf/open/mars_cave/mars_dirt_4,
/area/bigredv2/outside/virology)
"rh" = (
/obj/structure/surface/table/almayer,
/obj/item/ashtray/glass,
/obj/item/storage/syringe_case/regular{
	pixel_y = 10
	},
/turf/open/asphalt/cement_sunbleached/cement_sunbleached12,
/area/bigredv2/outside/virology)
"ru" = (
/obj/structure/machinery/light{
	dir = 4
	},
/obj/structure/inflatable,
/turf/open/asphalt/cement_sunbleached/cement_sunbleached1,
/area/bigredv2/outside/virology)
"rM" = (
/turf/open/asphalt/cement_sunbleached/cement_sunbleached4,
/area/bigredv2/outside/nw)
"rP" = (
/obj/structure/inflatable,
/turf/open/asphalt/cement_sunbleached/cement_sunbleached3,
/area/bigredv2/outside/virology)
"sm" = (
/obj/structure/inflatable/door,
/turf/open/asphalt/cement_sunbleached/cement_sunbleached14,
/area/bigredv2/outside/virology)
"uC" = (
/turf/open/asphalt/cement_sunbleached/cement_sunbleached2,
/area/bigredv2/outside/virology)
"uO" = (
/obj/structure/inflatable/popped/door,
/obj/effect/decal/cleanable/blood{
	icon_state = "gib6"
	},
/turf/open/asphalt/cement_sunbleached/cement_sunbleached3,
/area/bigredv2/outside/virology)
"vY" = (
/obj/effect/decal/cleanable/dirt,
/turf/open/asphalt/cement_sunbleached/cement_sunbleached14,
/area/bigredv2/outside/nw)
"xm" = (
/obj/effect/decal/cleanable/ash,
/turf/open/mars_cave/mars_dirt_6,
/area/bigredv2/outside/virology)
"xU" = (
/obj/structure/closet/bodybag{
	icon_state = "bodybag_open"
	},
/turf/open/mars_cave/mars_dirt_5,
/area/bigredv2/outside/virology)
"yk" = (
/obj/structure/pipes/standard/simple/hidden/green{
	dir = 4
	},
/turf/open/asphalt/cement_sunbleached,
/area/bigredv2/outside/virology)
"As" = (
/obj/structure/pipes/standard/simple/hidden/green,
/turf/open/asphalt/cement_sunbleached/cement_sunbleached3,
/area/bigredv2/outside/virology)
"AF" = (
/obj/structure/pipes/standard/simple/hidden/green,
/obj/effect/decal/cleanable/dirt,
/turf/open/asphalt/cement_sunbleached/cement_sunbleached14,
/area/bigredv2/outside/virology)
"Bq" = (
/obj/structure/inflatable/popped,
/turf/open/mars/mars_dirt_10,
/area/bigredv2/outside/virology)
"CQ" = (
/obj/structure/pipes/standard/simple/hidden/green{
	dir = 4
	},
/obj/structure/inflatable/door,
/turf/open/asphalt/cement_sunbleached,
/area/bigredv2/outside/nw)
"Dt" = (
/obj/structure/surface/table/almayer,
/obj/item/tool/surgery/scalpel,
/obj/item/device/autopsy_scanner,
/turf/open/mars_cave/mars_dirt_4,
/area/bigredv2/outside/virology)
"Ee" = (
/turf/open/asphalt/cement_sunbleached/cement_sunbleached1,
/area/bigredv2/outside/virology)
"Et" = (
/turf/open/asphalt/cement_sunbleached/cement_sunbleached12,
/area/bigredv2/outside/nw)
"ED" = (
/obj/structure/inflatable/popped,
/turf/open/asphalt/cement_sunbleached,
/area/bigredv2/outside/virology)
"EF" = (
/obj/structure/inflatable/door,
/turf/open/mars_cave/mars_dirt_4,
/area/bigredv2/outside/virology)
"Fb" = (
/turf/open/asphalt/cement_sunbleached/cement_sunbleached15,
/area/bigredv2/outside/virology)
"FA" = (
/obj/structure/surface/table/almayer,
/obj/structure/machinery/computer/med_data/laptop{
	dir = 8
	},
/turf/open/asphalt/cement_sunbleached/cement_sunbleached9,
/area/bigredv2/outside/virology)
"FX" = (
/obj/structure/closet/bodybag{
	icon_state = "bodybag_open"
	},
/turf/open/mars/mars_dirt_3,
/area/bigredv2/outside/virology)
"GA" = (
/turf/open/mars_cave/mars_dirt_4,
/area/bigredv2/outside/virology)
"GF" = (
/obj/effect/landmark/hunter_secondary,
/turf/open/asphalt/cement_sunbleached,
/area/bigredv2/outside/virology)
"GP" = (
/obj/structure/bed/roller,
/obj/effect/decal/cleanable/blood,
/turf/open/asphalt/cement_sunbleached/cement_sunbleached2,
/area/bigredv2/outside/virology)
"GX" = (
/turf/open/asphalt/cement_sunbleached,
/area/bigredv2/outside/virology)
"HZ" = (
/obj/structure/inflatable/popped,
/turf/open/asphalt/cement_sunbleached/cement_sunbleached4,
/area/bigredv2/outside/virology)
"Ie" = (
/obj/structure/inflatable,
/turf/open/mars_cave/mars_dirt_5,
/area/bigredv2/outside/virology)
"IZ" = (
/obj/effect/decal/cleanable/dirt,
/turf/open/asphalt/cement_sunbleached/cement_sunbleached12,
/area/bigredv2/outside/virology)
"KY" = (
/obj/structure/inflatable/door,
/turf/open/asphalt/cement_sunbleached,
/area/bigredv2/outside/nw)
"LF" = (
/obj/effect/decal/cleanable/dirt,
/obj/structure/inflatable,
/turf/open/floor/asteroidwarning/north,
/area/bigredv2/outside/virology)
"LZ" = (
/obj/structure/pipes/standard/simple/hidden/green{
	dir = 6
	},
/turf/open/asphalt/cement_sunbleached/cement_sunbleached3,
/area/bigredv2/outside/virology)
"MQ" = (
/obj/structure/fence,
/turf/open/mars_cave/mars_cave_7,
/area/bigredv2/outside/virology)
"Nt" = (
/obj/structure/fence,
/turf/open/mars_cave/mars_cave_13,
/area/bigredv2/outside/virology)
"OX" = (
/obj/structure/inflatable,
/turf/open/mars_cave/mars_dirt_4,
/area/bigredv2/outside/virology)
"Pb" = (
/obj/structure/inflatable,
/turf/open/asphalt/cement_sunbleached/cement_sunbleached1,
/area/bigredv2/outside/virology)
"PU" = (
/obj/structure/inflatable,
/turf/open/asphalt/cement_sunbleached/cement_sunbleached17,
/area/bigredv2/outside/nw)
"QV" = (
/turf/open/mars/mars_dirt_14,
/area/bigredv2/outside/virology)
"RE" = (
/obj/structure/inflatable,
/turf/open/asphalt/cement_sunbleached/cement_sunbleached20,
/area/bigredv2/outside/nw)
"RN" = (
/obj/effect/decal/cleanable/blood/gibs/xeno/body,
/obj/structure/pipes/standard/simple/hidden/green{
	dir = 4
	},
/obj/structure/machinery/door/poddoor/almayer/open{
	dir = 4;
	id = "viro";
	name = "Virology Lockdown"
	},
/turf/open/asphalt/cement_sunbleached,
/area/bigredv2/outside/virology)
"Sh" = (
/obj/structure/inflatable/popped/door,
/turf/open/asphalt/cement_sunbleached,
/area/bigredv2/outside/nw)
"TE" = (
/obj/structure/pipes/standard/simple/hidden/green{
	dir = 4
	},
/obj/structure/inflatable/popped/door,
/turf/open/asphalt/cement_sunbleached,
/area/bigredv2/outside/virology)
"UE" = (
/obj/structure/inflatable,
/turf/open/asphalt/cement_sunbleached,
/area/bigredv2/outside/virology)
"Vw" = (
/obj/structure/machinery/door/poddoor/almayer/open{
	dir = 4;
	id = "viro";
	name = "Virology Lockdown"
	},
/turf/open/asphalt/cement_sunbleached/cement_sunbleached4,
/area/bigredv2/outside/virology)
"Wm" = (
/turf/open/asphalt/cement_sunbleached/cement_sunbleached12,
/area/bigredv2/outside/virology)
"Xm" = (
/obj/structure/pipes/standard/simple/hidden/green{
	dir = 4
	},
/obj/structure/machinery/door/poddoor/almayer/open{
	dir = 4;
	id = "viro";
	name = "Virology Lockdown"
	},
/turf/open/asphalt/cement_sunbleached,
/area/bigredv2/outside/virology)
"XA" = (
/obj/effect/decal/cleanable/blood{
	dir = 4;
	icon_state = "gib6"
	},
/obj/structure/pipes/standard/simple/hidden/green{
	dir = 4
	},
/turf/open/asphalt/cement_sunbleached,
/area/bigredv2/outside/nw)
"XR" = (
/obj/structure/machinery/light{
	dir = 4
	},
/obj/structure/inflatable,
/turf/open/asphalt/cement_sunbleached/cement_sunbleached20,
/area/bigredv2/outside/virology)
"Yn" = (
/obj/effect/decal/cleanable/ash,
/turf/open/mars_cave/mars_cave_14,
/area/bigredv2/outside/virology)
"Yy" = (
/obj/structure/closet/bodybag{
	icon_state = "bodybag_open"
	},
/turf/open/mars/mars_dirt_12,
/area/bigredv2/outside/virology)
"ZB" = (
/turf/open/mars_cave/mars_dirt_5,
/area/bigredv2/outside/virology)
"ZY" = (
/obj/structure/closet/bodybag{
	icon_state = "bodybag_open"
	},
/turf/open/mars_cave/mars_dirt_4,
/area/bigredv2/outside/virology)

(1,1,1) = {"
aa
aa
bX
MQ
Nt
Nt
aa
aa
aa
aa
"}
(2,1,1) = {"
aa
aa
oS
Yn
jg
ZB
aa
aa
aa
aa
"}
(3,1,1) = {"
aa
aa
xm
dk
re
lY
lY
Dt
OX
bd
"}
(4,1,1) = {"
aa
Ie
xU
ZY
FX
ai
ai
kt
da
bd
"}
(5,1,1) = {"
aa
OX
Ie
EF
EF
gD
gD
OX
LF
bd
"}
(6,1,1) = {"
aa
ZY
ZY
uC
LZ
As
As
As
AF
bJ
"}
(7,1,1) = {"
bd
Yy
ZY
oe
yk
GX
GX
GX
Wm
mu
"}
(8,1,1) = {"
bd
br
Bq
oe
yk
GX
GF
GX
IZ
bd
"}
(9,1,1) = {"
bd
GP
uO
GX
yk
GX
GX
GX
pG
bd
"}
(10,1,1) = {"
bd
HZ
UE
GX
yk
GX
Ee
Ee
Fb
bd
"}
(11,1,1) = {"
bd
nR
qW
GX
yk
Wm
GA
GA
GA
bd
"}
(12,1,1) = {"
bd
HZ
ED
GX
yk
Wm
GA
lY
GA
bd
"}
(13,1,1) = {"
bd
nR
qW
GX
yk
Wm
GA
ai
QV
bd
"}
(14,1,1) = {"
bd
Pb
Pb
GX
yk
GX
rP
qc
sm
bd
"}
(15,1,1) = {"
bd
GA
GA
oe
yk
GX
UE
GX
Wm
bd
"}
(16,1,1) = {"
bd
GA
GA
oe
yk
GX
UE
GX
Wm
bd
"}
(17,1,1) = {"
bd
GA
XR
qW
TE
qW
ru
ia
rh
bd
"}
(18,1,1) = {"
bd
GA
bd
Vw
RN
jQ
bd
FA
ou
bd
"}
(19,1,1) = {"
bd
bd
bd
oe
yk
Wm
bd
bd
bd
bd
"}
(20,1,1) = {"
vY
gH
bd
Vw
Xm
jQ
bd
aU
bd
bc
"}
(21,1,1) = {"
oM
gH
RE
KY
CQ
Sh
PU
aU
bc
bc
"}
(22,1,1) = {"
df
gH
gH
rM
XA
Et
gH
aV
aU
bc
"}
