//MAP CONVERTED BY dmm2tgm.py THIS HEADER COMMENT PREVENTS RECONVERSION, DO NOT REMOVE
"aa" = (
/turf/closed/wall/solaris/rock,
/area/bigredv2/caves)
"ab" = (
/obj/structure/fence,
/turf/open/mars_cave/mars_cave_13,
/area/bigredv2/outside/virology)
"ac" = (
/obj/effect/decal/cleanable/dirt,
/turf/open/floor/asteroidwarning/southwest,
/area/bigredv2/outside/nw)
"ad" = (
/obj/effect/decal/cleanable/dirt,
/turf/open/floor/asteroidwarning,
/area/bigredv2/outside/nw)
"ae" = (
/obj/effect/landmark/crap_item,
/turf/open/floor/asteroidwarning,
/area/bigredv2/outside/nw)
"af" = (
/obj/effect/decal/cleanable/blood/gibs/xeno/body,
/obj/structure/pipes/standard/simple/hidden/green{
	dir = 4
	},
/obj/structure/machinery/door/poddoor/almayer/open{
	dir = 4;
	id = "viro";
	name = "Virology Lockdown"
	},
/turf/open/floor/asteroidfloor/north,
/area/bigredv2/outside/virology)
"ag" = (
/turf/open/mars_cave/mars_dirt_4,
/area/bigredv2/outside/virology)
"ah" = (
/turf/open/mars/mars_dirt_12,
/area/bigredv2/outside/virology)
"ai" = (
/turf/open/mars,
/area/bigredv2/outside/virology)
"ak" = (
/turf/open/mars_cave/mars_dirt_4,
/area/bigredv2/outside/nw)
"al" = (
/obj/structure/fence,
/turf/open/mars_cave/mars_cave_2,
/area/bigredv2/outside/virology)
"am" = (
/obj/effect/decal/cleanable/ash,
/turf/open/mars_cave/mars_cave_13,
/area/bigredv2/outside/virology)
"an" = (
/obj/effect/decal/cleanable/ash,
/turf/open/mars_cave/mars_dirt_6,
/area/bigredv2/outside/virology)
"ao" = (
/obj/structure/closet/bodybag{
	icon_state = "bodybag_open"
	},
/turf/open/mars/mars_dirt_12,
/area/bigredv2/outside/virology)
"aq" = (
/obj/structure/inflatable,
/turf/open/mars_cave/mars_dirt_5,
/area/bigredv2/outside/virology)
"ar" = (
/obj/structure/fence,
/turf/open/mars_cave/mars_cave_7,
/area/bigredv2/outside/virology)
"as" = (
/turf/open/floor/asteroidwarning/northwest,
/area/bigredv2/outside/virology)
"at" = (
/turf/open/floor/asteroidwarning/north,
/area/bigredv2/outside/virology)
"au" = (
/obj/structure/inflatable,
/turf/open/mars_cave/mars_dirt_4,
/area/bigredv2/outside/virology)
"av" = (
/turf/open/floor/asteroidfloor/north,
/area/bigredv2/outside/virology)
"aw" = (
/obj/structure/machinery/light{
	dir = 4
	},
/obj/structure/inflatable,
/turf/open/floor/asteroidwarning/northwest,
/area/bigredv2/outside/virology)
"ax" = (
/turf/open/floor/asteroidwarning/north,
/area/bigredv2/outside/nw)
"ay" = (
/obj/structure/closet/bodybag{
	icon_state = "bodybag_open"
	},
/turf/open/mars_cave/mars_dirt_5,
/area/bigredv2/outside/virology)
"az" = (
/obj/structure/pipes/standard/simple/hidden/green{
	dir = 6
	},
/turf/open/floor/asteroidwarning/west,
/area/bigredv2/outside/virology)
"aA" = (
/obj/structure/pipes/standard/simple/hidden/green{
	dir = 4
	},
/turf/open/floor/asteroidfloor/north,
/area/bigredv2/outside/virology)
"aE" = (
/obj/structure/inflatable,
/turf/open/floor/asteroidwarning/northeast,
/area/bigredv2/outside/nw)
"aF" = (
/obj/structure/inflatable/door,
/turf/open/mars_cave/mars_dirt_4,
/area/bigredv2/outside/virology)
"aG" = (
/obj/structure/inflatable/door,
/turf/open/floor/asteroidwarning/west,
/area/bigredv2/outside/virology)
"aH" = (
/obj/structure/machinery/light{
	dir = 4
	},
/obj/structure/inflatable,
/turf/open/floor/asteroidwarning/east,
/area/bigredv2/outside/virology)
"aI" = (
/obj/structure/inflatable/door,
/turf/open/floor/asteroidwarning/east,
/area/bigredv2/outside/nw)
"aJ" = (
/obj/structure/pipes/standard/simple/hidden/green,
/turf/open/floor/asteroidwarning/west,
/area/bigredv2/outside/virology)
"aK" = (
/turf/open/floor/asteroidwarning/east,
/area/bigredv2/outside/virology)
"aM" = (
/obj/structure/pipes/standard/simple/hidden/green{
	dir = 4
	},
/obj/structure/inflatable/popped/door,
/turf/open/floor/asteroidfloor/north,
/area/bigredv2/outside/virology)
"aN" = (
/obj/effect/decal/cleanable/ash,
/turf/open/mars_cave/mars_dirt_5,
/area/bigredv2/outside/virology)
"aO" = (
/obj/effect/landmark/hunter_secondary,
/turf/open/floor/asteroidfloor/north,
/area/bigredv2/outside/virology)
"aR" = (
/obj/structure/pipes/standard/simple/hidden/green{
	dir = 4
	},
/obj/structure/machinery/door/poddoor/almayer/open{
	dir = 4;
	id = "viro";
	name = "Virology Lockdown"
	},
/turf/open/floor/asteroidfloor/north,
/area/bigredv2/outside/virology)
"aU" = (
/turf/open/mars,
/area/bigredv2/outside/nw)
"aV" = (
/obj/effect/decal/cleanable/blood,
/turf/open/mars,
/area/bigredv2/outside/nw)
"aW" = (
/obj/structure/pipes/standard/simple/hidden/green{
	dir = 4
	},
/obj/structure/inflatable/door,
/turf/open/floor/asteroidfloor/north,
/area/bigredv2/outside/nw)
"aX" = (
/obj/structure/pipes/standard/simple/hidden/green,
/obj/effect/decal/cleanable/dirt,
/turf/open/floor/asteroidwarning/southwest,
/area/bigredv2/outside/virology)
"aY" = (
/obj/structure/sign/safety/biohazard,
/turf/open/floor/asteroidwarning,
/area/bigredv2/outside/virology)
"aZ" = (
/obj/effect/decal/cleanable/dirt,
/turf/open/floor/asteroidwarning,
/area/bigredv2/outside/virology)
"ba" = (
/obj/structure/machinery/light,
/turf/open/floor/asteroidwarning,
/area/bigredv2/outside/virology)
"bb" = (
/turf/open/mars/mars_dirt_14,
/area/bigredv2/outside/virology)
"bc" = (
/turf/closed/wall/solaris/rock,
/area/bigredv2/outside)
"bd" = (
/turf/closed/wall/solaris/reinforced,
/area/bigredv2/outside/virology)
"be" = (
/obj/structure/pipes/standard/simple/hidden/green,
/obj/structure/machinery/door/airlock/almayer/research/colony{
	dir = 1;
	name = "\improper Virology Lab Decontamination"
	},
/turf/open/floor/warnwhite/north,
/area/bigredv2/outside/virology)
"bf" = (
/obj/effect/decal/cleanable/blood{
	dir = 4;
	icon_state = "gib6"
	},
/obj/structure/pipes/standard/simple/hidden/green{
	dir = 4
	},
/turf/open/floor/asteroidfloor/north,
/area/bigredv2/outside/nw)
"bg" = (
/obj/structure/inflatable,
/turf/open/mars/mars_dirt_11,
/area/bigredv2/outside/virology)
"bj" = (
/obj/structure/inflatable,
/turf/open/floor/asteroidwarning/southeast,
/area/bigredv2/outside/nw)
"bk" = (
/obj/structure/inflatable/door,
/turf/open/floor/asteroidwarning/southwest,
/area/bigredv2/outside/virology)
"bl" = (
/obj/structure/inflatable,
/turf/open/floor/asteroidwarning/northwest,
/area/bigredv2/outside/virology)
"bm" = (
/obj/effect/decal/cleanable/dirt,
/obj/structure/inflatable,
/turf/open/floor/asteroidwarning/north,
/area/bigredv2/outside/virology)
"bn" = (
/obj/structure/inflatable,
/turf/open/floor/asteroidwarning/west,
/area/bigredv2/outside/virology)
"bo" = (
/obj/structure/closet/bodybag{
	icon_state = "bodybag_open"
	},
/turf/open/mars_cave/mars_dirt_4,
/area/bigredv2/outside/virology)
"bp" = (
/turf/open/mars_cave/mars_dirt_6,
/area/bigredv2/outside/virology)
"bq" = (
/obj/structure/closet/bodybag{
	icon_state = "bodybag_open"
	},
/turf/open/mars/mars_dirt_3,
/area/bigredv2/outside/virology)
"br" = (
/obj/structure/inflatable/popped,
/turf/open/mars,
/area/bigredv2/outside/virology)
"bs" = (
/obj/structure/surface/table/almayer,
/obj/item/tool/surgery/scalpel,
/obj/item/device/autopsy_scanner,
/turf/open/mars_cave/mars_dirt_4,
/area/bigredv2/outside/virology)
"bt" = (
/obj/structure/bed/roller,
/turf/open/mars/mars_dirt_10,
/area/bigredv2/outside/virology)
"bu" = (
/obj/structure/bed/roller,
/obj/effect/decal/cleanable/blood,
/turf/open/floor/asteroidwarning/northwest,
/area/bigredv2/outside/virology)
"bv" = (
/obj/structure/inflatable/popped,
/turf/open/floor/asteroidwarning/north,
/area/bigredv2/outside/virology)
"bw" = (
/obj/structure/bed/roller,
/turf/open/floor/asteroidwarning/north,
/area/bigredv2/outside/virology)
"bx" = (
/obj/structure/inflatable/popped,
/turf/open/mars/mars_dirt_10,
/area/bigredv2/outside/virology)
"by" = (
/obj/structure/inflatable/popped/door,
/obj/effect/decal/cleanable/blood{
	icon_state = "gib6"
	},
/turf/open/floor/asteroidwarning/west,
/area/bigredv2/outside/virology)
"bz" = (
/obj/structure/inflatable,
/turf/open/floor/asteroidfloor/north,
/area/bigredv2/outside/virology)
"bA" = (
/obj/structure/inflatable/door,
/turf/open/floor/asteroidfloor/north,
/area/bigredv2/outside/virology)
"bE" = (
/obj/structure/bed/chair/office/light{
	dir = 4
	},
/turf/open/floor/asteroidfloor/north,
/area/bigredv2/outside/virology)
"bF" = (
/obj/structure/surface/table/almayer,
/obj/structure/machinery/computer/med_data/laptop{
	dir = 8
	},
/turf/open/floor/asteroidwarning/northeast,
/area/bigredv2/outside/virology)
"bG" = (
/obj/structure/surface/table/almayer,
/obj/item/ashtray/glass,
/obj/item/storage/syringe_case/regular{
	pixel_y = 10
	},
/turf/open/floor/asteroidwarning,
/area/bigredv2/outside/virology)
"bH" = (
/obj/structure/surface/table/almayer,
/obj/item/restraint/handcuffs,
/turf/open/floor/asteroidwarning/southeast,
/area/bigredv2/outside/virology)
"lB" = (
/turf/open/floor/asteroidwarning/southeast,
/area/bigredv2/outside/virology)
"qP" = (
/obj/structure/inflatable/popped/door,
/turf/open/floor/asteroidwarning,
/area/bigredv2/outside/nw)
"rG" = (
/turf/open/floor/asteroidwarning,
/area/bigredv2/outside/nw)
"uN" = (
/turf/open/mars_cave/mars_dirt_5,
/area/bigredv2/outside/virology)
"zC" = (
/obj/structure/machinery/door/poddoor/almayer/open{
	dir = 4;
	id = "viro";
	name = "Virology Lockdown"
	},
/turf/open/floor/asteroidwarning/north,
/area/bigredv2/outside/virology)
"FK" = (
/obj/structure/inflatable,
/turf/open/floor/asteroidwarning/east,
/area/bigredv2/outside/virology)
"GE" = (
/turf/open/floor/asteroidwarning,
/area/bigredv2/outside/virology)
"Kk" = (
/obj/structure/machinery/door/poddoor/almayer/open{
	dir = 4;
	id = "viro";
	name = "Virology Lockdown"
	},
/turf/open/floor/asteroidwarning,
/area/bigredv2/outside/virology)
"Kv" = (
/obj/item/weapon/gun/flamer,
/turf/open/mars_cave/mars_dirt_4,
/area/bigredv2/outside/virology)
"Po" = (
/obj/structure/inflatable,
/turf/open/floor/asteroidwarning/northeast,
/area/bigredv2/outside/virology)
"Ry" = (
/obj/effect/decal/cleanable/ash,
/turf/open/mars_cave/mars_cave_14,
/area/bigredv2/outside/virology)
"Vr" = (
/obj/structure/inflatable/popped,
/turf/open/floor/asteroidfloor/north,
/area/bigredv2/outside/virology)

(1,1,1) = {"
aa
aa
al
ar
ab
ab
aa
aa
aa
aa
"}
(2,1,1) = {"
aa
aa
am
Ry
bp
uN
aa
aa
aa
aa
"}
(3,1,1) = {"
aa
aa
an
aN
Kv
ah
ah
bs
au
bd
"}
(4,1,1) = {"
aa
aq
ay
bo
bq
ai
ai
bt
bl
bd
"}
(5,1,1) = {"
aa
au
aq
aF
aF
bg
bg
au
bm
bd
"}
(6,1,1) = {"
aa
bo
bo
as
az
aJ
aJ
aJ
aX
be
"}
(7,1,1) = {"
bd
ao
bo
at
aA
av
av
av
aY
bd
"}
(8,1,1) = {"
bd
br
bx
at
aA
av
aO
av
aZ
bd
"}
(9,1,1) = {"
bd
bu
by
av
aA
av
av
av
ba
bd
"}
(10,1,1) = {"
bd
bv
bz
av
aA
av
aK
aK
lB
bd
"}
(11,1,1) = {"
bd
bw
bA
av
aA
GE
ag
ag
ag
bd
"}
(12,1,1) = {"
bd
bv
Vr
av
aA
GE
ag
ah
ag
bd
"}
(13,1,1) = {"
bd
bw
bA
av
aA
GE
ag
ai
bb
bd
"}
(14,1,1) = {"
bd
Po
FK
av
aA
av
bn
aG
bk
bd
"}
(15,1,1) = {"
bd
ag
ag
at
aA
av
bz
av
GE
bd
"}
(16,1,1) = {"
bd
ag
ag
at
aA
av
bz
av
GE
bd
"}
(17,1,1) = {"
bd
ag
aw
bA
aM
bA
aH
bE
bG
bd
"}
(18,1,1) = {"
bd
ag
bd
zC
af
Kk
bd
bF
bH
bd
"}
(19,1,1) = {"
bd
bd
bd
at
aA
GE
bd
bd
bd
bd
"}
(20,1,1) = {"
ac
ak
bd
zC
aR
Kk
bd
aU
bd
bc
"}
(21,1,1) = {"
ad
ak
aE
aI
aW
qP
bj
aU
bc
bc
"}
(22,1,1) = {"
ae
ak
ak
ax
bf
rG
ak
aV
aU
bc
"}
