//MAP CONVERTED BY dmm2tgm.py THIS HEADER COMMENT PREVENTS RECONVERSION, DO NOT REMOVE
"ax" = (
/obj/structure/machinery/power/apc{
	dir = 1;
	pixel_y = 28;
	start_charge = 0
	},
/turf/open/floor,
/area/bigred/ground/security)
"aN" = (
/obj/structure/surface/table/almayer,
/obj/structure/machinery/computer/secure_data{
	dir = 8
	},
/turf/open/floor,
/area/bigred/ground/security)
"bp" = (
/obj/structure/machinery/door/airlock/almayer/security/glass/colony{
	icon_state = "door_locked";
	locked = 0;
	name = "\improper Checkpoint Office"
	},
/turf/open/floor,
/area/bigred/ground/security)
"bx" = (
/obj/structure/surface/table/almayer,
/obj/item/device/motiondetector,
/turf/open/floor,
/area/bigred/ground/security)
"cO" = (
/obj/effect/decal/cleanable/dirt,
/turf/open/floor{
	dir = 1;
	icon_state = "asteroidwarning"
	},
/area/bigredv2/outside/filtration_cave_cas)
"dz" = (
/obj/effect/decal/cleanable/dirt,
/obj/structure/blocker/forcefield/multitile_vehicles,
/turf/open/floor{
	dir = 6;
	icon_state = "asteroidwarning"
	},
/area/bigredv2/outside/filtration_cave_cas)
"el" = (
/obj/structure/surface/table/almayer,
/obj/item/restraint/handcuffs,
/turf/open/floor,
/area/bigred/ground/security)
"ge" = (
/obj/structure/closet/secure_closet/marshal,
/turf/open/floor/greengrid,
/area/bigred/ground/security)
"hz" = (
/obj/structure/machinery/door/airlock/almayer/security/glass/colony{
	dir = 1;
	name = "\improper Checkpoint Office"
	},
/obj/structure/blocker/forcefield/multitile_vehicles,
/turf/open/floor{
	icon_state = "delivery"
	},
/area/bigred/ground/security)
"ie" = (
/obj/structure/blocker/forcefield/multitile_vehicles,
/turf/open/mars_cave{
	icon_state = "mars_cave_2"
	},
/area/bigredv2/outside/filtration_cave_cas)
"kd" = (
/obj/structure/surface/table/almayer,
/obj/structure/transmitter/colony_net/rotary{
	phone_category = "Solaris Ridge";
	phone_color = "red";
	phone_id = "Filtration Checkpoint"
	},
/turf/open/floor/greengrid,
/area/bigred/ground/security)
"kG" = (
/obj/effect/decal/cleanable/dirt,
/turf/open/floor{
	dir = 6;
	icon_state = "asteroidwarning"
	},
/area/bigredv2/outside/filtration_cave_cas)
"kL" = (
/obj/structure/machinery/light{
	dir = 1
	},
/obj/effect/decal/cleanable/dirt,
/turf/open/floor{
	dir = 9;
	icon_state = "asteroidwarning"
	},
/area/bigredv2/outside/filtration_cave_cas)
"kX" = (
/turf/closed/wall/solaris/reinforced,
/area/bigred/ground/security)
"mp" = (
/obj/effect/decal/cleanable/dirt,
/turf/open/floor{
	dir = 9;
	icon_state = "asteroidwarning"
	},
/area/bigredv2/outside/filtration_cave_cas)
"oT" = (
/turf/closed/wall/solaris/reinforced,
/area/bigredv2/outside/filtration_cave_cas)
"pb" = (
/obj/item/tool/warning_cone,
/turf/open/floor{
	dir = 1;
	icon_state = "asteroidwarning"
	},
/area/bigredv2/outside/filtration_cave_cas)
"pJ" = (
/obj/item/tool/warning_cone,
/turf/open/floor{
	dir = 5;
	icon_state = "asteroidwarning"
	},
/area/bigredv2/outside/se)
"pV" = (
/obj/structure/surface/table/almayer,
/obj/effect/spawner/random/tool,
/turf/open/floor,
/area/bigred/ground/security)
"qg" = (
/obj/effect/decal/cleanable/dirt,
/turf/open/floor{
	icon_state = "asteroidwarning"
	},
/area/bigredv2/outside/filtration_cave_cas)
"qy" = (
/obj/item/device/radio,
/obj/structure/surface/table/almayer,
/turf/open/floor,
/area/bigred/ground/security)
"rD" = (
/obj/structure/machinery/camera/autoname{
	dir = 8
	},
/turf/open/floor,
/area/bigred/ground/security)
"rF" = (
/obj/structure/machinery/deployable/barrier,
/turf/open/floor/greengrid,
/area/bigred/ground/security)
"tV" = (
/obj/structure/machinery/door/poddoor/almayer/closed{
	dir = 4;
	id = "filtration";
	name = "Filtration Lockdown"
	},
/turf/open/floor{
	icon_state = "delivery"
	},
/area/bigredv2/outside/filtration_cave_cas)
"uk" = (
/obj/effect/decal/cleanable/dirt,
/turf/open/floor,
/area/bigred/ground/security)
"uF" = (
/obj/structure/surface/table/almayer,
/obj/effect/spawner/random/technology_scanner,
/turf/open/floor/greengrid,
/area/bigred/ground/security)
"ve" = (
/obj/structure/machinery/door/airlock/almayer/security/glass/colony{
	dir = 1;
	name = "\improper Checkpoint Office"
	},
/turf/open/floor{
	icon_state = "delivery"
	},
/area/bigred/ground/security)
"vH" = (
/obj/effect/decal/cleanable/blood,
/turf/open/floor,
/area/bigred/ground/security)
"vO" = (
/obj/structure/surface/rack,
/obj/item/stack/sheet/metal/small_stack,
/turf/open/floor,
/area/bigred/ground/security)
"wi" = (
/obj/effect/decal/cleanable/dirt,
/turf/open/floor{
	dir = 4;
	icon_state = "asteroidwarning"
	},
/area/bigredv2/outside/filtration_cave_cas)
"xa" = (
/turf/open/floor/greengrid,
/area/bigred/ground/security)
"xj" = (
/obj/structure/bed/chair/office/light{
	dir = 4
	},
/turf/open/floor,
/area/bigred/ground/security)
"xr" = (
/obj/structure/surface/rack,
/obj/item/clothing/mask/gas,
/obj/item/device/flashlight,
/obj/structure/machinery/light{
	dir = 4
	},
/turf/open/floor,
/area/bigred/ground/security)
"zE" = (
/obj/effect/decal/cleanable/dirt,
/turf/open/floor{
	dir = 8;
	icon_state = "asteroidwarning"
	},
/area/bigredv2/outside/filtration_cave_cas)
"Aq" = (
/obj/effect/decal/cleanable/dirt,
/turf/open/floor{
	dir = 1;
	icon_state = "asteroidfloor"
	},
/area/bigredv2/outside/filtration_cave_cas)
"AY" = (
/turf/open/floor,
/area/bigred/ground/security)
"AZ" = (
/turf/open/floor{
	dir = 1;
	icon_state = "asteroidwarning"
	},
/area/bigredv2/outside/filtration_cave_cas)
"EV" = (
/obj/effect/decal/cleanable/dirt,
/turf/open/floor{
	dir = 4;
	icon_state = "asteroidwarning"
	},
/area/bigredv2/outside/se)
"Ge" = (
/obj/effect/landmark/crap_item,
/turf/open/floor{
	dir = 5;
	icon_state = "asteroidwarning"
	},
/area/bigredv2/outside/filtration_cave_cas)
"Gm" = (
/obj/structure/machinery/light{
	dir = 1
	},
/turf/open/floor{
	dir = 1;
	icon_state = "asteroidwarning"
	},
/area/bigredv2/outside/filtration_cave_cas)
"GJ" = (
/obj/effect/decal/cleanable/dirt,
/obj/structure/blocker/forcefield/multitile_vehicles,
/turf/open/floor{
	dir = 4;
	icon_state = "asteroidwarning"
	},
/area/bigredv2/outside/filtration_cave_cas)
"HH" = (
/turf/open/floor{
	icon_state = "asteroidwarning"
	},
/area/bigredv2/outside/filtration_cave_cas)
"Ih" = (
/turf/open/floor{
	dir = 1;
	icon_state = "asteroidfloor"
	},
/area/bigredv2/outside/filtration_cave_cas)
"IS" = (
/obj/structure/filingcabinet,
/turf/open/floor/greengrid,
/area/bigred/ground/security)
"KO" = (
/obj/item/trash/sosjerky,
/obj/effect/decal/cleanable/dirt,
/turf/open/floor,
/area/bigred/ground/security)
"LX" = (
/obj/structure/machinery/light{
	dir = 8
	},
/obj/effect/decal/cleanable/dirt,
/turf/open/floor,
/area/bigred/ground/security)
"Mq" = (
/obj/structure/surface/table/almayer,
/turf/open/floor/greengrid,
/area/bigred/ground/security)
"NQ" = (
/obj/structure/largecrate,
/turf/open/floor/greengrid,
/area/bigred/ground/security)
"NU" = (
/obj/structure/machinery/light{
	dir = 8
	},
/obj/structure/machinery/vending/security,
/turf/open/floor,
/area/bigred/ground/security)
"OD" = (
/turf/open/floor{
	dir = 4;
	icon_state = "asteroidwarning"
	},
/area/bigredv2/outside/se)
"OM" = (
/obj/effect/decal/cleanable/dirt,
/turf/open/floor{
	dir = 10;
	icon_state = "asteroidwarning"
	},
/area/bigredv2/outside/filtration_cave_cas)
"Pf" = (
/obj/effect/decal/cleanable/blood,
/obj/effect/spawner/gibspawner/human,
/turf/open/floor,
/area/bigred/ground/security)
"PS" = (
/turf/open/mars,
/area/bigredv2/outside/se)
"Qf" = (
/obj/effect/decal/cleanable/dirt,
/obj/structure/machinery/door/poddoor/almayer/closed{
	dir = 4;
	id = "filtration";
	name = "Filtration Lockdown"
	},
/turf/open/floor{
	icon_state = "delivery"
	},
/area/bigredv2/outside/filtration_cave_cas)
"Qo" = (
/obj/structure/blocker/forcefield/multitile_vehicles,
/turf/closed/wall/solaris/reinforced,
/area/bigred/ground/security)
"Sr" = (
/obj/structure/machinery/camera/autoname{
	dir = 8
	},
/obj/structure/surface/rack,
/obj/effect/spawner/random/toolbox,
/turf/open/floor,
/area/bigred/ground/security)
"SF" = (
/obj/structure/window/framed/solaris/reinforced,
/turf/open/floor/plating,
/area/bigred/ground/security)
"Ue" = (
/obj/structure/machinery/camera/autoname,
/turf/open/floor{
	dir = 1;
	icon_state = "asteroidwarning"
	},
/area/bigredv2/outside/filtration_cave_cas)
"Vg" = (
/turf/open/floor{
	dir = 8;
	icon_state = "asteroidwarning"
	},
/area/bigredv2/outside/filtration_cave_cas)
"Vn" = (
/obj/structure/surface/table/almayer,
/obj/item/ashtray/bronze,
/obj/item/trash/cigbutt/cigarbutt,
/turf/open/floor/greengrid,
/area/bigred/ground/security)
"VI" = (
/obj/structure/largecrate,
/turf/open/floor,
/area/bigred/ground/security)
"Wa" = (
/turf/open/floor{
	dir = 6;
	icon_state = "asteroidwarning"
	},
/area/bigredv2/outside/se)
"XU" = (
/turf/open/floor{
	dir = 10;
	icon_state = "asteroidwarning"
	},
/area/bigredv2/outside/filtration_cave_cas)
"Yo" = (
/obj/structure/surface/rack,
/obj/item/storage/firstaid,
/turf/open/floor,
/area/bigred/ground/security)
"YZ" = (
/obj/structure/surface/table/almayer,
/obj/structure/machinery/computer/cameras/wooden_tv{
	dir = 8
	},
/turf/open/floor/greengrid,
/area/bigred/ground/security)
"Zu" = (
/obj/effect/landmark/hunter_primary,
/obj/structure/blocker/forcefield/multitile_vehicles,
/turf/open/floor{
	dir = 5;
	icon_state = "asteroidwarning"
	},
/area/bigredv2/outside/filtration_cave_cas)
"ZK" = (
/obj/effect/landmark/crap_item,
/obj/structure/machinery/light{
	dir = 4
	},
/turf/open/floor,
/area/bigred/ground/security)

(1,1,1) = {"
PS
pJ
EV
OD
Wa
kX
kX
kX
kX
kX
kX
kX
kX
Qo
"}
(2,1,1) = {"
oT
tV
tV
tV
tV
kX
IS
LX
qy
bx
el
NU
rF
Qo
"}
(3,1,1) = {"
oT
kL
Vg
zE
OM
SF
kd
AY
KO
uk
uk
AY
rF
Qo
"}
(4,1,1) = {"
oT
Ge
wi
wi
kG
SF
Vn
xj
uk
AY
uk
uk
AY
hz
"}
(5,1,1) = {"
oT
tV
tV
Qf
Qf
kX
YZ
aN
rD
AY
uk
AY
ge
Qo
"}
(6,1,1) = {"
oT
mp
Vg
Vg
XU
kX
kX
kX
kX
bp
kX
kX
kX
Qo
"}
(7,1,1) = {"
oT
Ue
Ih
Aq
qg
kX
VI
VI
AY
uk
AY
pV
Mq
Qo
"}
(8,1,1) = {"
oT
AZ
Ih
Aq
qg
kX
ax
AY
uk
uk
AY
AY
uF
Qo
"}
(9,1,1) = {"
oT
cO
Aq
Ih
HH
ve
uk
uk
AY
AY
uk
AY
xa
Qo
"}
(10,1,1) = {"
oT
Gm
Ih
Ih
HH
kX
AY
Pf
vH
AY
uk
uk
xa
Qo
"}
(11,1,1) = {"
oT
pb
Ih
Aq
qg
kX
vH
ZK
Sr
Yo
vO
xr
NQ
Qo
"}
(12,1,1) = {"
ie
Zu
GJ
GJ
dz
Qo
Qo
Qo
Qo
Qo
Qo
Qo
Qo
Qo
"}
