//MAP CONVERTED BY dmm2tgm.py THIS HEADER COMMENT PREVENTS RECONVERSION, DO NOT REMOVE
"a" = (
/obj/structure/barricade/wooden{
	dir = 8
	},
/obj/item/weapon/twohanded/spear,
/turf/open/floor/prison/southwest,
/area/desert_dam/interior/dam_interior/atmos_storage)
"b" = (
/obj/structure/machinery/portable_atmospherics/powered/scrubber,
/turf/open/floor/prison/southwest,
/area/desert_dam/interior/dam_interior/atmos_storage)
"d" = (
/obj/structure/machinery/cm_vending/sorted/tech/tool_storage,
/turf/open/floor/prison/green/north,
/area/desert_dam/interior/dam_interior/atmos_storage)
"g" = (
/obj/structure/surface/rack,
/obj/item/clothing/mask/gas,
/turf/open/floor/prison/green/southwest,
/area/desert_dam/interior/dam_interior/atmos_storage)
"i" = (
/obj/structure/machinery/power/port_gen/pacman,
/turf/open/floor/prison/green,
/area/desert_dam/interior/dam_interior/atmos_storage)
"k" = (
/obj/structure/machinery/portable_atmospherics/powered/pump,
/turf/open/floor/prison/green,
/area/desert_dam/interior/dam_interior/atmos_storage)
"l" = (
/turf/open/floor/prison/southwest,
/area/desert_dam/interior/dam_interior/atmos_storage)
"n" = (
/obj/structure/surface/rack,
/obj/item/clothing/mask/gas,
/turf/open/floor/prison/green,
/area/desert_dam/interior/dam_interior/atmos_storage)
"o" = (
/obj/effect/landmark/corpsespawner/engineer,
/obj/effect/decal/cleanable/blood,
/turf/open/floor/prison/southwest,
/area/desert_dam/interior/dam_interior/atmos_storage)
"r" = (
/obj/structure/machinery/power/apc/no_power/north,
/turf/open/floor/prison/green/north,
/area/desert_dam/interior/dam_interior/atmos_storage)
"t" = (
/obj/structure/machinery/floodlight,
/obj/structure/machinery/camera/autoname/almayer,
/turf/open/floor/prison/green/north,
/area/desert_dam/interior/dam_interior/atmos_storage)
"u" = (
/obj/item/stack/sheet/metal/large_stack,
/turf/open/floor/prison/southwest,
/area/desert_dam/interior/dam_interior/atmos_storage)
"w" = (
/obj/structure/machinery/floodlight,
/turf/open/floor/prison/green/northeast,
/area/desert_dam/interior/dam_interior/atmos_storage)
"x" = (
/turf/closed/wall/r_wall/bunker{
	name = "reinforced metal wall"
	},
/area/desert_dam/interior/dam_interior/engine_east_wing)
"y" = (
/obj/structure/machinery/cm_vending/sorted/tech/comp_storage,
/turf/open/floor/prison/green/north,
/area/desert_dam/interior/dam_interior/atmos_storage)
"A" = (
/obj/structure/machinery/door/airlock/almayer/maint/colony{
	name = "\improper Atmospheric Storage"
	},
/turf/open/floor/prison/bright_clean/southwest,
/area/desert_dam/interior/dam_interior/atmos_storage)
"B" = (
/obj/effect/landmark/objective_landmark/medium,
/turf/open/floor/prison/southwest,
/area/desert_dam/interior/dam_interior/atmos_storage)
"D" = (
/obj/structure/surface/rack,
/obj/item/fuel_cell,
/obj/item/fuel_cell,
/obj/item/fuel_cell,
/obj/item/fuel_cell,
/obj/item/fuel_cell,
/obj/item/fuel_cell,
/obj/item/fuel_cell,
/obj/item/fuel_cell,
/turf/open/floor/prison/green,
/area/desert_dam/interior/dam_interior/atmos_storage)
"E" = (
/obj/structure/machinery/floodlight,
/turf/open/floor/prison/green/north,
/area/desert_dam/interior/dam_interior/atmos_storage)
"F" = (
/obj/structure/machinery/cm_vending/sorted/tech/electronics_storage,
/turf/open/floor/prison/green/north,
/area/desert_dam/interior/dam_interior/atmos_storage)
"H" = (
/obj/structure/machinery/portable_atmospherics/canister/air,
/turf/open/floor/prison/green/east,
/area/desert_dam/interior/dam_interior/atmos_storage)
"L" = (
/turf/open/floor/prison/greencorner/west,
/area/desert_dam/interior/dam_interior/atmos_storage)
"M" = (
/obj/structure/machinery/power/port_gen/pacman,
/turf/open/floor/prison/green/southeast,
/area/desert_dam/interior/dam_interior/atmos_storage)
"N" = (
/obj/item/stack/sheet/plasteel/medium_stack,
/turf/open/floor/prison/southwest,
/area/desert_dam/interior/dam_interior/atmos_storage)
"O" = (
/turf/closed/wall/r_wall/bunker{
	name = "reinforced metal wall"
	},
/area/desert_dam/interior/dam_interior/atmos_storage)
"P" = (
/obj/effect/decal/cleanable/blood{
	dir = 8;
	icon_state = "gib6";
	layer = 4;
	pixel_y = 3
	},
/turf/open/floor/prison/southwest,
/area/desert_dam/interior/dam_interior/atmos_storage)
"V" = (
/obj/structure/machinery/portable_atmospherics/canister/air,
/obj/structure/machinery/light{
	dir = 4
	},
/turf/open/floor/prison/green/east,
/area/desert_dam/interior/dam_interior/atmos_storage)
"X" = (
/obj/structure/closet/crate,
/obj/item/stack/sheet/mineral/phoron{
	amount = 25
	},
/obj/item/storage/briefcase/inflatable,
/obj/effect/landmark/objective_landmark/far,
/turf/open/floor/prison/green/east,
/area/desert_dam/interior/dam_interior/atmos_storage)
"Y" = (
/obj/structure/closet/crate,
/obj/item/stack/sheet/mineral/phoron{
	amount = 25
	},
/obj/item/storage/briefcase/inflatable,
/turf/open/floor/prison/southwest,
/area/desert_dam/interior/dam_interior/atmos_storage)

(1,1,1) = {"
x
O
A
A
O
O
O
"}
(2,1,1) = {"
x
F
a
P
L
g
O
"}
(3,1,1) = {"
x
d
l
o
l
n
O
"}
(4,1,1) = {"
x
y
u
l
l
n
O
"}
(5,1,1) = {"
x
r
l
N
l
D
O
"}
(6,1,1) = {"
x
E
l
b
b
k
O
"}
(7,1,1) = {"
x
t
l
B
Y
i
O
"}
(8,1,1) = {"
x
w
H
V
X
M
O
"}
(9,1,1) = {"
x
O
O
O
O
O
O
"}
