//MAP CONVERTED BY dmm2tgm.py THIS HEADER COMMENT PREVENTS RECONVERSION, DO NOT REMOVE
"aa" = (
/obj/item/shard,
/turf/open/floor/whitepurplecorner,
/area/lv624/lazarus/fitness)
"ab" = (
/obj/effect/landmark/objective_landmark/close,
/turf/open/floor/whitepurplecorner,
/area/lv624/lazarus/fitness)
"ac" = (
/obj/effect/decal/cleanable/blood/splatter,
/obj/structure/machinery/door/airlock/multi_tile/almayer/generic{
	dir = 1;
	name = "\improper Leisure Dome";
	req_access_txt = "100"
	},
/turf/open/floor/whitepurple/northeast,
/area/lv624/lazarus/fitness)
"ad" = (
/obj/effect/decal/remains/human,
/obj/structure/machinery/power/apc/no_power/south,
/turf/open/floor/whitepurplecorner,
/area/lv624/lazarus/fitness)
"ae" = (
/obj/item/device/radio/intercom{
	freerange = 1;
	frequency = 1469;
	name = "General Listening Channel";
	pixel_y = -30
	},
/turf/open/floor/whitepurplecorner,
/area/lv624/lazarus/fitness)
"af" = (
/obj/structure/closet/crate/secure/hydrosec,
/obj/effect/landmark/objective_landmark/medium,
/turf/open/floor/whitepurplecorner,
/area/lv624/lazarus/fitness)
"ag" = (
/obj/structure/surface/rack,
/obj/effect/decal/cleanable/dirt,
/obj/item/clothing/under/swimsuit/black,
/obj/item/clothing/under/swimsuit/blue{
	pixel_x = 7
	},
/obj/item/clothing/under/swimsuit/red{
	pixel_x = -7
	},
/turf/open/floor/whitepurplecorner,
/area/lv624/lazarus/fitness)
"ah" = (
/obj/structure/closet/athletic_mixed,
/obj/structure/machinery/light{
	dir = 4
	},
/obj/effect/landmark/objective_landmark/close,
/turf/open/floor/whitepurplecorner,
/area/lv624/lazarus/fitness)
"bA" = (
/turf/template_noop,
/area/template_noop)
"bQ" = (
/turf/open/floor/barber/west,
/area/lv624/lazarus/fitness)
"dw" = (
/obj/structure/machinery/vending/snack,
/turf/open/floor/whitepurplecorner,
/area/lv624/lazarus/fitness)
"gL" = (
/obj/structure/machinery/door/airlock/almayer/medical/glass/colony{
	dir = 1;
	name = "\improper Leisure Dome";
	req_access_txt = "100";
	req_one_access = null
	},
/turf/open/floor/whitepurple/northeast,
/area/lv624/lazarus/fitness)
"hX" = (
/obj/structure/filingcabinet/medical,
/obj/effect/landmark/objective_landmark/science,
/turf/open/floor,
/area/lv624/lazarus/fitness)
"iv" = (
/obj/item/toy/inflatable_duck,
/turf/open/gm/river,
/area/lv624/lazarus/fitness)
"kE" = (
/obj/item/clothing/under/shorts/red,
/obj/structure/surface/rack,
/obj/item/clothing/under/shorts/green{
	pixel_x = 1;
	pixel_y = 7
	},
/obj/item/clothing/under/shorts/grey{
	pixel_x = -1;
	pixel_y = -8
	},
/obj/effect/landmark/objective_landmark/close,
/turf/open/floor/whitepurplecorner,
/area/lv624/lazarus/fitness)
"li" = (
/obj/effect/decal/cleanable/blood/splatter,
/turf/open/floor/whitepurplecorner,
/area/lv624/lazarus/fitness)
"ls" = (
/obj/item/tool/soap,
/turf/open/floor/barber/west,
/area/lv624/lazarus/fitness)
"rI" = (
/obj/structure/surface/rack,
/obj/effect/landmark/item_pool_spawner/survivor_ammo/buckshot,
/obj/item/storage/firstaid/regular,
/turf/open/floor/whitepurplecorner,
/area/lv624/lazarus/fitness)
"sA" = (
/turf/closed/wall,
/area/lv624/lazarus/fitness)
"tV" = (
/turf/open/floor/whitepurple/northeast,
/area/lv624/lazarus/fitness)
"vq" = (
/turf/open/floor/whitepurplecorner,
/area/lv624/lazarus/fitness)
"yO" = (
/obj/item/toy/beach_ball,
/turf/open/gm/river,
/area/lv624/lazarus/fitness)
"yP" = (
/obj/effect/landmark/good_item,
/turf/open/floor/whitepurplecorner,
/area/lv624/lazarus/fitness)
"yV" = (
/obj/structure/surface/rack,
/obj/effect/landmark/item_pool_spawner/survivor_ammo/buckshot,
/turf/open/floor/whitepurplecorner,
/area/lv624/lazarus/fitness)
"zq" = (
/obj/effect/landmark/objective_landmark/close,
/turf/open/floor/barber/west,
/area/lv624/lazarus/fitness)
"Ei" = (
/obj/structure/machinery/light{
	dir = 8
	},
/turf/open/floor/whitepurplecorner,
/area/lv624/lazarus/fitness)
"Er" = (
/obj/effect/landmark/good_item,
/turf/open/floor/barber/west,
/area/lv624/lazarus/fitness)
"Ez" = (
/turf/open/floor,
/area/lv624/lazarus/fitness)
"EG" = (
/turf/open/gm/river,
/area/lv624/lazarus/fitness)
"Fx" = (
/obj/structure/window_frame/colony,
/obj/item/shard,
/turf/open/floor/plating,
/area/lv624/lazarus/fitness)
"FO" = (
/obj/structure/prop/static_tank/water,
/turf/open/floor/whitepurplecorner,
/area/lv624/lazarus/fitness)
"Ga" = (
/obj/structure/surface/rack,
/obj/effect/landmark/item_pool_spawner/survivor_ammo/buckshot,
/obj/effect/landmark/objective_landmark/medium,
/turf/open/floor/whitepurplecorner,
/area/lv624/lazarus/fitness)
"Iu" = (
/obj/structure/closet/athletic_mixed,
/obj/structure/machinery/light{
	dir = 8
	},
/obj/effect/landmark/objective_landmark/close,
/turf/open/floor/whitepurplecorner,
/area/lv624/lazarus/fitness)
"Ot" = (
/obj/structure/window_frame/colony,
/turf/open/floor/plating,
/area/lv624/lazarus/fitness)
"Ou" = (
/obj/effect/landmark/survivor_spawner,
/turf/open/gm/river,
/area/lv624/lazarus/fitness)
"Px" = (
/obj/structure/sign/safety/water{
	pixel_x = 7;
	pixel_y = 26
	},
/obj/structure/surface/table,
/obj/item/storage/box/cups,
/turf/open/floor/whitepurplecorner,
/area/lv624/lazarus/fitness)
"Rf" = (
/obj/structure/machinery/light{
	dir = 4
	},
/turf/open/floor/whitepurplecorner,
/area/lv624/lazarus/fitness)
"Rl" = (
/obj/structure/machinery/vending/cola,
/turf/open/floor/whitepurplecorner,
/area/lv624/lazarus/fitness)
"SW" = (
/obj/item/clothing/under/shorts/red,
/obj/structure/surface/rack,
/obj/item/clothing/mask/snorkel,
/obj/item/clothing/mask/snorkel,
/obj/item/clothing/mask/snorkel,
/turf/open/floor/whitepurplecorner,
/area/lv624/lazarus/fitness)
"Us" = (
/obj/structure/machinery/atm{
	name = "Weyland-Yutani Automatic Teller Machine";
	pixel_x = -30
	},
/obj/structure/machinery/light{
	dir = 8
	},
/turf/open/floor/whitepurplecorner,
/area/lv624/lazarus/fitness)
"UM" = (
/obj/structure/machinery/light{
	dir = 4
	},
/obj/structure/machinery/cm_vending/sorted/medical/wall_med/limited{
	pixel_x = 29
	},
/turf/open/floor/whitepurplecorner,
/area/lv624/lazarus/fitness)
"Vo" = (
/obj/structure/window/framed/colony,
/turf/open/floor/plating,
/area/lv624/lazarus/fitness)
"VM" = (
/obj/structure/reagent_dispensers/water_cooler/stacks,
/turf/open/floor/whitepurplecorner,
/area/lv624/lazarus/fitness)
"Zo" = (
/obj/effect/landmark/good_item,
/turf/open/gm/river,
/area/lv624/lazarus/fitness)

(1,1,1) = {"
bA
bA
bA
bA
bA
bA
Vo
hX
Ez
Vo
bA
bA
bA
bA
bA
"}
(2,1,1) = {"
bA
bA
bA
bA
bA
sA
sA
tV
ac
sA
bA
bA
bA
bA
bA
"}
(3,1,1) = {"
bA
sA
Ot
Vo
Vo
sA
vq
li
ad
sA
Vo
Ot
Vo
sA
bA
"}
(4,1,1) = {"
bA
Fx
Ga
vq
af
Ei
vq
vq
vq
Ei
vq
aa
FO
Vo
bA
"}
(5,1,1) = {"
bA
Vo
rI
vq
bQ
bQ
bQ
ls
zq
bQ
bQ
vq
VM
Vo
bA
"}
(6,1,1) = {"
bA
sA
yV
vq
bQ
EG
Zo
EG
EG
EG
bQ
vq
Px
sA
bA
"}
(7,1,1) = {"
sA
sA
vq
vq
bQ
EG
EG
EG
yO
EG
bQ
vq
vq
sA
sA
"}
(8,1,1) = {"
Vo
Iu
vq
vq
bQ
EG
EG
Ou
EG
EG
Er
vq
vq
Us
Vo
"}
(9,1,1) = {"
gL
vq
vq
vq
bQ
EG
EG
EG
EG
EG
bQ
vq
vq
vq
gL
"}
(10,1,1) = {"
Vo
ah
vq
vq
bQ
EG
EG
iv
EG
EG
bQ
vq
vq
Rf
Ot
"}
(11,1,1) = {"
sA
sA
vq
vq
bQ
EG
EG
EG
EG
EG
bQ
vq
vq
sA
sA
"}
(12,1,1) = {"
bA
sA
ag
vq
bQ
EG
EG
EG
Ou
EG
bQ
vq
vq
sA
bA
"}
(13,1,1) = {"
bA
Vo
SW
yP
bQ
bQ
bQ
bQ
bQ
bQ
bQ
yP
Rl
Fx
bA
"}
(14,1,1) = {"
bA
Vo
kE
vq
vq
UM
vq
vq
vq
Rf
ab
vq
dw
Vo
bA
"}
(15,1,1) = {"
bA
sA
Vo
Vo
Vo
sA
vq
vq
ae
sA
Vo
Vo
Ot
sA
bA
"}
