//MAP CONVERTED BY dmm2tgm.py THIS HEADER COMMENT PREVENTS RECONVERSION, DO NOT REMOVE
"aa" = (
/obj/structure/barricade/handrail{
	dir = 1
	},
/turf/open/floor,
/area/lv624/lazarus/fitness)
"ab" = (
/obj/structure/barricade/handrail{
	dir = 1
	},
/obj/effect/decal/cleanable/dirt,
/turf/open/floor,
/area/lv624/lazarus/fitness)
"ac" = (
/obj/structure/barricade/handrail{
	dir = 4
	},
/obj/structure/barricade/handrail{
	dir = 1
	},
/obj/effect/decal/cleanable/dirt,
/turf/open/floor,
/area/lv624/lazarus/fitness)
"ad" = (
/obj/effect/decal/cleanable/blood/splatter,
/obj/structure/machinery/door/airlock/multi_tile/almayer/generic{
	dir = 1;
	name = "\improper Leisure Dome";
	req_access_txt = "100"
	},
/turf/open/floor/whitepurple/northeast,
/area/lv624/lazarus/fitness)
"ae" = (
/obj/structure/machinery/power/apc/no_power/south,
/turf/open/floor/whitepurplecorner/east,
/area/lv624/lazarus/fitness)
"af" = (
/obj/item/device/radio/intercom{
	freerange = 1;
	frequency = 1469;
	name = "General Listening Channel";
	pixel_y = -30
	},
/obj/effect/decal/cleanable/dirt,
/turf/open/floor/whitepurplecorner/east,
/area/lv624/lazarus/fitness)
"ag" = (
/obj/structure/bed/chair{
	dir = 1
	},
/turf/open/floor/whitepurplecorner/east,
/area/lv624/lazarus/fitness)
"ah" = (
/obj/structure/bed/chair{
	dir = 1
	},
/obj/effect/landmark/objective_landmark/close,
/turf/open/floor/whitepurplecorner/east,
/area/lv624/lazarus/fitness)
"ar" = (
/obj/structure/machinery/conveyor{
	dir = 8;
	id = "lv_gym_2";
	name = "treadmill"
	},
/obj/effect/landmark/item_pool_spawner/survivor_ammo/buckshot,
/turf/open/floor/whitepurplecorner/east,
/area/lv624/lazarus/fitness)
"aG" = (
/obj/structure/window_frame/colony,
/turf/open/floor/plating,
/area/lv624/lazarus/fitness)
"cD" = (
/obj/structure/surface/rack,
/obj/item/tool/mop,
/obj/item/clothing/under/shorts/black{
	pixel_x = 2;
	pixel_y = 2
	},
/obj/effect/landmark/item_pool_spawner/survivor_ammo/buckshot,
/turf/open/floor/whitepurplecorner/east,
/area/lv624/lazarus/fitness)
"ds" = (
/obj/structure/machinery/conveyor_switch{
	id = "lv_gym_1";
	name = "treadmill switch";
	pixel_x = 8;
	pixel_y = 7
	},
/obj/structure/machinery/conveyor_switch{
	id = "lv_gym_2";
	name = "treadmill switch";
	pixel_x = -8;
	pixel_y = -4
	},
/turf/open/floor/whitepurplecorner/east,
/area/lv624/lazarus/fitness)
"ej" = (
/obj/structure/closet/crate/secure/hydrosec,
/obj/effect/landmark/objective_landmark/close,
/turf/open/floor/whitepurplecorner/east,
/area/lv624/lazarus/fitness)
"ek" = (
/obj/structure/surface/table/almayer,
/obj/item/reagent_container/food/drinks/cans/waterbottle{
	pixel_x = -5
	},
/obj/effect/spawner/random/toy,
/turf/open/floor/whitepurplecorner/east,
/area/lv624/lazarus/fitness)
"ez" = (
/obj/structure/surface/rack,
/obj/item/clothing/shoes/black,
/obj/item/clothing/shoes/orange{
	name = "running shoes";
	pixel_x = -5;
	pixel_y = -9
	},
/turf/open/floor/whitepurplecorner/east,
/area/lv624/lazarus/fitness)
"eD" = (
/obj/effect/decal/cleanable/blood/splatter,
/obj/effect/landmark/corpsespawner/colonist/random/burst,
/obj/structure/machinery/light,
/turf/open/floor/whitepurplecorner/east,
/area/lv624/lazarus/fitness)
"fr" = (
/turf/open/floor/warnwhite,
/area/lv624/lazarus/fitness)
"fv" = (
/obj/effect/landmark/survivor_spawner,
/turf/open/floor,
/area/lv624/lazarus/fitness)
"fV" = (
/turf/closed/wall,
/area/lv624/lazarus/fitness)
"hd" = (
/turf/open/floor/whitepurplecorner/east,
/area/lv624/lazarus/fitness)
"hm" = (
/obj/structure/machinery/conveyor{
	dir = 8;
	id = "lv_gym_1";
	name = "treadmill"
	},
/obj/item/reagent_container/food/drinks/cans/waterbottle{
	pixel_x = 8;
	pixel_y = 7
	},
/turf/open/floor/whitepurplecorner/east,
/area/lv624/lazarus/fitness)
"hn" = (
/obj/effect/decal/cleanable/blood/splatter,
/turf/open/floor/whitepurplecorner/east,
/area/lv624/lazarus/fitness)
"il" = (
/obj/item/clothing/under/shorts/red,
/obj/structure/surface/rack,
/obj/item/clothing/under/shorts/green{
	pixel_x = 1;
	pixel_y = 7
	},
/obj/item/clothing/under/shorts/grey{
	pixel_x = -1;
	pixel_y = -8
	},
/obj/effect/landmark/objective_landmark/close,
/turf/open/floor/whitepurplecorner/east,
/area/lv624/lazarus/fitness)
"iM" = (
/obj/item/toy/beach_ball/holoball,
/obj/effect/decal/warning_stripes,
/obj/effect/decal/cleanable/dirt,
/turf/open/floor/white,
/area/lv624/lazarus/fitness)
"jA" = (
/obj/structure/window_frame/colony,
/obj/item/shard{
	pixel_x = 9;
	pixel_y = -6
	},
/turf/open/floor/plating,
/area/lv624/lazarus/fitness)
"kk" = (
/obj/effect/landmark/crap_item,
/obj/effect/decal/cleanable/dirt,
/turf/open/floor/whitepurplecorner/east,
/area/lv624/lazarus/fitness)
"kv" = (
/obj/effect/decal/remains/human,
/turf/open/floor/whitepurplecorner/east,
/area/lv624/lazarus/fitness)
"nl" = (
/turf/template_noop,
/area/template_noop)
"ok" = (
/obj/structure/machinery/light{
	dir = 1
	},
/turf/open/floor/whitepurplecorner/east,
/area/lv624/lazarus/fitness)
"pV" = (
/obj/effect/decal/cleanable/dirt,
/obj/structure/machinery/light,
/turf/open/floor/whitepurplecorner/east,
/area/lv624/lazarus/fitness)
"rw" = (
/turf/open/floor/warnwhite/north,
/area/lv624/lazarus/fitness)
"sd" = (
/obj/structure/machinery/door/airlock/almayer/medical/glass/colony{
	dir = 1;
	name = "\improper Leisure Dome";
	req_access_txt = "100";
	req_one_access = null
	},
/turf/open/floor/whitepurple/northeast,
/area/lv624/lazarus/fitness)
"sx" = (
/obj/structure/window/framed/colony,
/turf/open/floor/plating,
/area/lv624/lazarus/fitness)
"tD" = (
/turf/open/floor/white,
/area/lv624/lazarus/fitness)
"uF" = (
/obj/structure/machinery/light{
	dir = 1
	},
/turf/open/floor/warnwhite/north,
/area/lv624/lazarus/fitness)
"ve" = (
/obj/structure/machinery/conveyor{
	dir = 8;
	id = "lv_gym_2";
	name = "treadmill"
	},
/turf/open/floor/whitepurplecorner/east,
/area/lv624/lazarus/fitness)
"xe" = (
/obj/structure/closet/boxinggloves,
/obj/effect/landmark/item_pool_spawner/survivor_ammo/buckshot,
/obj/effect/landmark/objective_landmark/medium,
/turf/open/floor/whitepurplecorner/east,
/area/lv624/lazarus/fitness)
"xT" = (
/obj/structure/surface/rack,
/obj/item/clothing/under/shorts/blue,
/obj/item/clothing/suit/redtag{
	pixel_x = 2;
	pixel_y = -5
	},
/obj/effect/decal/cleanable/dirt,
/turf/open/floor/whitepurplecorner/east,
/area/lv624/lazarus/fitness)
"Ah" = (
/obj/structure/closet/athletic_mixed,
/obj/effect/landmark/objective_landmark/medium,
/turf/open/floor/whitepurplecorner/east,
/area/lv624/lazarus/fitness)
"AE" = (
/turf/open/floor/warnwhite/northwest,
/area/lv624/lazarus/fitness)
"Bm" = (
/obj/structure/machinery/vending/cola,
/turf/open/floor/whitepurplecorner/east,
/area/lv624/lazarus/fitness)
"BE" = (
/obj/structure/window_frame/colony,
/obj/item/shard{
	pixel_x = -11;
	pixel_y = 13
	},
/turf/open/floor/plating,
/area/lv624/lazarus/fitness)
"BW" = (
/obj/structure/surface/rack,
/obj/effect/landmark/item_pool_spawner/survivor_ammo/buckshot,
/obj/structure/machinery/light{
	dir = 1
	},
/turf/open/floor/whitepurplecorner/east,
/area/lv624/lazarus/fitness)
"DH" = (
/obj/structure/closet/lasertag/blue,
/obj/item/tool/crowbar,
/turf/open/floor/whitepurplecorner/east,
/area/lv624/lazarus/fitness)
"EQ" = (
/obj/structure/holohoop{
	dir = 4
	},
/obj/effect/landmark/objective_landmark/close,
/turf/open/floor/warnwhite/west,
/area/lv624/lazarus/fitness)
"FD" = (
/turf/open/floor/warnwhite/southeast,
/area/lv624/lazarus/fitness)
"Ge" = (
/obj/structure/barricade/handrail{
	dir = 4
	},
/turf/open/floor,
/area/lv624/lazarus/fitness)
"Hn" = (
/obj/item/clothing/suit/redtag,
/turf/open/floor/whitepurplecorner/east,
/area/lv624/lazarus/fitness)
"HF" = (
/obj/structure/surface/rack,
/obj/item/storage/firstaid/o2,
/turf/open/floor/whitepurplecorner/east,
/area/lv624/lazarus/fitness)
"Ia" = (
/obj/structure/machinery/vending/snack,
/turf/open/floor/whitepurplecorner/east,
/area/lv624/lazarus/fitness)
"In" = (
/turf/open/floor,
/area/lv624/lazarus/fitness)
"It" = (
/obj/structure/holohoop{
	dir = 8
	},
/turf/open/floor/warnwhite/east,
/area/lv624/lazarus/fitness)
"Ix" = (
/turf/open/floor/warnwhite/southwest,
/area/lv624/lazarus/fitness)
"IL" = (
/obj/effect/decal/cleanable/dirt,
/turf/open/floor/whitepurple/northeast,
/area/lv624/lazarus/fitness)
"Js" = (
/obj/effect/decal/cleanable/dirt,
/obj/effect/decal/cleanable/dirt,
/turf/open/floor/whitepurplecorner/east,
/area/lv624/lazarus/fitness)
"JF" = (
/obj/structure/surface/rack,
/obj/item/weapon/baseballbat,
/obj/item/weapon/baseballbat{
	pixel_x = -6;
	pixel_y = 2
	},
/turf/open/floor/whitepurplecorner/east,
/area/lv624/lazarus/fitness)
"JN" = (
/obj/structure/filingcabinet/medical,
/obj/effect/landmark/objective_landmark/science,
/turf/open/floor,
/area/lv624/lazarus/fitness)
"Kc" = (
/obj/effect/landmark/crap_item,
/turf/open/floor/whitepurplecorner/east,
/area/lv624/lazarus/fitness)
"Mn" = (
/obj/structure/barricade/handrail{
	dir = 4
	},
/obj/structure/machinery/light,
/turf/open/floor,
/area/lv624/lazarus/fitness)
"Op" = (
/obj/effect/landmark/survivor_spawner,
/obj/effect/decal/cleanable/dirt,
/turf/open/floor/whitepurplecorner/east,
/area/lv624/lazarus/fitness)
"PC" = (
/obj/item/tool/soap,
/turf/open/floor/whitepurplecorner/east,
/area/lv624/lazarus/fitness)
"Qf" = (
/obj/structure/machinery/atm{
	name = "Weyland-Yutani Automatic Teller Machine";
	pixel_x = -30
	},
/obj/effect/decal/cleanable/dirt,
/turf/open/floor/whitepurplecorner/east,
/area/lv624/lazarus/fitness)
"Sj" = (
/obj/effect/decal/cleanable/blood/oil/streak,
/turf/open/floor/whitepurplecorner/east,
/area/lv624/lazarus/fitness)
"Ss" = (
/obj/effect/spawner/gibspawner/robot,
/obj/effect/decal/cleanable/blood/oil,
/turf/open/floor/whitepurple/northeast,
/area/lv624/lazarus/fitness)
"To" = (
/turf/open/floor/warnwhite/northeast,
/area/lv624/lazarus/fitness)
"Tq" = (
/obj/structure/surface/rack,
/obj/effect/landmark/item_pool_spawner/survivor_ammo/buckshot,
/turf/open/floor/whitepurplecorner/east,
/area/lv624/lazarus/fitness)
"Tv" = (
/obj/effect/decal/cleanable/dirt,
/turf/open/floor/whitepurplecorner/east,
/area/lv624/lazarus/fitness)
"TS" = (
/obj/effect/decal/cleanable/blood/splatter,
/obj/effect/decal/cleanable/dirt,
/obj/effect/decal/cleanable/dirt,
/turf/open/floor/whitepurplecorner/east,
/area/lv624/lazarus/fitness)
"Ur" = (
/obj/effect/landmark/crap_item,
/obj/effect/decal/cleanable/dirt,
/turf/open/floor/white,
/area/lv624/lazarus/fitness)
"Vk" = (
/obj/structure/closet/lasertag/red,
/obj/effect/landmark/objective_landmark/close,
/turf/open/floor/whitepurplecorner/east,
/area/lv624/lazarus/fitness)
"Vs" = (
/obj/structure/machinery/conveyor{
	dir = 8;
	id = "lv_gym_1";
	name = "treadmill"
	},
/turf/open/floor/whitepurplecorner/east,
/area/lv624/lazarus/fitness)
"Wx" = (
/obj/structure/window_frame/colony,
/obj/item/shard,
/turf/open/floor/plating,
/area/lv624/lazarus/fitness)
"Xu" = (
/obj/structure/reagent_dispensers/tank/water,
/turf/open/floor/whitepurplecorner/east,
/area/lv624/lazarus/fitness)

(1,1,1) = {"
nl
nl
nl
nl
nl
nl
sx
JN
In
sx
nl
nl
nl
nl
nl
"}
(2,1,1) = {"
nl
nl
nl
nl
nl
fV
fV
IL
ad
fV
nl
nl
nl
nl
nl
"}
(3,1,1) = {"
nl
fV
sx
sx
aG
fV
Qf
hd
ae
fV
sx
sx
sx
fV
nl
"}
(4,1,1) = {"
nl
sx
AE
EQ
Ix
ag
Js
Kc
hd
Tv
aa
In
In
jA
nl
"}
(5,1,1) = {"
nl
BE
rw
tD
fr
ag
hd
hd
kv
hd
ab
fv
In
sx
nl
"}
(6,1,1) = {"
nl
fV
uF
iM
fr
hd
hd
TS
hd
PC
ac
Ge
Mn
fV
nl
"}
(7,1,1) = {"
fV
fV
rw
Ur
fr
ag
Tv
hd
hd
hd
Tv
kk
xe
fV
fV
"}
(8,1,1) = {"
sx
Ah
To
It
FD
ah
hd
Ia
hd
Tv
hd
hd
hd
hd
sx
"}
(9,1,1) = {"
Ss
Sj
hd
hd
hd
hd
pV
fV
ok
hd
hd
hd
hd
hd
sd
"}
(10,1,1) = {"
Wx
Xu
hd
hd
Tv
hd
hd
Bm
hd
Hn
hd
Tv
hd
hd
sx
"}
(11,1,1) = {"
fV
fV
hd
hd
Tv
Tv
Tv
hd
hd
hd
il
hd
ez
fV
fV
"}
(12,1,1) = {"
nl
fV
BW
JF
xT
DH
kk
hd
hd
hd
Kc
hn
eD
fV
nl
"}
(13,1,1) = {"
nl
sx
ej
Tv
Op
hd
Tv
hd
hd
hd
ve
ek
hm
aG
nl
"}
(14,1,1) = {"
nl
sx
HF
cD
Tq
Vk
hd
hd
hd
hd
ar
ds
Vs
sx
nl
"}
(15,1,1) = {"
nl
fV
sx
sx
sx
fV
hd
hd
af
fV
sx
sx
Wx
fV
nl
"}
