//MAP CONVERTED BY dmm2tgm.py THIS HEADER COMMENT PREVENTS RECONVERSION, DO NOT REMOVE
"a" = (
/turf/open/floor/tdome/redfull,
/area/template_noop)
"c" = (
/turf/open/floor/tdome/bluefull,
/area/template_noop)
"d" = (
/obj/effect/landmark/thunderdome/two,
/obj/effect/decal/warning_stripes{
	icon_state = "E"
	},
/turf/open/floor/tdome/northeast,
/area/template_noop)
"f" = (
/obj/effect/landmark/thunderdome/one,
/turf/open/floor/tdome/northeast,
/area/template_noop)
"h" = (
/obj/effect/landmark/thunderdome/two,
/turf/open/floor/tdome/northeast,
/area/template_noop)
"l" = (
/turf/open/floor/tdome/w_y1/north,
/area/template_noop)
"m" = (
/turf/closed/wall/almayer/outer,
/area/template_noop)
"o" = (
/turf/open/floor/tdome/w_y0/north,
/area/template_noop)
"p" = (
/turf/open/floor/tdome/northeast,
/area/template_noop)
"s" = (
/obj/effect/decal/warning_stripes{
	icon_state = "W"
	},
/turf/open/floor/tdome/northeast,
/area/template_noop)
"z" = (
/obj/effect/decal/warning_stripes{
	icon_state = "E"
	},
/turf/open/floor/tdome/northeast,
/area/template_noop)
"D" = (
/turf/open/floor/tdome/tcomms,
/area/template_noop)
"K" = (
/turf/open/floor/tdome/w_y2/north,
/area/template_noop)
"N" = (
/turf/template_noop,
/area/template_noop)
"O" = (
/obj/structure/machinery/door/poddoor/almayer/locked{
	dir = 4;
	id = "tdome_t2";
	name = "\improper Team 2 Shutters";
	explo_proof = 1
	},
/turf/open/floor/tdome/test_floor4,
/area/template_noop)
"P" = (
/obj/effect/step_trigger/teleporter/random{
	affect_ghosts = 1;
	name = "escapeshuttle_leave";
	teleport_x = 25;
	teleport_x_offset = 245;
	teleport_y = 25;
	teleport_y_offset = 245;
	teleport_z = 1;
	teleport_z_offset = 1
	},
/turf/template_noop,
/area/template_noop)
"T" = (
/obj/effect/landmark/thunderdome/one,
/obj/effect/decal/warning_stripes{
	icon_state = "W"
	},
/turf/open/floor/tdome/northeast,
/area/template_noop)
"W" = (
/obj/structure/machinery/door/poddoor/almayer/locked{
	dir = 4;
	id = "tdome_t1";
	name = "\improper Team 1 Shutters";
	explo_proof = 1
	},
/turf/open/floor/tdome/test_floor4,
/area/template_noop)

(1,1,1) = {"
N
P
P
P
P
P
P
P
P
P
P
P
N
N
N
"}
(2,1,1) = {"
P
P
N
N
N
N
N
N
N
N
N
P
P
N
N
"}
(3,1,1) = {"
P
N
N
m
m
m
m
m
m
m
N
N
P
N
N
"}
(4,1,1) = {"
P
N
m
m
a
a
a
a
a
m
m
N
P
N
N
"}
(5,1,1) = {"
P
N
m
a
h
h
h
h
h
a
m
N
P
N
N
"}
(6,1,1) = {"
P
N
m
a
h
h
h
h
h
a
m
N
P
N
N
"}
(7,1,1) = {"
P
N
m
a
h
h
h
h
h
a
m
N
P
N
N
"}
(8,1,1) = {"
P
N
m
a
h
h
h
h
h
a
m
N
P
P
N
"}
(9,1,1) = {"
N
N
m
a
d
d
d
d
d
a
m
N
N
P
N
"}
(10,1,1) = {"
N
m
m
m
W
W
W
W
W
m
m
m
N
P
P
"}
(11,1,1) = {"
N
m
p
p
s
s
s
s
s
p
p
m
N
N
P
"}
(12,1,1) = {"
N
m
p
p
p
p
p
p
p
p
p
m
m
N
P
"}
(13,1,1) = {"
N
p
p
p
p
p
p
p
p
p
p
p
m
N
P
"}
(14,1,1) = {"
N
p
p
p
p
p
p
p
p
p
p
p
m
N
P
"}
(15,1,1) = {"
N
p
p
p
p
p
p
p
p
p
p
p
m
N
P
"}
(16,1,1) = {"
N
p
p
p
p
p
p
p
p
p
p
p
m
N
P
"}
(17,1,1) = {"
N
p
p
p
p
p
p
p
p
p
p
p
m
N
P
"}
(18,1,1) = {"
N
p
p
p
p
p
D
p
p
p
p
p
m
N
P
"}
(19,1,1) = {"
N
p
p
p
p
D
o
D
p
p
p
p
m
N
P
"}
(20,1,1) = {"
N
p
p
p
p
D
l
D
p
p
p
p
m
N
P
"}
(21,1,1) = {"
N
p
p
p
p
D
K
D
p
p
p
p
m
N
P
"}
(22,1,1) = {"
N
p
p
p
p
p
D
p
p
p
p
p
m
N
P
"}
(23,1,1) = {"
N
p
p
p
p
p
p
p
p
p
p
p
m
N
P
"}
(24,1,1) = {"
N
p
p
p
p
p
p
p
p
p
p
p
m
N
P
"}
(25,1,1) = {"
N
p
p
p
p
p
p
p
p
p
p
p
m
N
P
"}
(26,1,1) = {"
N
p
p
p
p
p
p
p
p
p
p
p
m
N
P
"}
(27,1,1) = {"
N
p
p
p
p
p
p
p
p
p
p
p
m
N
P
"}
(28,1,1) = {"
N
m
p
p
p
p
p
p
p
p
p
m
m
N
P
"}
(29,1,1) = {"
N
m
p
p
z
z
z
z
z
p
p
m
N
N
P
"}
(30,1,1) = {"
N
m
m
m
O
O
O
O
O
m
m
m
N
P
P
"}
(31,1,1) = {"
N
N
m
c
T
T
T
T
T
c
m
N
N
P
N
"}
(32,1,1) = {"
P
N
m
c
f
f
f
f
f
c
m
N
P
P
N
"}
(33,1,1) = {"
P
N
m
c
f
f
f
f
f
c
m
N
P
N
N
"}
(34,1,1) = {"
P
N
m
c
f
f
f
f
f
c
m
N
P
N
N
"}
(35,1,1) = {"
P
N
m
c
f
f
f
f
f
c
m
N
P
N
N
"}
(36,1,1) = {"
P
N
m
m
c
c
c
c
c
m
m
N
P
N
N
"}
(37,1,1) = {"
P
N
N
m
m
m
m
m
m
m
N
N
P
N
N
"}
(38,1,1) = {"
P
P
N
N
N
N
N
N
N
N
N
P
P
N
N
"}
(39,1,1) = {"
N
P
P
P
P
P
P
P
P
P
P
P
N
N
N
"}
