//MAP CONVERTED BY dmm2tgm.py THIS HEADER COMMENT PREVENTS RECONVERSION, DO NOT REMOVE
"a" = (
/turf/closed/wall,
/area/shuttle/drop1)
"b" = (
/obj/structure/tent/big,
/turf/open/mars,
/area/shuttle/drop1)
"c" = (
/turf/open/floor/almayer/no_build,
/area/shuttle/drop1)
"d" = (
/obj/effect/landmark/xeno_hive_spawn,
/turf/open/mars,
/area/shuttle/drop1)
"e" = (
/turf/open/floor/kutjevo/tan/grey_inner_edge{
	dir = 4
	},
/area/shuttle/drop1)
"h" = (
/obj/effect/landmark/lv624/xeno_tunnel,
/turf/open/mars,
/area/shuttle/drop1)
"j" = (
/obj/structure/window/framed/colony,
/turf/open/mars,
/area/shuttle/drop1)
"m" = (
/obj/structure/window/framed/colony,
/obj/structure/window/framed/colony,
/turf/open/mars,
/area/shuttle/drop1)
"n" = (
/obj/structure/barricade/plasteel/wired{
	dir = 4;
	linked = 1
	},
/turf/open/mars,
/area/shuttle/drop1)
"o" = (
/turf/open/floor/kutjevo/tan/grey_inner_edge,
/area/shuttle/drop1)
"q" = (
/obj/structure/barricade/metal/wired{
	dir = 4;
	is_wired = 1
	},
/turf/open/mars,
/area/shuttle/drop1)
"s" = (
/turf/open/floor/kutjevo/tan/grey_edge{
	dir = 1
	},
/area/shuttle/drop1)
"u" = (
/obj/structure/barricade/metal/wired{
	is_wired = 1s
	},
/turf/open/floor/kutjevo/tan/grey_edge{
	dir = 8
	},
/area/shuttle/drop1)
"v" = (
/obj/structure/flora/jungle/vines/heavy,
/turf/open/mars,
/area/shuttle/drop1)
"w" = (
/obj/structure/barricade/metal/wired{
	is_wired = 1s
	},
/turf/open/mars,
/area/shuttle/drop1)
"x" = (
/turf/open/floor/kutjevo/tan/grey_inner_edge{
	dir = 8
	},
/area/shuttle/drop1)
"y" = (
/turf/open/floor/kutjevo/tan/grey_edge{
	dir = 4
	},
/area/shuttle/drop1)
"C" = (
/obj/structure/barricade/metal/wired{
	is_wired = 1
	},
/obj/structure/barricade/metal/wired{
	dir = 4;
	is_wired = 1
	},
/turf/open/mars,
/area/shuttle/drop1)
"D" = (
/turf/open/floor/kutjevo/tan/grey_edge,
/area/shuttle/drop1)
"H" = (
/turf/closed/wall/rock/orange,
/area/shuttle/drop1)
"I" = (
/obj/effect/landmark/railgun_camera_pos,
/turf/closed/wall/indestructible/other,
/area/space)
"J" = (
/obj/effect/landmark/map_item,
/turf/closed/wall/indestructible/other,
/area/space)
"M" = (
/obj/docking_port/stationary/marine_dropship/lz1,
/turf/open/floor/almayer/no_build,
/area/shuttle/drop1)
"N" = (
/obj/structure/barricade/plasteel/wired{
	linked = 1
	},
/turf/open/mars,
/area/shuttle/drop1)
"O" = (
/turf/open/floor/kutjevo/tan/grey_edge{
	dir = 8
	},
/area/shuttle/drop1)
"P" = (
/turf/closed/wall/kutjevo/colony/reinforced/hull,
/area/shuttle/drop1)
"R" = (
/turf/closed/wall/indestructible/other,
/area/space)
"S" = (
/obj/structure/barricade/metal/wired{
	dir = 4;
	is_wired = 1
	},
/turf/open/floor/kutjevo/tan/grey_edge{
	dir = 1
	},
/area/shuttle/drop1)
"V" = (
/turf/open/floor/kutjevo/tan/grey_inner_edge{
	dir = 1
	},
/area/shuttle/drop1)
"W" = (
/turf/open/mars,
/area/shuttle/drop1)

(1,1,1) = {"
I
R
J
R
R
R
R
R
R
R
R
R
R
R
R
R
R
R
R
R
R
R
R
R
R
R
R
R
R
R
R
R
R
R
R
R
R
R
R
R
R
R
R
R
R
R
R
R
R
R
R
R
R
R
R
R
R
R
R
R
R
R
R
R
R
R
R
R
R
R
R
R
R
R
R
R
R
R
R
R
R
R
R
R
R
R
R
R
R
R
R
R
R
R
R
R
R
R
R
R
"}
(2,1,1) = {"
R
h
W
W
W
W
W
W
W
W
W
W
W
W
W
W
W
W
W
W
W
W
W
W
W
W
W
W
W
W
W
W
W
W
W
W
W
W
W
W
W
W
W
W
W
W
W
W
W
W
W
W
W
W
W
W
W
W
W
W
W
W
W
W
W
W
W
W
W
W
W
W
v
v
v
v
v
v
W
W
W
W
W
W
h
H
h
W
W
W
W
W
W
W
W
W
W
W
W
R
"}
(3,1,1) = {"
R
W
W
W
W
W
W
W
W
W
W
W
W
W
W
W
W
W
W
W
W
W
W
W
W
W
W
W
W
W
W
W
W
W
W
W
W
W
W
W
W
W
W
W
W
W
W
W
W
W
W
W
W
W
W
W
W
W
W
W
W
W
W
W
W
W
W
W
W
W
W
W
v
v
v
v
v
v
W
W
a
W
W
W
W
H
W
W
W
W
W
W
W
W
W
W
W
W
W
R
"}
(4,1,1) = {"
R
W
W
W
W
W
W
W
W
W
W
W
W
W
W
W
W
W
W
W
W
W
W
W
W
W
W
W
W
W
W
W
W
W
W
W
W
W
W
W
W
W
W
W
W
W
W
W
W
W
W
W
W
W
W
W
W
W
W
W
W
W
W
W
W
a
W
W
W
W
W
W
v
v
v
v
v
v
W
W
a
W
W
W
W
H
W
W
W
W
W
W
W
W
W
W
W
W
W
R
"}
(5,1,1) = {"
R
W
W
W
W
W
W
W
W
W
W
W
W
W
W
W
W
W
W
W
W
W
W
W
W
W
W
W
W
W
W
W
W
W
W
W
W
W
W
W
W
W
W
W
W
W
W
W
W
W
W
W
W
W
W
W
W
W
W
W
W
W
W
W
W
a
W
W
a
W
W
W
v
v
v
v
v
v
W
W
a
W
W
W
W
H
W
W
W
W
W
W
W
W
W
W
W
W
W
R
"}
(6,1,1) = {"
R
W
W
W
W
W
W
W
W
W
W
W
W
W
W
W
W
W
W
W
W
W
W
W
W
W
W
W
W
W
W
W
W
W
W
W
W
W
W
W
W
W
W
W
W
W
W
W
W
W
W
H
H
H
H
H
H
H
H
H
H
H
W
W
W
W
W
W
a
W
W
W
v
v
v
v
v
v
W
W
W
W
W
W
W
H
W
W
W
W
W
W
W
W
W
W
W
W
W
R
"}
(7,1,1) = {"
R
W
W
W
W
W
W
W
W
W
W
W
W
W
W
W
W
W
W
W
W
W
W
W
W
W
W
W
W
W
W
W
W
W
W
W
W
W
W
W
W
W
W
W
W
W
W
W
W
W
W
H
W
W
W
W
W
W
W
W
W
H
W
W
W
a
W
W
a
W
W
W
v
v
v
v
v
v
W
W
W
W
W
W
W
H
W
W
W
W
W
W
W
W
W
W
W
W
W
R
"}
(8,1,1) = {"
R
W
W
W
W
W
W
W
W
W
W
W
W
W
W
W
W
W
W
W
W
W
W
W
W
W
W
W
W
W
W
W
W
W
W
W
W
W
W
W
W
W
W
W
W
W
W
W
W
W
W
H
W
W
W
W
W
W
W
W
W
H
W
W
W
a
W
W
W
W
W
W
v
v
v
v
v
v
W
W
a
W
W
W
W
H
W
W
W
W
W
W
W
W
W
W
W
W
W
R
"}
(9,1,1) = {"
R
W
W
W
W
W
W
W
W
W
W
W
W
W
W
W
W
W
W
W
W
W
W
W
W
W
W
W
W
W
W
W
W
W
W
W
W
W
W
W
W
W
W
W
W
W
W
W
W
W
W
H
W
W
W
W
W
W
W
W
W
H
W
W
W
W
W
W
W
W
W
W
v
v
v
v
v
v
W
W
W
W
W
W
W
H
W
W
W
W
W
W
W
W
W
W
W
W
W
R
"}
(10,1,1) = {"
R
W
W
W
W
W
W
W
W
W
W
W
W
W
W
W
W
W
W
W
W
W
W
W
W
W
W
W
W
W
W
W
W
W
W
W
W
W
W
W
W
W
W
W
W
W
W
W
W
W
W
H
W
W
W
W
W
W
W
W
W
H
W
W
W
W
W
W
W
W
W
W
v
v
v
v
v
v
W
W
W
W
W
W
W
H
W
W
W
W
W
W
W
W
W
W
W
W
W
R
"}
(11,1,1) = {"
R
W
W
W
W
W
W
W
W
W
W
W
W
W
W
W
W
W
W
W
W
W
W
W
W
W
W
W
W
W
W
W
W
W
W
W
W
W
W
W
W
W
W
W
W
W
W
W
W
W
W
H
W
W
W
W
W
W
W
W
W
H
W
W
W
W
W
W
W
W
W
W
v
v
v
v
v
v
W
W
H
H
v
v
H
W
W
W
W
W
W
W
W
W
W
W
W
W
W
R
"}
(12,1,1) = {"
R
W
W
W
W
W
W
W
W
W
W
W
W
W
W
W
W
W
W
W
W
W
W
W
W
W
W
W
W
W
W
W
W
W
W
W
W
W
W
W
W
W
W
W
W
W
W
W
W
W
W
W
W
W
H
W
W
W
W
W
W
W
W
W
W
W
W
W
W
W
W
W
v
v
v
v
v
v
W
H
H
v
v
v
H
W
W
W
W
W
W
W
W
W
W
W
W
W
W
R
"}
(13,1,1) = {"
R
W
W
W
W
W
W
W
W
W
W
W
W
W
W
W
W
W
W
W
W
W
W
W
W
W
W
W
W
W
W
W
W
W
W
W
W
W
W
W
W
W
W
W
W
W
W
W
W
W
W
W
W
W
H
W
W
W
W
W
W
H
W
W
W
W
W
W
W
W
W
W
v
v
v
v
v
v
H
H
v
v
v
v
H
W
W
W
W
W
W
W
W
W
W
W
W
W
W
R
"}
(14,1,1) = {"
R
W
W
W
W
W
W
W
W
W
W
W
W
W
W
W
W
W
W
W
W
W
W
W
W
W
W
W
W
W
W
W
W
W
W
W
W
W
W
W
W
W
W
W
W
W
W
W
W
W
W
H
H
H
H
W
W
W
W
W
W
H
W
W
W
W
W
W
W
W
W
W
v
v
v
v
v
v
H
H
v
v
v
v
H
W
W
W
W
W
d
W
W
W
W
W
W
W
W
R
"}
(15,1,1) = {"
R
W
W
W
W
W
W
W
W
W
W
W
W
W
W
W
W
W
W
W
W
W
W
W
W
W
W
W
W
W
W
W
W
W
W
W
W
W
W
W
W
W
W
W
W
W
W
W
W
W
W
W
W
W
H
W
W
W
W
W
W
H
W
W
W
W
W
W
W
W
W
W
W
W
W
W
W
H
H
H
v
v
v
v
H
W
W
W
W
W
W
W
W
W
W
W
W
W
W
R
"}
(16,1,1) = {"
R
W
W
W
W
W
W
W
W
W
W
W
W
W
W
W
W
W
W
W
W
W
W
W
W
W
W
W
H
W
W
W
W
W
W
W
W
W
W
W
W
W
W
W
W
a
W
W
W
W
W
W
W
W
H
W
W
W
W
W
W
W
W
W
W
W
W
W
W
W
W
W
W
W
W
W
H
H
H
H
v
v
v
v
H
W
W
W
W
W
W
W
W
W
W
W
W
W
W
R
"}
(17,1,1) = {"
R
W
W
W
W
W
W
W
W
W
W
W
W
W
W
W
W
W
W
W
W
W
W
W
W
H
H
H
W
W
W
W
W
W
W
W
W
W
W
W
W
W
W
W
W
a
W
W
W
W
W
H
W
W
W
W
W
W
W
W
W
H
W
W
W
W
W
W
W
W
W
W
W
W
W
H
H
H
H
H
v
v
v
v
H
W
W
W
W
W
W
W
W
W
W
W
W
W
W
R
"}
(18,1,1) = {"
R
W
W
W
W
W
W
W
W
W
W
W
W
W
W
W
W
W
W
W
W
W
W
H
H
H
W
W
W
W
W
W
W
W
W
W
W
W
W
W
W
W
W
W
W
a
W
W
W
W
W
H
W
W
W
W
W
W
W
W
W
H
W
W
W
W
W
W
W
W
W
W
W
W
W
H
W
H
H
H
v
v
v
v
H
W
W
W
W
W
W
W
W
W
W
W
W
W
W
R
"}
(19,1,1) = {"
R
W
W
W
W
W
W
W
W
W
W
W
W
W
W
W
W
W
W
W
W
W
H
H
W
W
W
W
W
W
W
W
W
W
W
W
W
W
W
W
W
W
W
W
W
a
W
W
W
W
W
H
W
W
W
W
W
W
W
W
W
H
W
W
W
W
W
W
W
W
W
W
W
W
H
W
W
H
H
H
v
v
v
v
H
W
W
W
W
W
W
W
W
W
W
W
W
W
W
R
"}
(20,1,1) = {"
R
W
W
W
W
W
W
W
W
W
W
W
W
W
W
W
W
W
W
W
W
H
H
W
W
W
W
W
W
W
W
W
W
W
W
W
W
W
W
W
W
W
W
W
W
a
W
W
W
W
W
H
W
W
W
W
W
W
W
W
W
H
W
W
W
W
W
W
W
W
W
W
W
H
H
W
W
H
H
H
v
v
v
v
H
W
W
W
W
W
W
W
W
W
W
W
W
W
W
R
"}
(21,1,1) = {"
R
W
W
W
W
W
W
W
W
W
W
W
W
W
W
W
W
W
W
W
H
W
W
W
W
W
W
W
W
W
W
W
W
W
W
W
W
W
W
W
W
W
W
W
W
a
W
W
W
W
W
H
W
W
W
W
W
W
W
W
W
H
W
W
W
W
W
W
W
W
W
W
W
H
W
W
W
H
H
H
v
v
v
v
H
W
W
W
W
W
W
W
W
W
W
W
W
W
W
R
"}
(22,1,1) = {"
R
W
W
W
W
W
W
W
W
W
W
W
W
W
W
W
W
W
W
H
W
W
W
W
W
W
W
W
W
W
W
W
W
W
W
W
W
W
W
a
a
a
a
a
a
a
W
W
W
W
W
H
H
H
H
H
H
H
H
H
H
H
W
W
W
W
W
W
W
W
W
W
H
W
W
W
W
H
H
H
v
v
v
v
H
W
W
W
W
W
W
W
W
W
W
W
W
W
W
R
"}
(23,1,1) = {"
R
W
W
W
W
W
W
W
W
W
W
W
W
W
W
W
W
W
H
H
W
W
W
W
W
W
W
W
W
W
W
W
W
W
W
W
W
W
W
W
W
W
W
W
W
W
W
W
W
W
W
W
W
W
W
W
W
W
W
W
W
W
W
W
W
W
W
W
W
W
W
W
H
W
W
W
W
v
v
v
v
v
v
v
H
W
W
W
W
W
W
W
W
W
W
W
W
W
W
R
"}
(24,1,1) = {"
R
W
W
W
W
W
W
W
W
W
W
W
W
W
W
W
W
W
H
W
W
W
W
W
W
W
W
W
W
W
W
W
W
W
W
W
W
W
W
W
W
W
W
W
W
W
W
W
W
W
W
W
W
W
W
W
W
W
W
W
W
W
W
W
W
W
W
W
W
W
W
H
W
W
W
W
W
v
v
v
v
v
v
v
H
W
W
W
W
W
W
W
W
W
W
W
W
W
W
R
"}
(25,1,1) = {"
R
W
W
W
W
W
W
W
W
W
W
W
W
W
W
W
W
H
H
W
W
W
W
W
W
W
W
W
W
W
W
W
W
W
W
W
W
W
W
W
W
W
W
W
W
W
W
W
W
W
W
W
W
W
W
a
a
a
a
a
W
W
W
W
W
W
W
W
W
W
W
H
W
W
W
W
W
v
v
v
v
v
v
v
H
W
W
W
W
W
W
W
W
W
W
W
W
W
W
R
"}
(26,1,1) = {"
R
W
W
W
W
W
W
W
W
W
W
W
W
W
W
W
W
H
W
W
W
W
W
W
W
W
W
W
W
W
W
W
W
W
W
W
W
W
W
W
W
W
W
W
W
W
W
W
W
W
W
a
W
W
W
W
W
W
W
W
W
W
W
W
W
W
W
W
W
W
H
H
W
W
W
W
W
v
v
v
v
v
v
v
H
W
W
W
W
W
W
W
W
W
W
W
W
W
W
R
"}
(27,1,1) = {"
R
W
W
W
W
W
W
W
W
W
W
W
W
W
W
W
H
H
W
W
W
W
W
W
W
W
W
W
W
W
W
W
W
W
W
W
W
W
W
W
W
W
W
W
W
W
W
W
W
W
W
a
W
W
W
W
W
W
W
W
W
W
W
W
W
W
W
W
W
W
H
W
W
W
W
W
H
H
H
H
v
v
v
v
H
W
W
W
W
W
W
W
W
W
W
W
W
W
W
R
"}
(28,1,1) = {"
R
W
W
W
W
W
W
W
W
W
W
W
W
W
W
W
H
W
W
W
W
W
W
W
W
W
W
W
W
W
W
W
W
W
W
W
W
W
W
W
W
W
W
W
W
W
W
W
W
W
W
a
W
W
W
a
W
W
W
a
W
W
W
W
W
W
W
W
W
W
H
W
W
W
W
W
H
H
H
H
v
v
v
v
H
W
W
W
W
W
W
W
W
W
W
W
W
W
W
R
"}
(29,1,1) = {"
R
W
W
W
W
W
W
W
W
W
W
W
W
W
W
W
H
W
W
W
W
W
W
W
W
W
W
W
W
W
W
W
W
W
W
W
W
W
W
W
W
W
W
W
W
W
W
W
W
W
W
j
W
W
W
a
W
W
W
a
W
W
j
W
W
W
W
W
W
W
H
W
W
W
W
W
H
H
H
H
v
v
v
v
H
W
W
W
W
W
W
W
W
W
W
W
W
W
W
R
"}
(30,1,1) = {"
R
W
W
W
W
W
W
W
W
W
W
W
W
W
W
W
H
W
W
W
W
W
W
W
W
W
W
W
W
W
W
W
W
W
W
W
W
W
W
W
W
W
W
W
W
W
W
W
W
W
W
j
W
W
W
a
W
W
W
a
W
W
j
W
W
W
W
W
W
W
H
W
W
W
W
W
H
H
H
H
v
v
v
v
H
W
W
W
W
W
W
W
W
W
W
W
W
W
W
R
"}
(31,1,1) = {"
R
W
W
W
W
W
W
W
W
W
W
W
W
W
W
H
W
W
W
W
W
W
W
W
W
W
W
W
W
W
W
W
W
W
W
W
W
W
W
W
W
W
W
W
W
W
W
W
W
W
W
j
W
W
W
a
W
W
W
a
W
W
j
W
W
W
W
W
W
W
H
W
W
W
W
W
H
H
H
H
v
v
v
v
H
W
W
W
W
W
W
W
W
W
W
W
W
W
W
R
"}
(32,1,1) = {"
R
W
W
W
W
W
W
W
W
W
W
W
W
W
W
H
W
W
W
W
W
W
W
W
W
W
W
W
W
W
W
W
W
W
W
W
W
W
W
W
W
W
W
W
W
W
W
W
W
W
W
a
W
W
W
a
a
a
a
a
W
W
a
W
W
W
W
W
W
H
W
W
W
W
W
W
H
H
H
H
v
v
v
v
H
W
W
W
W
W
W
W
W
W
W
W
W
W
W
R
"}
(33,1,1) = {"
R
W
W
W
W
W
W
W
W
W
W
W
W
W
W
H
W
W
W
W
W
W
W
W
W
W
W
W
W
W
W
W
W
W
W
W
W
W
W
W
W
W
W
W
W
W
W
W
W
W
W
a
W
W
W
W
W
W
W
W
W
W
a
W
W
W
W
W
W
H
W
W
W
W
W
W
H
H
H
H
v
v
v
v
H
W
W
W
W
W
W
W
W
W
W
W
W
W
W
R
"}
(34,1,1) = {"
R
W
W
W
W
W
W
W
W
W
W
W
W
W
W
H
W
W
W
W
W
W
W
W
W
W
W
W
W
W
W
W
W
W
W
W
W
W
W
W
W
W
W
W
W
W
W
W
W
W
W
a
W
W
W
W
W
W
W
W
W
W
a
W
W
W
W
W
W
H
W
W
W
W
W
W
H
H
H
H
v
v
v
v
H
W
W
W
W
W
W
W
W
W
W
W
W
W
W
R
"}
(35,1,1) = {"
R
W
W
W
W
W
W
W
W
W
W
W
W
W
W
H
W
W
W
W
W
W
W
W
W
W
W
W
W
W
P
P
P
P
P
P
P
P
P
P
P
P
P
P
P
W
W
W
W
W
W
a
a
a
a
a
j
j
a
a
a
a
a
W
W
W
W
W
W
H
W
W
W
W
W
W
H
H
H
H
v
v
v
v
H
W
W
W
W
W
W
W
W
W
W
W
W
W
W
R
"}
(36,1,1) = {"
R
W
W
W
W
W
W
W
W
W
W
W
W
W
W
H
W
W
W
W
W
W
W
W
W
W
W
W
W
W
P
o
O
O
O
O
O
O
u
O
O
O
O
O
O
O
O
O
O
O
O
O
O
O
O
O
O
O
O
O
O
O
O
O
O
O
O
O
O
e
W
W
W
W
W
W
H
H
H
H
v
v
v
v
H
W
W
W
W
W
W
W
W
W
W
W
W
W
W
R
"}
(37,1,1) = {"
R
W
W
W
W
W
W
W
W
W
W
W
W
W
W
H
W
W
W
W
W
W
W
W
W
W
W
W
W
W
P
s
W
W
W
b
W
W
N
W
W
W
W
W
W
W
W
W
W
W
W
W
W
W
W
W
W
W
W
W
W
W
W
W
W
W
W
W
W
D
W
W
W
W
W
W
H
H
H
H
v
v
v
v
H
W
W
W
W
W
W
W
W
W
W
W
W
W
W
R
"}
(38,1,1) = {"
R
W
W
W
W
W
W
W
W
W
W
W
W
W
W
H
W
W
W
W
W
W
W
W
W
W
W
W
W
W
P
s
W
W
W
W
W
W
N
W
W
W
W
W
W
W
W
W
W
W
W
W
W
W
W
W
W
W
W
W
W
W
W
W
W
W
W
W
W
D
W
W
W
W
W
W
W
W
v
v
v
v
v
v
H
W
W
W
W
W
W
W
W
W
W
W
W
W
W
R
"}
(39,1,1) = {"
R
W
W
W
W
W
W
W
W
W
W
W
W
W
W
H
W
W
W
W
W
W
W
W
W
W
W
W
W
W
P
s
W
W
W
W
W
W
N
W
W
W
W
W
W
W
W
W
W
W
W
W
W
W
W
W
W
W
W
W
W
W
W
W
W
W
W
W
W
D
W
W
W
W
W
W
W
W
v
v
v
v
v
v
H
W
W
W
W
W
W
W
W
W
W
W
W
W
W
R
"}
(40,1,1) = {"
R
W
W
W
W
W
W
W
W
W
W
W
W
W
W
H
W
W
W
W
W
W
W
W
W
W
W
W
W
W
P
s
W
W
W
W
W
W
w
W
W
W
W
W
W
W
W
W
W
W
W
W
W
W
W
W
W
W
W
W
W
W
W
W
W
W
W
W
W
D
a
W
W
W
W
W
W
W
v
v
v
v
v
v
H
W
W
W
W
W
W
W
W
W
W
W
W
W
W
R
"}
(41,1,1) = {"
R
W
W
W
W
W
W
W
W
W
W
W
W
W
H
W
W
W
W
W
W
W
W
W
W
W
W
W
W
W
P
S
q
q
n
n
q
q
C
W
W
W
W
W
W
W
W
W
W
W
W
W
W
W
W
W
W
W
W
W
W
W
W
W
W
W
W
W
W
D
a
W
W
W
W
W
W
W
v
v
v
v
v
v
H
W
W
W
W
W
W
W
W
W
W
W
W
W
W
R
"}
(42,1,1) = {"
R
W
W
W
W
W
W
W
W
W
W
W
W
W
H
W
W
W
W
W
W
W
W
W
W
W
W
W
W
W
P
s
W
W
W
W
W
W
W
W
W
W
W
W
W
W
W
W
W
W
W
W
W
W
W
W
W
W
W
W
W
W
W
W
W
W
W
W
W
D
a
W
W
W
W
W
W
H
H
H
v
v
v
v
H
W
W
W
W
W
W
W
W
W
W
W
W
W
W
R
"}
(43,1,1) = {"
R
W
W
W
W
W
W
W
W
W
W
W
W
W
H
W
W
W
W
W
W
W
W
W
W
W
W
W
W
W
P
s
W
W
W
W
W
W
c
c
c
c
c
c
c
c
c
c
c
c
c
c
c
c
c
c
c
c
c
c
c
c
c
W
W
W
W
W
W
D
a
W
W
W
W
W
W
H
H
H
v
v
v
v
H
W
W
W
W
W
W
W
W
W
W
W
W
W
W
R
"}
(44,1,1) = {"
R
W
W
W
W
W
W
W
W
W
W
W
W
W
H
W
W
W
W
W
W
W
W
W
W
W
W
W
W
W
P
s
W
W
W
W
W
W
c
c
c
c
c
c
c
c
c
c
c
c
c
c
c
c
c
c
c
c
c
c
c
c
c
W
W
W
W
W
W
D
W
W
W
W
W
W
W
H
H
H
v
v
v
v
H
W
W
W
W
W
W
W
W
W
W
W
W
W
W
R
"}
(45,1,1) = {"
R
W
W
W
W
W
W
W
W
W
W
W
W
W
H
W
W
W
W
W
W
W
W
W
W
W
W
W
W
W
P
s
W
W
W
W
W
W
c
c
c
c
c
c
c
c
c
c
c
c
c
c
c
c
c
c
c
c
c
c
c
c
c
W
W
W
W
W
W
D
W
W
W
W
W
W
W
W
H
H
v
v
v
v
H
W
W
W
W
W
W
W
W
W
W
W
W
W
W
R
"}
(46,1,1) = {"
R
W
W
W
W
W
W
W
W
W
W
W
W
W
H
W
W
W
W
W
W
W
W
W
W
W
W
W
W
W
P
s
W
W
W
W
W
W
c
c
c
c
c
c
c
c
c
c
c
c
c
c
c
c
c
c
c
c
c
c
c
c
c
W
W
W
W
W
W
D
W
W
W
W
W
W
W
W
H
H
v
v
v
v
H
W
W
W
W
W
W
W
W
W
W
W
W
W
W
R
"}
(47,1,1) = {"
R
W
W
W
W
W
W
W
W
W
W
W
W
W
H
W
W
W
W
W
W
W
W
W
W
W
W
W
W
W
P
s
W
W
W
W
W
W
c
c
c
c
c
c
c
c
c
c
c
c
c
c
c
c
c
c
c
c
c
c
c
c
c
W
W
W
W
W
W
D
W
W
W
W
W
W
W
W
H
H
v
v
v
v
H
W
W
W
W
W
W
W
W
W
W
W
W
W
W
R
"}
(48,1,1) = {"
R
W
W
W
W
W
W
W
W
W
W
W
W
W
H
W
W
W
W
W
W
W
W
W
W
W
W
W
W
W
W
s
W
W
W
W
W
W
c
c
c
c
c
c
c
c
c
c
c
c
c
c
c
c
c
c
c
c
c
c
c
c
c
W
W
W
W
W
W
D
P
W
W
W
W
W
W
W
H
H
v
v
v
v
H
W
W
W
W
W
W
W
W
W
W
W
W
W
W
R
"}
(49,1,1) = {"
R
W
W
W
W
W
W
W
W
W
W
W
W
W
H
W
W
W
W
W
W
W
W
W
W
W
W
W
W
W
W
s
W
W
W
W
W
W
c
c
c
c
c
c
c
c
c
c
c
c
M
c
c
c
c
c
c
c
c
c
c
c
c
W
W
W
W
W
W
D
P
W
W
j
j
j
W
W
H
H
v
v
v
v
H
W
W
W
W
W
W
W
W
W
W
W
W
W
W
R
"}
(50,1,1) = {"
R
W
W
W
W
W
W
W
W
W
W
W
W
W
H
W
W
W
W
W
W
W
W
W
W
W
W
W
W
W
W
s
W
W
W
W
W
W
c
c
c
c
c
c
c
c
c
c
c
c
c
c
c
c
c
c
c
c
c
c
c
c
c
W
W
W
W
W
W
D
P
W
W
j
W
W
W
W
H
H
v
v
v
v
H
W
W
W
W
W
W
W
W
W
W
W
W
W
W
R
"}
(51,1,1) = {"
R
W
W
W
W
W
W
W
W
W
W
W
W
W
H
W
W
W
W
W
W
W
W
W
W
W
W
W
W
W
a
s
W
W
W
W
W
W
c
c
c
c
c
c
c
c
c
c
c
c
c
c
c
c
c
c
c
c
c
c
c
c
c
W
W
W
W
W
W
D
P
W
W
j
W
W
W
W
H
H
v
v
v
v
H
W
W
W
W
W
W
W
W
W
W
W
W
W
W
R
"}
(52,1,1) = {"
R
W
W
W
W
W
W
W
W
W
W
W
W
W
H
W
W
W
W
W
W
W
W
W
W
W
W
W
W
W
a
s
W
W
W
W
W
W
c
c
c
c
c
c
c
c
c
c
c
c
c
c
c
c
c
c
c
c
c
c
c
c
c
W
W
W
W
W
W
D
P
W
W
W
W
W
W
W
H
H
v
v
v
v
H
W
W
W
W
W
W
W
W
W
W
W
W
W
W
R
"}
(53,1,1) = {"
R
W
W
W
W
W
W
W
W
W
W
W
W
W
H
W
W
W
W
W
W
W
W
W
W
W
W
W
W
W
a
s
W
W
W
W
W
W
c
c
c
c
c
c
c
c
c
c
c
c
c
c
c
c
c
c
c
c
c
c
c
c
c
W
W
W
W
W
W
D
P
W
W
W
W
W
W
W
H
H
v
v
v
v
H
W
W
W
W
W
W
W
W
W
W
W
W
W
W
R
"}
(54,1,1) = {"
R
W
W
W
W
W
W
W
W
W
W
W
W
W
H
W
W
W
W
W
W
W
W
W
W
W
W
W
W
W
W
s
W
W
W
W
W
W
c
c
c
c
c
c
c
c
c
c
c
c
c
c
c
c
c
c
c
c
c
c
c
c
c
W
W
W
W
W
W
D
P
W
W
W
W
W
W
W
H
H
v
v
v
v
H
W
W
W
W
W
W
W
W
W
W
W
W
W
W
R
"}
(55,1,1) = {"
R
W
W
W
W
W
W
W
W
W
W
W
W
W
H
W
W
W
W
W
W
W
W
W
W
W
W
W
W
W
W
s
W
W
W
W
W
W
c
c
c
c
c
c
c
c
c
c
c
c
c
c
c
c
c
c
c
c
c
c
c
c
c
W
W
W
W
W
W
D
P
W
W
W
W
W
W
W
H
H
v
v
v
v
H
W
W
W
W
W
W
W
W
W
W
W
W
W
W
R
"}
(56,1,1) = {"
R
W
W
W
W
W
W
W
W
W
W
W
W
W
W
H
W
W
W
W
W
W
W
W
W
W
W
W
W
W
W
s
W
W
W
W
W
W
c
c
c
c
c
c
c
c
c
c
c
c
c
c
c
c
c
c
c
c
c
c
c
c
c
W
W
W
W
W
W
D
P
W
W
W
W
W
W
W
H
H
v
v
v
v
H
W
W
W
W
W
W
W
W
W
W
W
W
W
W
R
"}
(57,1,1) = {"
R
W
W
W
W
W
W
W
W
W
W
W
W
W
W
H
W
W
W
W
W
W
W
W
W
W
W
W
W
W
P
s
W
W
W
W
W
W
W
W
W
W
W
W
W
W
W
W
W
W
W
W
W
W
W
W
W
W
W
W
W
W
W
W
W
W
W
W
W
D
P
W
W
W
W
W
W
W
H
H
v
v
v
v
H
W
W
W
W
W
W
W
W
W
W
W
W
W
W
R
"}
(58,1,1) = {"
R
W
W
W
W
W
W
W
W
W
W
W
W
W
W
H
W
W
W
W
W
W
W
W
W
W
W
W
W
W
P
s
W
W
W
W
W
W
W
W
W
W
W
W
W
W
W
W
W
W
W
W
W
W
W
W
W
W
W
W
W
W
W
W
W
W
W
W
W
D
P
W
W
W
W
W
W
W
v
v
v
v
v
v
H
W
W
W
W
W
W
W
W
W
W
W
W
W
W
R
"}
(59,1,1) = {"
R
W
W
W
W
W
W
W
W
W
W
W
W
W
W
H
W
W
W
W
W
W
W
W
W
W
W
W
W
W
P
s
W
W
W
W
W
W
W
W
W
W
W
W
W
W
W
W
W
W
W
W
W
W
W
W
W
W
W
W
W
W
W
W
W
W
W
W
W
D
P
W
W
W
W
W
W
W
v
v
v
v
v
v
H
W
W
W
W
W
W
W
W
W
W
W
W
W
W
R
"}
(60,1,1) = {"
R
W
W
W
W
W
W
W
W
W
W
W
W
W
W
H
W
W
W
W
W
W
W
W
W
W
W
W
W
W
P
s
W
W
W
W
W
W
W
W
W
W
W
W
W
W
W
W
W
W
W
W
W
W
W
W
W
W
W
W
W
W
W
W
W
W
W
W
W
D
P
W
W
W
W
W
W
W
H
H
H
H
H
H
H
W
W
W
W
W
W
W
W
W
W
W
W
W
W
R
"}
(61,1,1) = {"
R
W
W
W
W
W
W
W
W
W
W
W
W
W
W
H
W
W
W
W
W
W
W
W
W
W
W
W
W
W
P
s
W
W
W
W
W
W
W
W
W
W
W
W
W
W
W
W
W
W
W
W
W
W
W
W
W
W
W
W
W
W
W
W
W
W
W
W
W
D
P
W
W
W
W
W
W
W
H
W
W
W
W
W
W
W
W
W
W
W
W
W
W
W
W
W
W
W
W
R
"}
(62,1,1) = {"
R
W
W
W
W
W
W
W
W
W
W
W
W
W
W
H
W
W
W
W
W
W
W
W
W
W
W
W
W
W
P
s
W
W
W
W
W
W
W
W
W
W
W
W
W
W
W
W
W
W
W
W
W
W
W
W
W
W
W
W
W
W
W
W
W
W
W
W
W
D
P
W
W
W
W
W
W
W
H
W
W
W
W
W
W
W
W
W
W
W
W
W
W
W
W
W
W
W
W
R
"}
(63,1,1) = {"
R
W
W
W
W
W
W
W
W
W
W
W
W
W
W
H
W
W
W
W
W
W
W
W
W
a
a
a
W
W
P
V
y
y
y
y
y
y
y
y
y
y
y
y
y
y
y
y
y
y
y
y
y
y
y
y
y
y
y
y
y
y
y
y
y
y
y
y
y
x
P
W
W
W
W
W
W
W
H
W
W
W
W
W
W
W
W
W
W
W
W
W
W
W
W
W
W
W
W
R
"}
(64,1,1) = {"
R
W
W
W
W
W
W
W
W
W
W
W
W
W
W
H
W
W
W
W
W
W
W
W
W
j
W
W
W
W
W
W
W
a
a
a
a
j
j
j
j
a
a
a
a
a
a
a
a
W
W
W
W
W
W
W
P
P
P
P
P
P
P
P
P
P
P
P
P
P
P
W
W
W
W
W
W
W
H
W
W
W
W
W
W
W
W
W
W
W
W
W
W
W
W
W
W
W
W
R
"}
(65,1,1) = {"
R
W
W
W
W
W
W
W
W
W
W
W
W
W
W
H
W
W
W
a
W
a
a
W
W
W
W
W
W
W
W
W
W
W
W
W
a
W
W
W
W
a
W
W
W
W
a
W
W
W
W
W
W
W
W
W
W
W
W
W
H
W
W
W
W
W
W
W
W
W
W
W
W
W
W
W
W
W
H
W
W
W
W
W
W
W
W
W
W
W
W
W
W
W
W
W
W
W
W
R
"}
(66,1,1) = {"
R
W
W
W
W
W
W
W
W
W
W
W
W
W
W
W
H
W
W
W
W
W
j
W
W
j
W
W
W
a
a
W
W
W
W
W
a
W
W
W
W
a
W
W
W
W
a
W
W
W
W
a
W
W
W
W
W
W
W
W
H
W
W
W
a
W
W
W
W
W
W
W
W
W
W
W
W
W
H
W
W
W
W
W
W
W
W
W
W
W
W
W
W
W
W
W
W
W
W
R
"}
(67,1,1) = {"
R
W
W
W
W
W
W
W
W
W
W
W
W
W
W
W
H
W
W
W
W
W
j
W
W
m
W
W
W
W
a
W
W
a
W
W
a
W
W
W
W
a
W
W
W
W
W
W
W
W
W
a
W
W
W
W
a
W
W
W
H
W
W
W
a
W
W
W
a
W
W
W
W
W
W
W
W
W
H
W
W
W
W
W
W
W
W
W
W
W
W
W
W
W
W
W
W
W
W
R
"}
(68,1,1) = {"
R
W
W
W
W
W
W
W
W
W
W
W
W
W
W
W
H
W
W
W
W
W
j
W
W
j
W
W
W
W
W
W
W
a
W
W
W
W
W
W
W
W
W
W
a
W
W
W
W
j
j
a
W
W
W
W
a
W
W
W
H
W
W
W
a
W
W
W
a
W
W
W
W
W
W
W
H
H
W
W
W
W
W
W
W
W
W
W
W
W
W
W
W
W
W
W
W
W
W
R
"}
(69,1,1) = {"
R
W
W
W
W
W
W
W
W
W
W
W
W
W
W
W
H
W
W
W
W
W
j
W
W
W
W
W
W
W
W
W
W
a
W
W
W
W
W
W
W
W
W
W
a
W
W
W
W
W
W
a
W
W
W
W
a
W
W
W
H
W
W
W
W
W
W
W
a
W
W
W
W
W
W
W
H
W
W
W
W
W
W
W
W
W
W
W
W
W
W
W
W
W
W
W
W
W
W
R
"}
(70,1,1) = {"
R
W
W
W
W
W
W
W
W
W
W
W
W
W
W
W
H
W
W
a
W
a
a
W
W
a
a
a
a
a
a
W
W
a
W
W
a
a
a
a
a
a
W
a
a
a
W
W
a
a
a
a
W
W
W
W
a
W
W
W
H
H
W
W
W
a
W
W
a
W
W
W
W
W
W
H
W
W
W
W
W
W
W
W
W
W
W
W
W
W
W
W
W
W
W
W
W
W
W
R
"}
(71,1,1) = {"
R
W
W
W
W
W
W
W
W
W
W
W
W
W
W
W
H
W
W
W
W
W
W
W
W
W
W
W
W
W
W
W
W
W
W
W
W
W
W
W
W
W
W
W
W
W
W
W
W
W
W
W
W
W
W
W
a
W
W
W
W
H
h
W
W
a
W
W
W
W
W
W
W
W
H
H
W
W
W
W
W
W
W
W
W
W
W
W
W
W
W
W
W
W
W
W
W
W
W
R
"}
(72,1,1) = {"
R
W
W
W
W
W
W
W
W
W
W
W
W
W
W
W
H
H
W
W
W
W
W
W
W
W
W
W
W
W
W
W
W
W
W
W
W
W
W
W
W
W
W
W
W
W
W
W
W
W
W
W
W
W
W
W
a
W
W
W
W
H
H
W
W
W
W
W
W
W
W
W
W
H
H
W
W
W
W
W
W
W
W
W
W
W
W
W
W
W
W
W
W
W
W
W
W
W
W
R
"}
(73,1,1) = {"
R
W
W
W
W
W
W
W
W
W
W
W
W
W
W
W
W
H
W
W
W
W
W
W
W
W
W
W
W
W
W
W
W
W
W
W
W
W
W
W
W
a
a
W
W
W
a
a
W
W
W
W
W
W
W
W
a
W
a
a
W
W
H
W
W
W
W
W
W
H
H
H
H
W
W
W
W
W
W
W
W
W
W
W
W
W
W
W
W
W
W
W
W
W
W
W
W
W
W
R
"}
(74,1,1) = {"
R
W
W
W
W
W
W
W
W
W
W
W
W
W
W
W
W
H
W
W
W
a
W
W
W
W
W
a
a
j
a
a
W
W
W
W
W
W
W
W
W
W
W
W
W
W
W
W
W
W
W
W
W
W
W
W
a
W
W
W
W
W
H
H
H
H
H
H
H
H
W
W
W
W
W
W
W
W
W
W
W
W
W
W
W
W
W
W
W
W
W
W
W
W
W
W
W
W
W
R
"}
(75,1,1) = {"
R
W
W
W
W
W
W
W
W
W
W
W
W
W
W
W
W
W
H
W
W
a
W
W
W
W
W
W
W
W
W
a
W
W
W
W
W
W
W
W
W
W
W
W
W
W
W
W
W
W
W
W
W
W
W
W
a
W
W
W
W
W
H
h
W
W
W
W
W
W
W
W
W
W
W
W
W
W
W
W
W
W
W
W
W
W
W
W
W
W
W
W
W
W
W
W
W
W
W
R
"}
(76,1,1) = {"
R
W
W
W
W
W
W
W
W
W
W
W
W
W
W
W
W
W
H
h
W
W
a
a
W
W
W
W
W
W
W
a
W
W
W
W
W
W
a
a
a
W
W
a
a
a
W
W
a
a
a
a
a
a
W
a
a
W
W
W
W
W
H
W
W
W
W
W
W
W
W
W
W
W
W
W
W
W
W
W
W
W
W
W
W
W
W
W
W
W
W
W
W
W
W
W
W
W
W
R
"}
(77,1,1) = {"
R
W
W
W
W
W
W
W
W
W
W
W
W
W
W
W
W
W
W
H
H
W
W
W
W
W
W
W
W
W
W
W
W
W
W
W
W
a
a
a
W
W
W
W
a
W
W
W
W
W
W
W
W
a
W
a
W
W
a
a
W
H
H
W
W
W
W
W
W
W
W
W
W
W
W
W
W
W
W
W
W
W
W
W
W
W
W
W
W
W
W
W
W
W
W
W
W
W
W
R
"}
(78,1,1) = {"
R
W
W
W
W
W
W
W
W
W
W
W
W
W
W
W
W
W
W
W
H
H
H
H
H
H
W
W
W
W
W
W
W
W
W
W
W
W
h
a
W
W
W
W
W
W
W
W
W
W
W
W
W
a
j
a
W
W
W
W
h
H
W
W
W
W
W
W
W
W
W
W
W
W
W
W
W
W
W
W
W
W
W
W
W
W
W
W
W
W
W
W
W
W
W
W
W
W
W
R
"}
(79,1,1) = {"
R
W
W
W
W
W
W
W
W
W
W
W
W
W
W
W
W
W
W
W
W
W
W
W
W
W
H
H
H
H
H
H
H
H
H
H
H
H
H
H
H
H
H
H
W
W
W
W
W
a
W
W
W
W
W
W
W
W
W
W
H
H
W
W
W
W
W
W
W
W
W
W
W
W
W
W
W
W
W
W
W
W
W
W
W
W
W
W
W
W
W
W
W
W
W
W
W
W
W
R
"}
(80,1,1) = {"
R
W
W
W
W
W
W
W
W
W
W
W
W
W
W
W
W
W
W
W
W
W
W
W
W
W
W
W
W
W
W
W
W
W
W
W
W
W
W
W
W
W
W
W
H
H
H
H
H
a
W
W
W
W
W
W
W
W
W
H
H
W
W
W
W
W
W
W
W
W
W
W
W
W
W
W
W
W
W
W
W
W
W
W
W
W
W
W
W
W
W
W
W
W
W
W
W
W
W
R
"}
(81,1,1) = {"
R
W
W
W
W
W
W
W
W
W
W
W
W
W
W
W
W
W
W
W
W
W
W
W
W
W
W
W
W
W
W
W
W
W
W
W
W
W
W
W
W
W
W
W
W
W
W
W
W
H
H
H
H
H
H
H
H
H
H
H
W
W
W
W
W
W
W
W
W
W
W
W
W
W
W
W
W
W
W
W
W
W
W
W
W
W
W
W
W
W
W
W
W
W
W
W
W
W
W
R
"}
(82,1,1) = {"
R
W
W
W
W
W
W
W
W
W
W
W
W
W
W
W
W
W
W
W
W
W
W
W
W
W
W
W
W
W
W
W
W
W
W
W
W
W
W
W
W
W
W
W
W
W
W
W
W
W
W
W
W
W
W
W
W
W
W
W
W
W
W
W
W
W
W
W
W
W
W
W
W
W
W
W
W
W
W
W
W
W
W
W
W
W
W
W
W
W
W
W
W
W
W
W
W
W
W
R
"}
(83,1,1) = {"
R
W
W
W
W
W
W
W
W
W
W
W
W
W
W
W
W
W
W
W
W
W
W
W
W
W
W
W
W
W
W
W
W
W
W
W
W
W
W
W
W
W
W
W
W
W
W
W
W
W
W
W
W
W
W
W
W
W
W
W
W
W
W
W
W
W
W
W
W
W
W
W
W
W
W
W
W
W
W
W
W
W
W
W
W
W
W
W
W
W
W
W
W
W
W
W
W
W
W
R
"}
(84,1,1) = {"
R
W
W
W
W
W
W
W
W
W
W
W
W
W
W
W
W
W
W
W
W
W
W
W
W
W
W
W
W
W
W
W
W
W
W
W
W
W
W
W
W
W
W
W
W
W
W
W
W
W
W
W
W
W
W
W
W
W
W
W
W
W
W
W
W
W
W
W
W
W
W
W
W
W
W
W
W
W
W
W
W
W
W
W
W
W
W
W
W
W
W
W
W
W
W
W
W
W
W
R
"}
(85,1,1) = {"
R
W
W
W
W
W
W
W
W
W
W
W
W
W
W
W
W
W
W
W
W
W
W
W
W
W
W
W
W
W
W
W
W
W
W
W
W
W
W
W
W
W
W
W
W
W
W
W
W
W
W
W
W
W
W
W
W
W
W
W
W
W
W
W
W
W
W
W
W
W
W
W
W
W
W
W
W
W
W
W
W
W
W
W
W
W
W
W
W
W
W
W
W
W
W
W
W
W
W
R
"}
(86,1,1) = {"
R
W
W
W
W
W
W
W
W
W
W
W
W
W
W
W
W
W
W
W
W
W
W
W
W
W
W
W
W
W
W
W
W
W
W
W
W
W
W
W
W
W
W
W
W
W
W
W
W
W
W
W
W
W
W
W
W
W
W
W
W
W
W
W
W
W
W
W
W
W
W
W
W
W
W
W
W
W
W
W
W
W
W
W
W
W
W
W
W
W
W
W
W
W
W
W
W
W
W
R
"}
(87,1,1) = {"
R
W
W
W
W
W
W
W
W
W
W
W
W
W
W
W
W
W
W
W
W
W
W
W
W
W
W
W
W
W
W
W
W
W
W
W
W
W
W
W
W
W
W
W
W
W
W
W
W
W
W
W
W
W
W
W
W
W
W
W
W
W
W
W
W
W
W
W
W
W
W
W
W
W
W
W
W
W
W
W
W
W
W
W
W
W
W
W
W
W
W
W
W
W
W
W
W
W
W
R
"}
(88,1,1) = {"
R
W
W
W
W
W
W
W
W
W
W
W
W
W
W
W
W
W
W
W
W
W
W
W
W
W
W
W
W
W
W
W
W
W
W
W
W
W
W
W
W
W
W
W
W
W
W
W
W
W
W
W
W
W
W
W
W
W
W
W
W
W
W
W
W
W
W
W
W
W
W
W
W
W
W
W
W
W
W
W
W
W
W
W
W
W
W
W
W
W
W
W
W
W
W
W
W
W
W
R
"}
(89,1,1) = {"
R
W
W
W
W
W
W
W
W
W
W
W
W
W
W
W
W
W
W
W
W
W
W
W
W
W
W
W
W
W
W
W
W
W
W
W
W
W
W
W
W
W
W
W
W
W
W
W
W
W
W
W
W
W
W
W
W
W
W
W
W
W
W
W
W
W
W
W
W
W
W
W
W
W
W
W
W
W
W
W
W
W
W
W
W
W
W
W
W
W
W
W
W
W
W
W
W
W
W
R
"}
(90,1,1) = {"
R
W
W
W
W
W
W
W
W
W
W
W
W
W
W
W
W
W
W
W
W
W
W
W
W
W
W
W
W
W
W
W
W
W
W
W
W
W
W
W
W
W
W
W
W
W
W
W
W
W
W
W
W
W
W
W
W
W
W
W
W
W
W
W
W
W
W
W
W
W
W
W
W
W
W
W
W
W
W
W
W
W
W
W
W
W
W
W
W
W
W
W
W
W
W
W
W
W
W
R
"}
(91,1,1) = {"
R
W
W
W
W
W
W
W
W
W
W
W
W
W
W
W
W
W
W
W
W
W
W
W
W
W
W
W
W
W
W
W
W
W
W
W
W
W
W
W
W
W
W
W
W
W
W
W
W
W
W
W
W
W
W
W
W
W
W
W
W
W
W
W
W
W
W
W
W
W
W
W
W
W
W
W
W
W
W
W
W
W
W
W
W
W
W
W
W
W
W
W
W
W
W
W
W
W
W
R
"}
(92,1,1) = {"
R
W
W
W
W
W
W
W
W
W
W
W
W
W
W
W
W
W
W
W
W
W
W
W
W
W
W
W
W
W
W
W
W
W
W
W
W
W
W
W
W
W
W
W
W
W
W
W
W
W
W
W
W
W
W
W
W
W
W
W
W
W
W
W
W
W
W
W
W
W
W
W
W
W
W
W
W
W
W
W
W
W
W
W
W
W
W
W
W
W
W
W
W
W
W
W
W
W
W
R
"}
(93,1,1) = {"
R
W
W
W
W
W
W
W
W
W
W
W
W
W
W
W
W
W
W
W
W
W
W
W
W
W
W
W
W
W
W
W
W
W
W
W
W
W
W
W
W
W
W
W
W
W
W
W
W
W
W
W
W
W
W
W
W
W
W
W
W
W
W
W
W
W
W
W
W
W
W
W
W
W
W
W
W
W
W
W
W
W
W
W
W
W
W
W
W
W
W
W
W
W
W
W
W
W
W
R
"}
(94,1,1) = {"
R
W
W
W
W
W
W
W
W
W
W
W
W
W
W
W
W
W
W
W
W
W
W
W
W
W
W
W
W
W
W
W
W
W
W
W
W
W
W
W
W
W
W
W
W
W
W
W
W
W
W
W
W
W
W
W
W
W
W
W
W
W
W
W
W
W
W
W
W
W
W
W
W
W
W
W
W
W
W
W
W
W
W
W
W
W
W
W
W
W
W
W
W
W
W
W
W
W
W
R
"}
(95,1,1) = {"
R
W
W
W
W
W
W
W
W
W
W
W
W
W
W
W
W
W
W
W
W
W
W
W
W
W
W
W
W
W
W
W
W
W
W
W
W
W
W
W
W
W
W
W
W
W
W
W
W
W
W
W
W
W
W
W
W
W
W
W
W
W
W
W
W
W
W
W
W
W
W
W
W
W
W
W
W
W
W
W
W
W
W
W
W
W
W
W
W
W
W
W
W
W
W
W
W
W
W
R
"}
(96,1,1) = {"
R
W
W
W
W
W
W
W
W
W
W
W
W
W
W
W
W
W
W
W
W
W
W
W
W
W
W
W
W
W
W
W
W
W
W
W
W
W
W
W
W
W
W
W
W
W
W
W
W
W
W
W
W
W
W
W
W
W
W
W
W
W
W
W
W
W
W
W
W
W
W
W
W
W
W
W
W
W
W
W
W
W
W
W
W
W
W
W
W
W
W
W
W
W
W
W
W
W
W
R
"}
(97,1,1) = {"
R
W
W
W
W
W
W
W
W
W
W
W
W
W
W
W
W
W
W
W
W
W
W
W
W
W
W
W
W
W
W
W
W
W
W
W
W
W
W
W
W
W
W
W
W
W
W
W
W
W
W
W
W
W
W
W
W
W
W
W
W
W
W
W
W
W
W
W
W
W
W
W
W
W
W
W
W
W
W
W
W
W
W
W
W
W
W
W
W
W
W
W
W
W
W
W
W
W
W
R
"}
(98,1,1) = {"
R
W
W
W
W
W
W
W
W
W
W
W
W
W
W
W
W
W
W
W
W
W
W
W
W
W
W
W
W
W
W
W
W
W
W
W
W
W
W
W
W
W
W
W
W
W
W
W
W
W
W
W
W
W
W
W
W
W
W
W
W
W
W
W
W
W
W
W
W
W
W
W
W
W
W
W
W
W
W
W
W
W
W
W
W
W
W
W
W
W
W
W
W
W
W
W
W
W
W
R
"}
(99,1,1) = {"
R
W
W
W
W
W
W
W
W
W
W
W
W
W
W
W
W
W
W
W
W
W
W
W
W
W
W
W
W
W
W
W
W
W
W
W
W
W
W
W
W
W
W
W
W
W
W
W
W
W
W
W
W
W
W
W
W
W
W
W
W
W
W
W
W
W
W
W
W
W
W
W
W
W
W
W
W
W
W
W
W
W
W
W
W
W
W
W
W
W
W
W
W
W
W
W
W
W
W
R
"}
(100,1,1) = {"
R
R
R
R
R
R
R
R
R
R
R
R
R
R
R
R
R
R
R
R
R
R
R
R
R
R
R
R
R
R
R
R
R
R
R
R
R
R
R
R
R
R
R
R
R
R
R
R
R
R
R
R
R
R
R
R
R
R
R
R
R
R
R
R
R
R
R
R
R
R
R
R
R
R
R
R
R
R
R
R
R
R
R
R
R
R
R
R
R
R
R
R
R
R
R
R
R
R
R
R
"}
