//MAP CONVERTED BY dmm2tgm.py THIS HEADER COMMENT PREVENTS RECONVERSION, DO NOT REMOVE
"a" = (
/obj/effect/decal/cleanable/vomit,
/turf/template_noop,
/area/template_noop)
"c" = (
/obj/structure/sign/banners/happybirthdaysteve,
/obj/structure/prop/souto_land/pole{
	pixel_x = 6
	},
/turf/template_noop,
/area/template_noop)
"d" = (
/obj/structure/bed/chair/wood/normal,
/turf/template_noop,
/area/template_noop)
"k" = (
/turf/template_noop,
/area/template_noop)
"l" = (
/obj/item/weapon/melee/broken_bottle{
	pixel_x = -5;
	pixel_y = -6
	},
/turf/template_noop,
/area/template_noop)
"n" = (
/obj/structure/bed/chair/wood/normal{
	dir = 1
	},
/turf/template_noop,
/area/template_noop)
"o" = (
/obj/structure/bed/chair/wood/normal{
	dir = 4;
	pixel_y = 12
	},
/turf/template_noop,
/area/template_noop)
"p" = (
/obj/structure/surface/table/woodentable/poor,
/obj/item/trash/plate,
/obj/item/trash/plate{
	pixel_y = 14
	},
/turf/template_noop,
/area/template_noop)
"r" = (
/obj/structure/bed/chair/wood/normal{
	dir = 8;
	tag = null
	},
/turf/template_noop,
/area/template_noop)
"t" = (
/obj/item/weapon/melee/broken_bottle{
	pixel_x = 5;
	pixel_y = 2
	},
/turf/template_noop,
/area/template_noop)
"w" = (
/obj/structure/bed/chair/wood/normal{
	pixel_y = 17
	},
/turf/template_noop,
/area/template_noop)
"y" = (
/obj/item/reagent_container/food/drinks/bottle/gin,
/turf/template_noop,
/area/template_noop)
"z" = (
/obj/structure/surface/table/woodentable/poor,
/obj/item/reagent_container/food/drinks/bottle/pwine{
	pixel_y = 10
	},
/obj/item/reagent_container/food/drinks/drinkingglass{
	pixel_x = -8;
	pixel_y = 4
	},
/turf/template_noop,
/area/template_noop)
"B" = (
/obj/structure/prop/souto_land/pole{
	dir = 1;
	pixel_x = -5
	},
/turf/template_noop,
/area/template_noop)
"E" = (
/obj/structure/surface/table/woodentable/poor,
/obj/item/reagent_container/food/snacks/sliceable/birthdaycake{
	pixel_y = 6
	},
/turf/template_noop,
/area/template_noop)
"L" = (
/obj/structure/surface/table/woodentable/poor,
/obj/item/reagent_container/food/drinks/drinkingglass{
	pixel_x = 4;
	pixel_y = 5
	},
/obj/item/reagent_container/food/drinks/drinkingglass{
	pixel_x = -6;
	pixel_y = 14
	},
/turf/template_noop,
/area/template_noop)
"P" = (
/obj/effect/landmark/crap_item,
/turf/template_noop,
/area/template_noop)
"Q" = (
/obj/structure/bed/chair/wood/normal{
	pixel_y = 11
	},
/turf/template_noop,
/area/template_noop)
"U" = (
/obj/structure/bed/chair/wood/normal{
	dir = 4;
	pixel_x = -10;
	tag = null
	},
/turf/template_noop,
/area/template_noop)
"W" = (
/obj/structure/bed/chair/wood/normal{
	dir = 4;
	pixel_x = 9
	},
/turf/template_noop,
/area/template_noop)

(1,1,1) = {"
k
w
W
k
a
"}
(2,1,1) = {"
k
z
L
l
P
"}
(3,1,1) = {"
P
U
r
k
y
"}
(4,1,1) = {"
c
t
o
E
n
"}
(5,1,1) = {"
k
k
d
p
Q
"}
(6,1,1) = {"
B
k
k
k
k
"}
