//MAP CONVERTED BY dmm2tgm.py THIS HEADER COMMENT PREVENTS RECONVERSION, DO NOT REMOVE
"a" = (
/obj/structure/barricade/wooden,
/turf/open/floor/prison/floor_plate,
/area/template_noop)
"b" = (
/obj/item/reagent_container/food/drinks/bottle/gin{
	pixel_y = -6;
	pixel_x = -9
	},
/turf/open/floor/prison/floor_plate,
/area/template_noop)
"e" = (
/obj/effect/landmark/corpsespawner/prison_security,
/obj/item/clothing/head/cakehat{
	pixel_x = -10
	},
/turf/open/floor/prison/floor_plate,
/area/template_noop)
"h" = (
/obj/structure/surface/table/woodentable/poor,
/obj/item/reagent_container/food/drinks/bottle/pwine{
	pixel_y = 15;
	pixel_x = 6
	},
/obj/item/reagent_container/food/drinks/drinkingglass{
	pixel_x = -1;
	pixel_y = 10
	},
/turf/open/floor/prison/floor_plate,
/area/template_noop)
"i" = (
/obj/structure/barricade/wooden{
	dir = 1
	},
/turf/open/floor/prison/floor_plate,
/area/template_noop)
"o" = (
/obj/structure/machinery/light/double/blue{
	dir = 1;
	pixel_y = 21
	},
/obj/structure/barricade/wooden{
	dir = 8
	},
/turf/open/floor/prison/floor_plate,
/area/template_noop)
"s" = (
/obj/item/weapon/broken_bottle{
	pixel_x = 5;
	pixel_y = 2
	},
/turf/open/floor/prison/floor_plate,
/area/template_noop)
"u" = (
/turf/closed/wall/prison,
/area/template_noop)
"A" = (
/obj/structure/machinery/light/double/blue{
	pixel_y = -1
	},
/obj/structure/barricade/wooden{
	dir = 4
	},
/turf/open/floor/prison/floor_plate,
/area/template_noop)
"B" = (
/obj/structure/machinery/light/double/blue{
	dir = 1;
	pixel_y = 21
	},
/turf/open/floor/prison/floor_plate,
/area/template_noop)
"C" = (
/turf/open/floor/prison/floor_plate,
/area/template_noop)
"E" = (
/obj/structure/surface/table/woodentable/poor,
/obj/item/trash/plate{
	pixel_y = 14;
	pixel_x = 1
	},
/turf/open/floor/prison/floor_plate,
/area/template_noop)
"G" = (
/obj/structure/surface/table/woodentable/poor,
/obj/item/reagent_container/food/drinks/drinkingglass{
	pixel_x = 4;
	pixel_y = 11
	},
/obj/item/reagent_container/food/drinks/drinkingglass{
	pixel_x = -3;
	pixel_y = 2
	},
/turf/open/floor/prison/floor_plate,
/area/template_noop)
"H" = (
/obj/effect/decal/cleanable/vomit,
/turf/open/floor/prison/floor_plate,
/area/template_noop)
"K" = (
/obj/structure/prop/souto_land/pole{
	dir = 1;
	pixel_x = 10;
	pixel_y = 16
	},
/turf/open/floor/prison/floor_plate,
/area/template_noop)
"L" = (
/obj/structure/surface/table/woodentable/poor,
/obj/item/reagent_container/food/snacks/sliceable/birthdaycake{
	pixel_y = 23;
	pixel_x = 15
	},
/obj/item/trash/plate{
	pixel_y = 2;
	pixel_x = 2
	},
/turf/open/floor/prison/floor_plate,
/area/template_noop)
"N" = (
/obj/item/stack/sheet/wood{
	amount = 10
	},
/turf/open/floor/prison/floor_plate,
/area/template_noop)
"P" = (
/obj/structure/barricade/wooden{
	dir = 4
	},
/turf/open/floor/prison/floor_plate,
/area/template_noop)
"U" = (
/obj/structure/prop/souto_land/pole{
	pixel_x = 16;
	pixel_y = 17
	},
/obj/structure/sign/banners/happybirthdaysteve{
	pixel_x = 12;
	pixel_y = 19
	},
/obj/item/weapon/broken_bottle{
	pixel_x = 8;
	pixel_y = 1
	},
/turf/open/floor/prison/floor_plate,
/area/template_noop)
"Y" = (
/obj/structure/machinery/light/double/blue{
	pixel_y = -1
	},
/obj/structure/barricade/wooden{
	dir = 8
	},
/turf/open/floor/prison/floor_plate,
/area/template_noop)
"Z" = (
/obj/structure/barricade/wooden{
	dir = 8
	},
/turf/open/floor/prison/floor_plate,
/area/template_noop)

(1,1,1) = {"
u
o
Z
Z
Y
u
"}
(2,1,1) = {"
i
U
H
e
b
a
"}
(3,1,1) = {"
i
C
h
L
C
a
"}
(4,1,1) = {"
i
K
E
G
C
a
"}
(5,1,1) = {"
i
C
C
C
s
a
"}
(6,1,1) = {"
u
B
P
N
A
u
"}
