//MAP CONVERTED BY dmm2tgm.py THIS HEADER COMMENT PREVENTS RECONVERSION, DO NOT REMOVE
"a" = (
/turf/closed/wall/r_wall/prison,
/area/template_noop)
"b" = (
/obj/effect/decal/cleanable/blood,
/turf/open/floor/prison,
/area/template_noop)
"c" = (
/turf/open/floor/prison,
/area/template_noop)
"d" = (
/obj/structure/closet/secure_closet/guncabinet{
	req_access = null
	},
/obj/item/clothing/under/color/orange,
/turf/open/floor/prison/redfull,
/area/template_noop)
"e" = (
/turf/closed/wall/prison,
/area/template_noop)
"g" = (
/obj/effect/landmark/objective_landmark/close,
/turf/open/floor/prison/floor_plate,
/area/template_noop)
"i" = (
/obj/structure/machinery/door/airlock/almayer/maint/colony/autoname{
	dir = 1;
	req_one_access = null
	},
/turf/open/floor/plating/prison,
/area/template_noop)
"k" = (
/obj/structure/closet/secure_closet/guncabinet{
	req_access = null
	},
/obj/item/clothing/shoes/galoshes{
	pixel_y = -6
	},
/turf/open/floor/prison/redfull,
/area/template_noop)
"l" = (
/obj/structure/closet/secure_closet/guncabinet{
	req_access = null
	},
/obj/item/clothing/shoes/dress/commander{
	pixel_y = -9
	},
/turf/open/floor/prison/redfull,
/area/template_noop)
"m" = (
/obj/structure/closet/secure_closet/security_empty,
/obj/structure/window/reinforced{
	dir = 8
	},
/obj/item/storage/box/flashbangs,
/turf/open/floor/prison/redfull,
/area/template_noop)
"n" = (
/obj/item/stack/folding_barricade,
/turf/open/floor/prison/floor_plate,
/area/template_noop)
"r" = (
/obj/structure/reagent_dispensers/water_cooler,
/turf/open/floor/prison/redfull,
/area/template_noop)
"s" = (
/obj/structure/machinery/power/apc/power/east,
/turf/open/floor/prison,
/area/template_noop)
"t" = (
/obj/structure/window/reinforced,
/turf/open/floor/prison,
/area/template_noop)
"u" = (
/obj/structure/closet/secure_closet/security_empty,
/obj/item/clothing/accessory/storage/holster,
/obj/structure/window/reinforced{
	dir = 4
	},
/turf/open/floor/prison/redfull,
/area/template_noop)
"v" = (
/obj/item/clothing/under/color/orange,
/turf/open/floor/prison,
/area/template_noop)
"w" = (
/obj/structure/bed/chair{
	dir = 1
	},
/obj/effect/decal/cleanable/blood,
/turf/open/floor/prison/floor_plate,
/area/template_noop)
"x" = (
/obj/effect/decal/cleanable/blood/oil,
/turf/open/floor/prison,
/area/template_noop)
"y" = (
/turf/open/floor/prison/floor_plate,
/area/template_noop)
"z" = (
/obj/item/clothing/shoes/black{
	pixel_x = -1;
	pixel_y = -17
	},
/obj/effect/decal/cleanable/blood/oil/streak,
/turf/open/floor/prison,
/area/template_noop)
"B" = (
/obj/item/tool/kitchen/knife{
	pixel_x = -7;
	pixel_y = -15
	},
/turf/open/floor/prison/floor_plate,
/area/template_noop)
"C" = (
/obj/structure/machinery/light/double/blue{
	dir = 1;
	pixel_y = 21
	},
/turf/open/floor/prison,
/area/template_noop)
"D" = (
/obj/effect/decal/cleanable/blood/oil/streak,
/turf/open/floor/prison,
/area/template_noop)
"E" = (
/obj/structure/window/reinforced{
	dir = 8
	},
/obj/structure/window/reinforced,
/turf/open/floor/prison,
/area/template_noop)
"F" = (
/obj/item/prop/helmetgarb/riot_shield,
/obj/effect/decal/cleanable/blood,
/turf/open/floor/prison/floor_plate,
/area/template_noop)
"I" = (
/obj/structure/closet/secure_closet/guncabinet{
	req_access = null
	},
/obj/effect/spawner/random/gun/pistol/lowchance,
/turf/open/floor/prison/redfull,
/area/template_noop)
"J" = (
/obj/structure/window/reinforced{
	dir = 8
	},
/turf/open/floor/prison,
/area/template_noop)
"K" = (
/obj/item/clothing/under/color/orange,
/turf/open/floor/prison/floor_plate,
/area/template_noop)
"L" = (
/obj/structure/window/framed/prison/reinforced,
/turf/open/floor/prison,
/area/template_noop)
"R" = (
/obj/structure/extinguisher_cabinet,
/turf/closed/wall/r_wall/prison,
/area/template_noop)
"S" = (
/obj/structure/surface/table/reinforced/prison,
/obj/structure/flora/pottedplant{
	pixel_y = 9
	},
/obj/structure/machinery/light/double/blue,
/turf/open/floor/prison,
/area/template_noop)
"U" = (
/obj/effect/landmark/corpsespawner/ua_riot,
/turf/open/floor/prison/floor_plate,
/area/template_noop)
"V" = (
/turf/closed/wall/r_wall/prison_unmeltable,
/area/fiorina/oob)
"W" = (
/obj/structure/closet/secure_closet/guncabinet{
	req_access = null
	},
/obj/item/clothing/shoes/black{
	pixel_x = 2;
	pixel_y = -9
	},
/turf/open/floor/prison/redfull,
/area/template_noop)
"X" = (
/obj/item/frame/rack,
/turf/open/floor/prison/redfull,
/area/template_noop)
"Z" = (
/obj/effect/landmark/corpsespawner/ua_riot,
/turf/open/floor/prison,
/area/template_noop)

(1,1,1) = {"
s
S
a
a
R
a
a
C
"}
(2,1,1) = {"
a
a
a
I
d
k
a
a
"}
(3,1,1) = {"
n
K
y
B
y
y
X
a
"}
(4,1,1) = {"
D
z
I
d
r
c
X
a
"}
(5,1,1) = {"
Z
b
J
E
I
v
X
a
"}
(6,1,1) = {"
L
L
V
t
l
c
a
e
"}
(7,1,1) = {"
w
U
i
v
x
v
i
y
"}
(8,1,1) = {"
g
F
V
d
W
I
a
u
"}
(9,1,1) = {"
V
V
V
a
V
V
a
m
"}
