//MAP CONVERTED BY dmm2tgm.py THIS HEADER COMMENT PREVENTS RECONVERSION, DO NOT REMOVE
"aj" = (
/obj/structure/window/framed/prison,
/turf/open/floor/plating/prison,
/area/template_noop)
"az" = (
/obj/structure/bed/chair/comfy{
	dir = 1
	},
/turf/open/floor/wood,
/area/template_noop)
"bD" = (
/obj/effect/decal/cleanable/blood,
/turf/open/floor/wood,
/area/template_noop)
"bO" = (
/obj/item/toy/inflatable_duck,
/turf/open/gm/river/pool,
/area/template_noop)
"cb" = (
/obj/item/trash/barcardine{
	pixel_y = -9;
	pixel_x = -15
	},
/turf/open/floor/wood,
/area/template_noop)
"ci" = (
/obj/item/toy/gun,
/turf/open/floor/wood,
/area/template_noop)
"cj" = (
/obj/item/trash/crushed_cup{
	pixel_y = -7;
	pixel_x = -1
	},
/turf/open/floor/prison/darkbrown2,
/area/template_noop)
"cq" = (
/obj/structure/surface/table/reinforced/prison,
/obj/item/reagent_container/food/drinks/bottle/beer/craft/tuxedo{
	pixel_x = -9;
	pixel_y = 9
	},
/turf/open/floor/wood,
/area/template_noop)
"cK" = (
/obj/structure/platform_decoration/metal/almayer,
/turf/open/floor/prison/darkbrown2,
/area/template_noop)
"cU" = (
/obj/structure/machinery/power/apc/power/south,
/turf/open/floor/wood,
/area/template_noop)
"dB" = (
/turf/open/floor/prison/darkbrown2/northwest,
/area/template_noop)
"ef" = (
/obj/item/toy/beach_ball,
/turf/open/gm/river/pool,
/area/template_noop)
"el" = (
/obj/structure/prop/souto_land/streamer{
	dir = 6
	},
/obj/effect/decal/cleanable/blood/oil/streak,
/turf/open/floor/prison/darkbrown2/north,
/area/template_noop)
"fv" = (
/obj/item/toy/crossbow_ammo{
	pixel_x = -16
	},
/turf/open/floor/prison/darkbrowncorners2/west,
/area/template_noop)
"fL" = (
/obj/structure/grille,
/obj/item/reagent_container/food/snacks/carpmeat{
	pixel_x = -5;
	pixel_y = 13
	},
/obj/item/reagent_container/food/snacks/carpmeat{
	pixel_x = 4;
	pixel_y = 6
	},
/obj/structure/prop/invuln/fire{
	layer = 2.9
	},
/turf/open/floor/prison/darkbrowncorners2/west,
/area/template_noop)
"fN" = (
/obj/structure/platform/metal/almayer/east,
/turf/open/floor/prison/floor_plate,
/area/template_noop)
"fX" = (
/turf/closed/wall/mineral/bone_resin,
/area/template_noop)
"gs" = (
/obj/effect/decal/cleanable/blood,
/turf/open/floor/prison/darkbrown2/west,
/area/template_noop)
"gV" = (
/turf/open/space,
/area/template_noop)
"hf" = (
/turf/open/gm/river/pool,
/area/template_noop)
"hP" = (
/obj/structure/platform/metal/almayer/east,
/turf/open/floor/prison,
/area/template_noop)
"hY" = (
/obj/structure/machinery/light/double/blue{
	dir = 8;
	pixel_x = -10;
	pixel_y = -3
	},
/turf/open/floor/wood,
/area/template_noop)
"ij" = (
/obj/item/toy/crossbow_ammo{
	pixel_y = 18;
	pixel_x = 24;
	layer = 2.5
	},
/turf/open/floor/wood,
/area/template_noop)
"ik" = (
/obj/item/trash/syndi_cakes{
	pixel_x = -13;
	pixel_y = -11
	},
/turf/open/floor/prison/darkbrown2/east,
/area/template_noop)
"is" = (
/obj/structure/platform_decoration/metal/almayer/north,
/turf/open/floor/prison/darkbrown2/southeast,
/area/template_noop)
"iC" = (
/obj/item/tool/mop{
	pixel_x = 11;
	layer = 2.9;
	pixel_y = 3
	},
/obj/item/reagent_container/glass/bucket/mopbucket{
	pixel_x = 9;
	pixel_y = -5
	},
/turf/open/floor/prison/darkbrown2/east,
/area/template_noop)
"iK" = (
/obj/effect/decal/cleanable/blood/oil/streak,
/turf/open/floor/prison/darkbrown2/north,
/area/template_noop)
"iY" = (
/obj/structure/surface/table/reinforced/prison,
/obj/item/reagent_container/food/drinks/cup{
	pixel_x = 6;
	pixel_y = 5
	},
/obj/item/reagent_container/food/drinks/cup{
	pixel_x = 15;
	pixel_y = 5
	},
/turf/open/floor/wood,
/area/template_noop)
"jt" = (
/obj/structure/surface/table/reinforced/prison,
/turf/open/floor/wood,
/area/template_noop)
"jW" = (
/obj/item/trash/crushed_cup{
	pixel_y = 6;
	pixel_x = 6
	},
/turf/open/floor/prison/darkbrown2/east,
/area/template_noop)
"kb" = (
/obj/item/trash/crushed_cup{
	pixel_y = -65;
	pixel_x = 29
	},
/turf/open/gm/river/pool,
/area/template_noop)
"kA" = (
/obj/structure/platform/metal/almayer/north,
/turf/open/floor/prison/floor_plate,
/area/template_noop)
"lc" = (
/obj/structure/surface/table/reinforced/prison,
/obj/item/toy/deck,
/obj/item/toy/dice{
	pixel_x = 11;
	pixel_y = 7
	},
/turf/open/floor/wood,
/area/template_noop)
"lh" = (
/obj/item/trash/cigbutt{
	pixel_x = 31;
	pixel_y = -16
	},
/turf/open/floor/wood,
/area/template_noop)
"ly" = (
/obj/structure/platform_decoration/metal/almayer/west,
/turf/open/floor/prison,
/area/template_noop)
"lS" = (
/obj/structure/surface/table/reinforced/prison,
/obj/item/reagent_container/food/snacks/cheeseburger{
	pixel_x = -6;
	pixel_y = 12
	},
/obj/item/reagent_container/food/snacks/cheeseburger{
	pixel_x = 9;
	pixel_y = 12
	},
/obj/item/reagent_container/food/snacks/cheeseburger{
	pixel_x = 9;
	pixel_y = 1
	},
/obj/item/reagent_container/food/snacks/cheeseburger{
	pixel_x = -6;
	pixel_y = 2
	},
/turf/open/floor/wood,
/area/template_noop)
"mc" = (
/obj/item/trash/kepler{
	pixel_x = 13
	},
/turf/open/floor/prison/darkbrown2/west,
/area/template_noop)
"mj" = (
/obj/structure/prop/souto_land/pole,
/turf/open/floor/prison/darkbrown2,
/area/template_noop)
"mk" = (
/obj/structure/machinery/light/double/blue{
	dir = 1;
	pixel_y = 21
	},
/obj/item/trash/crushed_cup{
	pixel_y = -7;
	pixel_x = 7
	},
/turf/open/floor/wood,
/area/template_noop)
"mq" = (
/turf/open/floor/prison/darkbrowncorners2/north,
/area/template_noop)
"mu" = (
/turf/open/floor/plating/prison,
/area/template_noop)
"nf" = (
/turf/open/floor/wood,
/area/template_noop)
"ng" = (
/obj/item/trash/cigbutt{
	pixel_x = 31;
	pixel_y = -16
	},
/turf/open/floor/prison/darkbrown2/west,
/area/template_noop)
"ni" = (
/turf/closed/wall/prison,
/area/template_noop)
"nS" = (
/obj/structure/prop/souto_land/pole,
/turf/open/floor/wood,
/area/template_noop)
"or" = (
/obj/structure/prop/souto_land/pole{
	dir = 1
	},
/turf/open/floor/wood,
/area/template_noop)
"ou" = (
/obj/structure/platform/metal/almayer,
/turf/open/floor/prison/darkbrown2,
/area/template_noop)
"oL" = (
/obj/structure/lattice,
/turf/open/space,
/area/template_noop)
"pt" = (
/obj/structure/bed/chair/comfy{
	layer = 2.9
	},
/turf/open/floor/wood,
/area/template_noop)
"pB" = (
/obj/structure/stairs/perspective{
	icon_state = "p_stair_sn_full_cap"
	},
/obj/structure/platform/metal/almayer/west,
/turf/open/floor/prison/bright_clean2/southwest,
/area/template_noop)
"pG" = (
/obj/structure/stairs/perspective{
	dir = 8;
	icon_state = "p_stair_ew_full_cap"
	},
/obj/structure/platform/metal/stair_cut/platform_left,
/turf/open/floor/plating/prison,
/area/template_noop)
"pH" = (
/obj/structure/platform_decoration/metal/almayer/east,
/turf/open/floor/prison/darkbrown2/west,
/area/template_noop)
"ql" = (
/obj/item/trash/sosjerky{
	pixel_x = -14;
	pixel_y = -20
	},
/obj/effect/decal/cleanable/blood/oil/streak,
/turf/open/floor/prison/darkbrown2/north,
/area/template_noop)
"qm" = (
/obj/structure/stairs/perspective{
	dir = 4;
	icon_state = "p_stair_full"
	},
/obj/structure/platform/metal/almayer,
/turf/open/floor/plating/prison,
/area/template_noop)
"qG" = (
/obj/item/trash/crushed_cup{
	pixel_y = 16
	},
/obj/item/trash/hotdog{
	pixel_x = 7;
	pixel_y = -8
	},
/obj/item/trash/hotdog{
	pixel_x = -4;
	pixel_y = -11
	},
/obj/item/trash/hotdog{
	pixel_x = 2;
	pixel_y = -2
	},
/turf/open/floor/wood,
/area/template_noop)
"ro" = (
/obj/structure/platform/metal/almayer/west,
/turf/open/floor/prison/floor_plate,
/area/template_noop)
"rp" = (
/obj/item/reagent_container/glass/bucket/janibucket,
/turf/open/floor/prison,
/area/template_noop)
"rq" = (
/obj/item/trash/semki{
	pixel_x = 15
	},
/turf/open/floor/prison/darkbrown2/north,
/area/template_noop)
"rt" = (
/obj/item/trash/crushed_cup{
	pixel_x = -2;
	pixel_y = 36
	},
/turf/open/gm/river/pool,
/area/template_noop)
"rU" = (
/obj/structure/grille,
/obj/item/reagent_container/food/snacks/bearmeat{
	pixel_x = 6;
	pixel_y = 13
	},
/obj/item/reagent_container/food/snacks/meat/human{
	pixel_x = -7;
	pixel_y = 3
	},
/obj/structure/prop/invuln/fire{
	layer = 2.9
	},
/turf/open/floor/prison/darkbrowncorners2,
/area/template_noop)
"rW" = (
/obj/structure/bed/chair/comfy{
	dir = 8
	},
/turf/open/floor/wood,
/area/template_noop)
"so" = (
/obj/item/device/flashlight/lamp/tripod,
/turf/open/floor/wood,
/area/template_noop)
"tb" = (
/obj/item/trash/wy_chips_pepper{
	pixel_x = 18;
	layer = 2.5
	},
/turf/open/floor/wood,
/area/template_noop)
"tw" = (
/obj/item/toy/crossbow_ammo{
	pixel_x = -7;
	pixel_y = -11
	},
/turf/open/floor/wood,
/area/template_noop)
"ty" = (
/obj/structure/platform/metal/almayer/west,
/turf/open/floor/prison,
/area/template_noop)
"tz" = (
/obj/structure/bed/chair/comfy{
	dir = 4
	},
/turf/open/floor/wood,
/area/template_noop)
"tD" = (
/obj/item/trash/plate{
	pixel_x = -9
	},
/turf/open/floor/prison/darkbrowncorners2,
/area/template_noop)
"tM" = (
/obj/effect/decal/cleanable/blood/oil/streak,
/turf/open/floor/prison/darkbrowncorners2/east,
/area/template_noop)
"tT" = (
/obj/effect/decal/cleanable/blood/oil/streak,
/turf/open/floor/wood,
/area/template_noop)
"uw" = (
/obj/structure/platform_decoration/metal/almayer/north,
/turf/open/floor/prison/darkbrowncorners2/west,
/area/template_noop)
"vd" = (
/obj/structure/prop/souto_land/pole,
/obj/structure/prop/souto_land/pole{
	dir = 4;
	pixel_y = 24
	},
/obj/item/toy/plush/barricade{
	pixel_x = 1;
	pixel_y = -9
	},
/obj/effect/decal/cleanable/blood/oil/streak,
/turf/open/floor/prison/darkbrown2/west,
/area/template_noop)
"vf" = (
/obj/structure/platform_decoration/metal/almayer/east,
/turf/open/floor/prison/floor_plate,
/area/template_noop)
"vU" = (
/obj/structure/surface/table/reinforced/prison,
/obj/item/reagent_container/food/snacks/hotdog{
	pixel_x = 6;
	pixel_y = 16
	},
/obj/item/reagent_container/food/snacks/hotdog{
	pixel_x = -7;
	pixel_y = 16
	},
/obj/item/reagent_container/food/snacks/hotdog{
	pixel_x = 6;
	pixel_y = 12
	},
/obj/item/reagent_container/food/snacks/hotdog{
	pixel_x = -7;
	pixel_y = 12
	},
/obj/item/reagent_container/food/snacks/hotdog{
	pixel_x = -7;
	pixel_y = 7
	},
/obj/item/reagent_container/food/snacks/hotdog{
	pixel_x = 6;
	pixel_y = 7
	},
/obj/item/reagent_container/food/snacks/hotdog{
	pixel_x = -7;
	pixel_y = 2
	},
/obj/item/reagent_container/food/snacks/hotdog{
	pixel_x = 6;
	pixel_y = 2
	},
/turf/open/floor/wood,
/area/template_noop)
"vX" = (
/obj/structure/surface/table/reinforced/prison,
/obj/structure/machinery/light/double/blue{
	dir = 4;
	pixel_x = 10;
	pixel_y = 13
	},
/obj/structure/prop/souto_land/pole{
	dir = 1
	},
/obj/structure/prop/souto_land/streamer{
	dir = 9
	},
/obj/item/tool/hand_labeler{
	pixel_x = -5;
	pixel_y = 7
	},
/turf/open/floor/wood,
/area/template_noop)
"wS" = (
/turf/open/floor/prison/darkbrown2/southeast,
/area/template_noop)
"wV" = (
/obj/structure/platform/metal/almayer/north,
/obj/structure/machinery/light/double/blue{
	dir = 1;
	pixel_y = 21
	},
/turf/open/floor/prison/floor_plate,
/area/template_noop)
"xz" = (
/obj/structure/prop/souto_land/streamer{
	dir = 9
	},
/turf/open/floor/wood,
/area/template_noop)
"xQ" = (
/obj/item/reagent_container/food/drinks/cans/beer,
/turf/open/floor/prison/darkbrown2,
/area/template_noop)
"xS" = (
/obj/structure/platform/metal/almayer/north,
/obj/structure/machinery/light/double/blue{
	dir = 1;
	pixel_y = 21
	},
/turf/open/floor/wood,
/area/template_noop)
"yx" = (
/obj/effect/decal/cleanable/blood/oil/streak,
/turf/open/floor/prison/darkbrown2/west,
/area/template_noop)
"yL" = (
/obj/structure/stairs/perspective{
	dir = 4;
	icon_state = "p_stair_sn_full_cap"
	},
/obj/structure/platform/metal/almayer/east,
/turf/open/floor/plating/prison,
/area/template_noop)
"zc" = (
/obj/structure/stairs/perspective{
	dir = 4;
	icon_state = "p_stair_full"
	},
/obj/structure/platform/metal/almayer,
/turf/open/floor/prison/darkbrown2,
/area/template_noop)
"zR" = (
/obj/item/trash/cigbutt{
	pixel_x = 10;
	pixel_y = -11
	},
/turf/open/floor/wood,
/area/template_noop)
"Aj" = (
/obj/item/device/flashlight/lamp/tripod,
/turf/open/floor/prison,
/area/template_noop)
"Ao" = (
/obj/structure/surface/table/reinforced/prison,
/obj/structure/machinery/light/double/blue{
	dir = 4;
	pixel_x = 10;
	pixel_y = -3
	},
/turf/open/floor/wood,
/area/template_noop)
"Bf" = (
/obj/structure/window/framed/prison/reinforced/hull,
/turf/open/floor/plating/prison,
/area/template_noop)
"Bj" = (
/obj/effect/landmark/survivor_spawner,
/turf/open/floor/prison/darkbrown2,
/area/template_noop)
"Bm" = (
/obj/structure/prop/souto_land/pole{
	dir = 1
	},
/obj/structure/prop/souto_land/pole{
	dir = 8;
	pixel_y = 24
	},
/obj/item/toy/plush/barricade{
	pixel_x = -3;
	pixel_y = -9
	},
/turf/open/floor/prison/darkbrown2/east,
/area/template_noop)
"Bv" = (
/obj/structure/prop/souto_land/streamer{
	dir = 9
	},
/obj/item/toy/gun_ammo{
	pixel_y = 66
	},
/turf/open/floor/wood,
/area/template_noop)
"BK" = (
/obj/structure/prop/souto_land/pole,
/obj/structure/prop/souto_land/streamer{
	dir = 6
	},
/turf/open/floor/wood,
/area/template_noop)
"BY" = (
/obj/structure/surface/table/reinforced/prison,
/obj/item/reagent_container/food/drinks/bottle/beer/craft/mono{
	pixel_x = 6;
	pixel_y = 5;
	layer = 3.1
	},
/obj/item/toy/plush/farwa{
	pixel_x = -5;
	pixel_y = 4
	},
/obj/item/trash/cigbutt{
	pixel_x = -6;
	pixel_y = 11
	},
/turf/open/floor/wood,
/area/template_noop)
"Ci" = (
/obj/structure/surface/table/reinforced/prison,
/obj/item/storage/beer_pack{
	pixel_y = 5;
	layer = 4
	},
/turf/open/floor/wood,
/area/template_noop)
"Cq" = (
/obj/item/toy/crossbow_ammo{
	pixel_x = -17;
	pixel_y = 41
	},
/turf/open/floor/prison/darkbrown2/north,
/area/template_noop)
"Cx" = (
/obj/item/weapon/baseballbat/metal,
/turf/open/floor/wood,
/area/template_noop)
"Dd" = (
/obj/item/trash/crushed_cup{
	pixel_x = -20
	},
/turf/open/gm/river/pool,
/area/template_noop)
"DN" = (
/obj/structure/platform_decoration/metal/almayer,
/turf/open/floor/prison/darkbrowncorners2,
/area/template_noop)
"DT" = (
/obj/structure/platform/metal/almayer,
/turf/open/gm/river/pool,
/area/template_noop)
"Fj" = (
/obj/structure/platform_decoration/metal/almayer/west,
/turf/open/floor/wood,
/area/template_noop)
"Fl" = (
/obj/structure/closet/crate/trashcart,
/obj/item/storage/pill_bottle/kelotane/skillless,
/obj/effect/landmark/objective_landmark/close,
/turf/open/floor/prison,
/area/template_noop)
"Fo" = (
/turf/open/floor/prison/darkbrown2/east,
/area/template_noop)
"Fy" = (
/turf/closed/wall/r_wall/prison_unmeltable,
/area/template_noop)
"Fz" = (
/obj/structure/prop/souto_land/streamer{
	dir = 9
	},
/turf/open/floor/prison/darkbrown2/north,
/area/template_noop)
"FD" = (
/obj/structure/surface/table/reinforced/prison,
/obj/item/toy/plush/therapy/blue{
	pixel_y = 4
	},
/obj/item/reagent_container/food/drinks/bottle/whiskey{
	pixel_x = 10;
	pixel_y = 4
	},
/obj/item/clothing/head/bowlerhat{
	pixel_y = 16;
	layer = 3.1
	},
/turf/open/floor/wood,
/area/template_noop)
"FN" = (
/obj/item/toy/crossbow{
	pixel_x = 11;
	pixel_y = -8
	},
/turf/open/floor/prison/darkbrown2,
/area/template_noop)
"Gi" = (
/obj/structure/stairs/perspective{
	dir = 4;
	icon_state = "p_stair_full"
	},
/turf/open/floor/plating/prison,
/area/template_noop)
"Gp" = (
/obj/effect/landmark/objective_landmark/medium,
/obj/structure/surface/table/reinforced/prison,
/obj/item/trash/plate{
	pixel_x = -7
	},
/obj/item/trash/plate{
	pixel_x = -7;
	pixel_y = 4
	},
/obj/item/trash/plate{
	pixel_x = -7;
	pixel_y = 9
	},
/obj/item/trash/plate{
	pixel_x = 7
	},
/obj/item/trash/plate{
	pixel_x = 7;
	pixel_y = 4
	},
/obj/item/trash/plate{
	pixel_x = 7;
	pixel_y = 9
	},
/turf/open/floor/wood,
/area/template_noop)
"Gu" = (
/obj/item/trash/crushed_cup{
	pixel_y = -2;
	pixel_x = -12
	},
/turf/open/floor/prison/darkbrown2/east,
/area/template_noop)
"GO" = (
/obj/item/toy/crossbow_ammo{
	pixel_y = -14;
	pixel_x = -15
	},
/turf/open/floor/prison/darkbrown2/north,
/area/template_noop)
"Hn" = (
/obj/structure/platform/metal/almayer/north,
/obj/structure/platform/metal/almayer/east,
/obj/structure/platform_decoration/metal/almayer/northwest,
/turf/open/floor/prison/floor_plate,
/area/template_noop)
"HP" = (
/obj/structure/prop/souto_land/streamer{
	dir = 6
	},
/obj/item/trash/crushed_cup{
	pixel_y = 3;
	pixel_x = -4
	},
/turf/open/floor/wood,
/area/template_noop)
"ID" = (
/obj/item/trash/crushed_cup{
	pixel_y = -6;
	pixel_x = -8
	},
/turf/open/floor/prison/darkbrown2/east,
/area/template_noop)
"IU" = (
/obj/effect/decal/cleanable/blood/oil,
/turf/open/floor/wood,
/area/template_noop)
"Jf" = (
/obj/structure/surface/table/reinforced/prison,
/obj/item/reagent_container/food/drinks/cup{
	pixel_x = -17;
	pixel_y = -21
	},
/obj/item/reagent_container/food/drinks/bottle/beer/craft/tazhushka{
	pixel_x = 10;
	pixel_y = 20
	},
/turf/open/floor/wood,
/area/template_noop)
"Jr" = (
/turf/open/floor/prison/darkbrowncorners2/east,
/area/template_noop)
"Jw" = (
/obj/structure/machinery/light/double/blue{
	dir = 1;
	pixel_y = 21
	},
/turf/open/floor/wood,
/area/template_noop)
"JQ" = (
/obj/item/clipboard,
/turf/open/floor/prison,
/area/template_noop)
"JR" = (
/obj/effect/decal/cleanable/blood/oil,
/turf/open/floor/prison/darkbrown2/east,
/area/template_noop)
"Ke" = (
/obj/item/toy/crossbow_ammo{
	pixel_x = 19;
	pixel_y = 9
	},
/turf/open/floor/prison/darkbrown2,
/area/template_noop)
"Kx" = (
/turf/open/floor/prison/floor_plate,
/area/template_noop)
"KL" = (
/obj/structure/surface/table/reinforced/prison,
/obj/item/reagent_container/food/drinks/cup{
	pixel_x = -8;
	pixel_y = 5
	},
/obj/item/reagent_container/food/drinks/cup{
	pixel_x = -12;
	pixel_y = -1
	},
/obj/item/reagent_container/food/drinks/cup{
	pixel_x = -21;
	pixel_y = -1
	},
/obj/item/reagent_container/food/drinks/cup{
	pixel_x = -16;
	pixel_y = -6
	},
/turf/open/floor/wood,
/area/template_noop)
"KM" = (
/obj/effect/decal/cleanable/blood,
/turf/open/floor/prison/darkbrown2/east,
/area/template_noop)
"KO" = (
/obj/structure/surface/table/reinforced/prison,
/obj/item/reagent_container/food/drinks/cup{
	pixel_x = -8;
	layer = 3.2
	},
/obj/item/reagent_container/food/drinks/cup{
	pixel_x = -13;
	pixel_y = 6;
	layer = 3.1
	},
/turf/open/floor/wood,
/area/template_noop)
"La" = (
/obj/structure/platform/metal/almayer/north,
/turf/open/gm/river/pool,
/area/template_noop)
"Ls" = (
/obj/structure/surface/table/reinforced/prison,
/obj/structure/prop/souto_land/pole{
	dir = 1
	},
/obj/structure/prop/souto_land/streamer{
	dir = 9
	},
/turf/open/floor/wood,
/area/template_noop)
"LI" = (
/obj/structure/surface/table/reinforced/prison,
/obj/item/reagent_container/food/drinks/cans/beer{
	pixel_y = 11;
	pixel_x = 9
	},
/obj/item/reagent_container/food/drinks/cans/beer{
	pixel_y = 11;
	pixel_x = 1
	},
/obj/item/reagent_container/food/drinks/cans/beer{
	pixel_y = 11;
	pixel_x = -7
	},
/obj/item/reagent_container/food/drinks/cans/beer{
	pixel_y = 4;
	pixel_x = 9
	},
/obj/item/reagent_container/food/drinks/cans/beer{
	pixel_y = 4;
	pixel_x = 1
	},
/obj/item/reagent_container/food/drinks/cans/beer{
	pixel_y = 4;
	pixel_x = -7
	},
/turf/open/floor/wood,
/area/template_noop)
"LW" = (
/obj/structure/platform_decoration/metal/almayer/west,
/turf/open/floor/prison/darkbrown2/east,
/area/template_noop)
"Mn" = (
/obj/structure/platform/metal/almayer,
/obj/structure/platform/metal/almayer/west,
/obj/structure/platform_decoration/metal/almayer/southwest,
/turf/open/floor/prison/floor_plate,
/area/template_noop)
"MS" = (
/obj/structure/platform/metal/almayer,
/obj/structure/platform/metal/almayer/east,
/obj/structure/platform_decoration/metal/almayer/southeast,
/turf/open/floor/prison/floor_plate,
/area/template_noop)
"ND" = (
/turf/open/floor/prison/darkbrown2/northeast,
/area/template_noop)
"NQ" = (
/obj/effect/decal/cleanable/blood,
/turf/open/floor/prison/darkbrown2/southwest,
/area/template_noop)
"Oz" = (
/obj/item/trash/crushed_cup{
	pixel_y = 5;
	pixel_x = 11
	},
/turf/open/gm/river/pool,
/area/template_noop)
"PA" = (
/obj/structure/platform_decoration/metal/almayer/east,
/turf/open/floor/prison/darkbrown2/northeast,
/area/template_noop)
"PR" = (
/obj/item/device/flashlight/lamp/tripod,
/turf/open/floor/prison/darkbrowncorners2,
/area/template_noop)
"Qn" = (
/turf/open/floor/prison,
/area/template_noop)
"QF" = (
/turf/open/floor/prison/darkbrowncorners2/west,
/area/template_noop)
"QO" = (
/obj/effect/decal/cleanable/blood/oil,
/turf/open/floor/prison/darkbrown2,
/area/template_noop)
"Rg" = (
/obj/structure/prop/souto_land/pole{
	dir = 1
	},
/turf/open/floor/prison/darkbrown2,
/area/template_noop)
"Ro" = (
/obj/item/toy/bikehorn/rubberducky{
	pixel_x = -2;
	pixel_y = -15
	},
/turf/open/gm/river/pool,
/area/template_noop)
"Rr" = (
/obj/structure/stairs/perspective{
	dir = 8;
	icon_state = "p_stair_full"
	},
/turf/open/floor/plating/prison,
/area/template_noop)
"Rs" = (
/turf/open/floor/prison/darkbrown2,
/area/template_noop)
"RW" = (
/obj/structure/surface/table/reinforced/prison,
/obj/item/reagent_container/food/drinks/cup{
	pixel_x = 6;
	layer = 3.2
	},
/obj/item/reagent_container/food/drinks/cup{
	pixel_x = 15;
	layer = 3.2
	},
/obj/item/reagent_container/food/drinks/cup{
	pixel_x = 11;
	pixel_y = 6;
	layer = 3.1
	},
/turf/open/floor/wood,
/area/template_noop)
"Sg" = (
/obj/effect/decal/cleanable/blood,
/turf/open/floor/prison/darkbrowncorners2/north,
/area/template_noop)
"SC" = (
/obj/effect/landmark/corpsespawner/ua_riot/burst,
/turf/open/floor/prison/darkbrown2/north,
/area/template_noop)
"SO" = (
/obj/structure/machinery/light/double/blue{
	dir = 8;
	pixel_x = -10;
	pixel_y = 13
	},
/obj/structure/prop/souto_land/pole,
/obj/structure/prop/souto_land/streamer{
	dir = 6
	},
/obj/item/trash/cigbutt{
	pixel_x = 31;
	pixel_y = -16
	},
/turf/open/floor/wood,
/area/template_noop)
"SW" = (
/obj/structure/stairs/perspective{
	dir = 1;
	icon_state = "p_stair_sn_full_cap"
	},
/obj/structure/platform/metal/almayer/west,
/obj/structure/prop/souto_land/pole,
/obj/structure/prop/souto_land/pole{
	dir = 4;
	pixel_y = 24
	},
/obj/item/toy/plush/barricade{
	pixel_x = 1;
	pixel_y = -9
	},
/turf/open/floor/prison/darkbrown2/west,
/area/template_noop)
"Th" = (
/obj/effect/decal/cleanable/blood/oil,
/turf/open/floor/prison/darkbrown2/north,
/area/template_noop)
"Tq" = (
/turf/open/floor/prison/cell_stripe/east,
/area/template_noop)
"TO" = (
/obj/structure/prop/souto_land/streamer{
	dir = 6
	},
/turf/open/floor/wood,
/area/template_noop)
"TS" = (
/obj/structure/stairs/perspective{
	dir = 8;
	icon_state = "p_stair_full"
	},
/obj/structure/platform/metal/almayer,
/turf/open/floor/plating/prison,
/area/template_noop)
"Us" = (
/obj/item/toy/syndicateballoon{
	pixel_x = 14;
	pixel_y = -5
	},
/turf/open/floor/wood,
/area/template_noop)
"UN" = (
/obj/item/trash/crushed_cup{
	pixel_x = -13;
	pixel_y = 48
	},
/turf/open/gm/river/pool,
/area/template_noop)
"Vi" = (
/obj/structure/surface/table/reinforced/prison,
/obj/item/reagent_container/food/drinks/bottle/cognac{
	pixel_x = 7;
	pixel_y = 7
	},
/obj/item/reagent_container/food/drinks/drinkingglass{
	pixel_x = -3;
	pixel_y = 13;
	layer = 4
	},
/obj/item/reagent_container/food/drinks/drinkingglass{
	pixel_x = -10;
	pixel_y = 1;
	layer = 4
	},
/turf/open/floor/wood,
/area/template_noop)
"Vx" = (
/obj/structure/bed/chair/comfy{
	dir = 1
	},
/obj/item/weapon/gun/shotgun/merc{
	pixel_x = 1;
	pixel_y = 25
	},
/turf/open/floor/wood,
/area/template_noop)
"VV" = (
/obj/structure/platform_decoration/metal/almayer,
/turf/open/floor/prison,
/area/template_noop)
"Wa" = (
/obj/structure/closet/basketball{
	pixel_x = -8;
	pixel_y = -2
	},
/obj/item/weapon/gun/pistol/heavy,
/obj/item/weapon/gun/revolver/cmb,
/turf/open/floor/wood,
/area/template_noop)
"We" = (
/obj/structure/platform_decoration/metal/almayer/north,
/turf/open/floor/prison,
/area/template_noop)
"Wh" = (
/turf/open/floor/prison/darkbrown2/north,
/area/template_noop)
"Wx" = (
/obj/structure/platform/metal/almayer,
/obj/item/trash/crushed_cup{
	pixel_y = 13;
	pixel_x = 45
	},
/turf/open/gm/river/pool,
/area/template_noop)
"WY" = (
/obj/structure/platform_decoration/metal/almayer/north,
/turf/open/floor/prison/darkbrown2,
/area/template_noop)
"Xn" = (
/obj/item/toy/inflatable_duck{
	layer = 3.1
	},
/obj/item/trash/crushed_cup{
	pixel_y = 6;
	pixel_x = -30
	},
/obj/item/reagent_container/food/drinks/cans/beer{
	pixel_y = 4;
	pixel_x = 1
	},
/turf/open/gm/river/pool,
/area/template_noop)
"Xu" = (
/obj/structure/platform/metal/almayer,
/obj/structure/machinery/light/double/blue,
/turf/open/floor/prison/darkbrown2,
/area/template_noop)
"Xw" = (
/obj/item/toy/beach_ball/holoball{
	pixel_x = -10;
	pixel_y = -7
	},
/turf/open/floor/prison/darkbrown2/west,
/area/template_noop)
"XM" = (
/turf/open/floor/prison/darkbrown2/west,
/area/template_noop)
"XS" = (
/obj/effect/landmark/corpsespawner/prisoner,
/turf/open/floor/wood,
/area/template_noop)
"XU" = (
/obj/structure/stairs/perspective{
	dir = 8;
	icon_state = "p_stair_sn_full_cap"
	},
/obj/structure/platform/metal/almayer/east,
/obj/structure/prop/souto_land/pole{
	dir = 1
	},
/obj/structure/prop/souto_land/pole{
	dir = 8;
	pixel_y = 24
	},
/obj/item/toy/plush/barricade{
	pixel_x = -1;
	pixel_y = -9
	},
/turf/open/floor/prison/darkbrown2/east,
/area/template_noop)
"XX" = (
/obj/structure/platform_decoration/metal/almayer,
/turf/open/floor/prison/floor_plate,
/area/template_noop)
"Yd" = (
/obj/structure/machinery/light/double/blue,
/turf/open/floor/wood,
/area/template_noop)
"Yh" = (
/obj/structure/bed/chair/comfy{
	dir = 8
	},
/obj/structure/machinery/light/double/blue{
	dir = 4;
	pixel_x = 10;
	pixel_y = -3
	},
/turf/open/floor/wood,
/area/template_noop)
"YB" = (
/turf/open/floor/plating/plating_catwalk/prison,
/area/template_noop)
"YG" = (
/obj/structure/platform/metal/almayer,
/turf/open/floor/prison,
/area/template_noop)
"YP" = (
/obj/structure/stairs/perspective{
	icon_state = "p_stair_ew_full_cap"
	},
/obj/structure/platform/metal/stair_cut/platform_right,
/turf/open/floor/plating/prison,
/area/template_noop)
"Zr" = (
/obj/structure/bed/chair/comfy,
/turf/open/floor/wood,
/area/template_noop)
"ZB" = (
/obj/structure/platform/metal/almayer,
/turf/open/floor/prison/floor_plate,
/area/template_noop)

(1,1,1) = {"
Rs
Qn
Fl
Qn
rp
fX
fX
fX
fX
Wh
cK
hP
hP
ly
Qn
Qn
Qn
Aj
Qn
Wh
Rs
Fy
"}
(2,1,1) = {"
Rs
Qn
JQ
Qn
VV
fN
fX
ni
ni
YP
TS
ni
ni
kA
Kx
XX
hP
hP
ly
Wh
Rs
so
"}
(3,1,1) = {"
Rs
Qn
VV
fN
MS
ni
aj
ni
SO
el
mj
hY
ni
YP
Rr
TS
ni
ni
kA
Wh
Rs
dB
"}
(4,1,1) = {"
Rs
Qn
ZB
ni
aj
ni
nf
nf
nf
ql
Rs
nf
BK
TO
HP
nS
Wa
aj
kA
Wh
Rs
mu
"}
(5,1,1) = {"
Rs
VV
MS
aj
jt
az
dB
yx
XM
tM
QF
XM
Xw
NQ
nf
IU
nf
aj
kA
Wh
mu
fX
"}
(6,1,1) = {"
Rs
ZB
ni
ni
XS
nf
GO
PR
Fo
Fo
jW
Fo
mq
Ke
lh
nf
Cx
aj
kA
ND
Fo
fX
"}
(7,1,1) = {"
cK
MS
aj
nf
tz
nf
Th
Rs
pG
Gi
Gi
qm
Wh
Rs
nf
tz
nf
aj
Hn
Fj
nf
fX
"}
(8,1,1) = {"
ou
ni
ni
Zr
FD
az
Wh
xQ
La
kb
hf
DT
Wh
Rs
Zr
Ci
az
ni
ni
kA
nf
Wh
"}
(9,1,1) = {"
Xu
ni
mk
nf
rW
nf
Cq
Rs
La
Dd
ef
DT
Wh
Rs
nf
rW
nf
Yd
ni
wV
nf
Wh
"}
(10,1,1) = {"
uw
SW
ng
yx
yx
mc
Jr
Rs
La
bO
rt
DT
Wh
fL
XM
yx
yx
vd
pB
pH
XM
Jr
"}
(11,1,1) = {"
DN
XU
JR
Fo
Fo
Fo
Sg
Bj
La
hf
UN
Wx
Wh
rU
KM
Fo
Gu
Bm
yL
LW
Fo
Fo
"}
(12,1,1) = {"
Xu
ni
Jw
nf
tz
nf
Wh
Rs
La
Oz
Xn
DT
SC
Rs
nf
tz
nf
Yd
ni
xS
nf
nf
"}
(13,1,1) = {"
ou
ni
ni
pt
LI
Vx
Wh
FN
La
Ro
hf
DT
Wh
cj
Zr
BY
az
cb
Fy
Bf
Bf
Bf
"}
(14,1,1) = {"
WY
Mn
aj
nf
rW
nf
rq
Rs
YP
Rr
Rr
TS
Wh
QO
nf
rW
nf
cU
Fy
gV
gV
gV
"}
(15,1,1) = {"
Rs
ZB
aj
nf
ij
tT
iK
fv
gs
XM
XM
XM
Jr
Rs
nf
tb
nf
nf
Fy
Bf
Bf
Bf
"}
(16,1,1) = {"
Rs
YG
aj
lc
ci
tT
ND
iC
ID
mq
tD
Fo
ik
wS
iY
cq
RW
nf
nf
nf
Gp
Bf
"}
(17,1,1) = {"
Rs
YG
aj
Ls
xz
Bv
or
zR
nf
Th
Rs
nf
tw
XS
KL
Jf
KO
bD
nf
nf
lS
Bf
"}
(18,1,1) = {"
Rs
YG
ni
ni
pG
Gi
qm
ni
vX
Fz
Rg
Ao
Fy
nf
lh
nf
nf
nf
nf
qG
vU
Bf
"}
(19,1,1) = {"
Rs
We
ty
ty
vf
Kx
ZB
ni
ni
pG
zc
ni
Fy
Zr
Vi
az
Fy
Bf
Bf
Bf
Bf
Bf
"}
(20,1,1) = {"
wS
Qn
Qn
Qn
Aj
Qn
We
ro
ro
PA
is
ro
Fy
nf
Yh
Us
Fy
gV
gV
oL
gV
gV
"}
(21,1,1) = {"
Tq
YB
YB
Tq
YB
YB
Tq
YB
YB
Tq
Tq
YB
Fy
Fy
Fy
Fy
Fy
gV
gV
oL
gV
gV
"}
