//MAP CONVERTED BY dmm2tgm.py THIS HEADER COMMENT PREVENTS RECONVERSION, DO NOT REMOVE
"a" = (
/obj/structure/desertdam/decals/road_edge{
	icon_state = "road_edge_decal3";
	pixel_y = -12
	},
/obj/structure/desertdam/decals/road_edge{
	pixel_x = -12
	},
/turf/open/floor/wood,
/area/template_noop)
"c" = (
/obj/structure/desertdam/decals/road_edge{
	icon_state = "road_edge_decal5";
	pixel_x = -2
	},
/obj/structure/desertdam/decals/road_edge{
	icon_state = "road_edge_decal3"
	},
/turf/open/floor/wood,
/area/template_noop)
"d" = (
/obj/structure/desertdam/decals/road_edge{
	icon_state = "road_edge_decal3";
	pixel_x = -9;
	pixel_y = 4
	},
/obj/structure/desertdam/decals/road_edge{
	icon_state = "road_edge_decal3";
	pixel_x = 6;
	pixel_y = 4
	},
/turf/open/floor/wood,
/area/template_noop)
"e" = (
/obj/item/trash/cigbutt{
	pixel_x = 5;
	pixel_y = -6
	},
/turf/open/floor/wood,
/area/template_noop)
"f" = (
/obj/structure/desertdam/decals/road_edge{
	icon_state = "road_edge_decal5";
	pixel_x = -2;
	pixel_y = 4
	},
/obj/structure/desertdam/decals/road_edge{
	pixel_x = 2;
	pixel_y = -22
	},
/obj/effect/decal/cleanable/blood,
/obj/effect/landmark/corpsespawner/ua_riot,
/obj/item/restraint/handcuffs/zip{
	pixel_y = -12
	},
/turf/open/floor/wood,
/area/template_noop)
"h" = (
/obj/structure/desertdam/decals/road_edge{
	icon_state = "road_edge_decal7";
	pixel_x = 2;
	pixel_y = -4
	},
/obj/structure/desertdam/decals/road_edge{
	pixel_x = 2;
	pixel_y = 23
	},
/turf/open/floor/wood,
/area/template_noop)
"j" = (
/obj/structure/desertdam/decals/road_edge{
	pixel_x = 16
	},
/obj/structure/desertdam/decals/road_edge{
	icon_state = "road_edge_decal3"
	},
/turf/open/floor/wood,
/area/template_noop)
"k" = (
/obj/item/ammo_casing{
	dir = 6;
	icon_state = "casing_10_1"
	},
/turf/open/floor/wood,
/area/template_noop)
"l" = (
/obj/structure/desertdam/decals/road_edge{
	pixel_x = 2
	},
/obj/structure/desertdam/decals/road_edge{
	icon_state = "road_edge_decal3";
	pixel_y = -12
	},
/turf/open/floor/wood,
/area/template_noop)
"m" = (
/obj/structure/desertdam/decals/road_edge{
	icon_state = "road_edge_decal8";
	pixel_x = -2;
	pixel_y = -4
	},
/obj/structure/desertdam/decals/road_edge{
	pixel_x = 2;
	pixel_y = 23
	},
/turf/open/floor/wood,
/area/template_noop)
"n" = (
/obj/structure/desertdam/decals/road_edge{
	pixel_x = 2
	},
/turf/open/floor/wood,
/area/template_noop)
"o" = (
/obj/structure/desertdam/decals/road_edge{
	icon_state = "road_edge_decal3";
	pixel_x = -6
	},
/obj/structure/desertdam/decals/road_edge{
	icon_state = "road_edge_decal3";
	pixel_x = 9
	},
/turf/open/floor/wood,
/area/template_noop)
"q" = (
/obj/structure/desertdam/decals/road_edge{
	icon_state = "road_edge_decal6";
	pixel_x = 2
	},
/obj/structure/desertdam/decals/road_edge{
	icon_state = "road_edge_decal3"
	},
/turf/open/floor/wood,
/area/template_noop)
"r" = (
/obj/structure/desertdam/decals/road_edge{
	pixel_x = 2
	},
/obj/structure/desertdam/decals/road_edge{
	icon_state = "road_edge_decal3";
	pixel_y = 16
	},
/turf/open/floor/wood,
/area/template_noop)
"s" = (
/obj/structure/desertdam/decals/road_edge{
	icon_state = "road_edge_decal8";
	pixel_x = -2
	},
/obj/structure/desertdam/decals/road_edge{
	icon_state = "road_edge_decal3";
	pixel_y = 4
	},
/turf/open/floor/wood,
/area/template_noop)
"t" = (
/obj/structure/desertdam/decals/road_edge{
	icon_state = "road_edge_decal7";
	pixel_x = 16;
	pixel_y = -16
	},
/obj/structure/desertdam/decals/road_edge{
	icon_state = "road_edge_decal6";
	pixel_x = 16;
	pixel_y = 16
	},
/obj/structure/desertdam/decals/road_edge{
	icon_state = "road_edge_decal5";
	pixel_x = -16;
	pixel_y = 16
	},
/obj/structure/desertdam/decals/road_edge{
	icon_state = "road_edge_decal8";
	pixel_x = -16;
	pixel_y = -16
	},
/turf/open/floor/wood,
/area/template_noop)
"u" = (
/obj/structure/desertdam/decals/road_edge{
	icon_state = "road_edge_decal3";
	pixel_y = 16
	},
/obj/item/spacecash/c100{
	pixel_x = -11;
	pixel_y = -6
	},
/turf/open/floor/wood,
/area/template_noop)
"v" = (
/obj/structure/desertdam/decals/road_edge{
	icon_state = "road_edge_decal5";
	pixel_x = -16;
	pixel_y = 16
	},
/obj/structure/desertdam/decals/road_edge{
	icon_state = "road_edge_decal8";
	pixel_x = -16;
	pixel_y = -16
	},
/obj/structure/desertdam/decals/road_edge{
	icon_state = "road_edge_decal6";
	pixel_x = 16;
	pixel_y = 16
	},
/obj/structure/desertdam/decals/road_edge{
	icon_state = "road_edge_decal7";
	pixel_x = 16;
	pixel_y = -16
	},
/turf/open/floor/wood,
/area/template_noop)
"w" = (
/obj/structure/desertdam/decals/road_edge{
	pixel_x = 2
	},
/obj/structure/desertdam/decals/road_edge{
	icon_state = "road_edge_decal3";
	pixel_y = 16
	},
/obj/item/trash/barcardine,
/turf/open/floor/wood,
/area/template_noop)
"x" = (
/obj/structure/desertdam/decals/road_edge{
	icon_state = "road_edge_decal3";
	pixel_y = -12
	},
/obj/structure/desertdam/decals/road_edge{
	pixel_x = 16
	},
/turf/open/floor/wood,
/area/template_noop)
"y" = (
/obj/structure/desertdam/decals/road_edge{
	pixel_x = -12
	},
/obj/structure/desertdam/decals/road_edge{
	icon_state = "road_edge_decal3";
	pixel_y = 4
	},
/turf/open/floor/wood,
/area/template_noop)
"z" = (
/obj/structure/desertdam/decals/road_edge{
	icon_state = "road_edge_decal6";
	pixel_x = 2;
	pixel_y = 4
	},
/obj/structure/desertdam/decals/road_edge{
	pixel_x = 2;
	pixel_y = -22
	},
/turf/open/floor/wood,
/area/template_noop)
"A" = (
/obj/structure/desertdam/decals/road_edge{
	icon_state = "road_edge_decal7";
	pixel_x = 2
	},
/obj/structure/desertdam/decals/road_edge{
	icon_state = "road_edge_decal3";
	pixel_y = 4
	},
/turf/open/floor/wood,
/area/template_noop)
"B" = (
/obj/structure/desertdam/decals/road_edge{
	pixel_x = 16
	},
/obj/structure/desertdam/decals/road_edge{
	icon_state = "road_edge_decal3";
	pixel_y = 4
	},
/turf/open/floor/wood,
/area/template_noop)
"D" = (
/obj/structure/desertdam/decals/road_edge{
	icon_state = "road_edge_decal3";
	pixel_y = 16
	},
/turf/open/floor/wood,
/area/template_noop)
"E" = (
/obj/structure/desertdam/decals/road_edge{
	icon_state = "road_edge_decal3";
	pixel_y = 16
	},
/obj/structure/desertdam/decals/road_edge{
	pixel_x = 16
	},
/turf/open/floor/wood,
/area/template_noop)
"G" = (
/obj/structure/desertdam/decals/road_edge{
	pixel_x = -12
	},
/obj/structure/desertdam/decals/road_edge{
	icon_state = "road_edge_decal3"
	},
/turf/open/floor/wood,
/area/template_noop)
"H" = (
/obj/item/trash/chunk,
/turf/open/floor/wood,
/area/template_noop)
"J" = (
/obj/item/weapon/gun/smg/mac15{
	pixel_x = 12
	},
/turf/open/floor/wood,
/area/template_noop)
"M" = (
/obj/structure/holohoop{
	dir = 8
	},
/obj/structure/desertdam/decals/road_edge{
	pixel_x = 16
	},
/obj/structure/desertdam/decals/road_edge{
	icon_state = "road_edge_decal5";
	pixel_x = -16;
	pixel_y = 16
	},
/obj/structure/desertdam/decals/road_edge{
	icon_state = "road_edge_decal8";
	pixel_x = -16;
	pixel_y = -16
	},
/obj/structure/desertdam/decals/road_edge{
	icon_state = "road_edge_decal6";
	pixel_x = 16;
	pixel_y = 16
	},
/obj/structure/desertdam/decals/road_edge{
	icon_state = "road_edge_decal7";
	pixel_x = 16;
	pixel_y = -16
	},
/turf/open/floor/wood,
/area/template_noop)
"Q" = (
/obj/structure/desertdam/decals/road_edge{
	icon_state = "road_edge_decal3";
	pixel_y = 16
	},
/obj/structure/desertdam/decals/road_edge{
	pixel_x = -12
	},
/turf/open/floor/wood,
/area/template_noop)
"R" = (
/obj/structure/holohoop{
	dir = 4
	},
/obj/structure/desertdam/decals/road_edge{
	pixel_x = -12
	},
/obj/structure/desertdam/decals/road_edge{
	icon_state = "road_edge_decal5";
	pixel_x = -16;
	pixel_y = 16
	},
/obj/structure/desertdam/decals/road_edge{
	icon_state = "road_edge_decal8";
	pixel_x = -16;
	pixel_y = -16
	},
/obj/structure/desertdam/decals/road_edge{
	icon_state = "road_edge_decal6";
	pixel_x = 16;
	pixel_y = 16
	},
/obj/structure/desertdam/decals/road_edge{
	icon_state = "road_edge_decal7";
	pixel_x = 16;
	pixel_y = -16
	},
/turf/open/floor/wood,
/area/template_noop)
"S" = (
/obj/structure/desertdam/decals/road_edge{
	icon_state = "road_edge_decal3";
	pixel_y = -12
	},
/turf/open/floor/wood,
/area/template_noop)
"T" = (
/obj/structure/desertdam/decals/road_edge{
	icon_state = "road_edge_decal3";
	pixel_x = -6
	},
/obj/structure/desertdam/decals/road_edge{
	icon_state = "road_edge_decal3";
	pixel_x = 9
	},
/obj/item/weapon/gun/shotgun/pump/dual_tube/cmb,
/turf/open/floor/wood,
/area/template_noop)
"U" = (
/obj/item/ammo_magazine/smg/uzi{
	current_rounds = 0;
	pixel_x = 5;
	pixel_y = 12
	},
/turf/open/floor/wood,
/area/template_noop)
"W" = (
/obj/effect/decal/cleanable/blood,
/turf/open/floor/wood,
/area/template_noop)
"Y" = (
/turf/open/floor/wood,
/area/template_noop)
"Z" = (
/obj/item/toy/beach_ball/holoball,
/obj/structure/desertdam/decals/road_edge{
	icon_state = "road_edge_decal6";
	pixel_x = 16;
	pixel_y = 16
	},
/obj/structure/desertdam/decals/road_edge{
	icon_state = "road_edge_decal5";
	pixel_x = -16;
	pixel_y = 16
	},
/obj/structure/desertdam/decals/road_edge{
	icon_state = "road_edge_decal8";
	pixel_x = -16;
	pixel_y = -16
	},
/obj/structure/desertdam/decals/road_edge{
	icon_state = "road_edge_decal7";
	pixel_x = 16;
	pixel_y = -16
	},
/turf/open/floor/wood,
/area/template_noop)

(1,1,1) = {"
Q
y
R
G
a
"}
(2,1,1) = {"
w
s
Y
c
l
"}
(3,1,1) = {"
D
d
Y
T
S
"}
(4,1,1) = {"
D
z
t
h
S
"}
(5,1,1) = {"
D
Y
Y
H
S
"}
(6,1,1) = {"
D
Y
e
Y
S
"}
(7,1,1) = {"
r
n
Z
n
l
"}
(8,1,1) = {"
D
J
U
Y
S
"}
(9,1,1) = {"
D
k
W
Y
S
"}
(10,1,1) = {"
u
f
v
m
S
"}
(11,1,1) = {"
D
d
Y
o
S
"}
(12,1,1) = {"
r
A
Y
q
l
"}
(13,1,1) = {"
E
B
M
j
x
"}
