//MAP CONVERTED BY dmm2tgm.py THIS HEADER COMMENT PREVENTS RECONVERSION, DO NOT REMOVE
"a" = (
/turf/closed/wall/prison,
/area/template_noop)
"e" = (
/turf/open/floor/plating/prison,
/area/template_noop)
"h" = (
/turf/open/floor/prison/greenfull/east,
/area/template_noop)
"k" = (
/obj/structure/sign/poster/hero/voteno{
	pixel_y = 29
	},
/turf/open/floor/prison/greenfull/east,
/area/template_noop)
"n" = (
/obj/structure/machinery/power/apc/power/south,
/turf/open/floor/prison/greenfull/east,
/area/template_noop)
"o" = (
/turf/closed/wall/mineral/bone_resin,
/area/fiorina/oob)
"s" = (
/turf/open/floor/prison/greenfull/northwest,
/area/template_noop)
"t" = (
/obj/structure/filingcabinet{
	pixel_x = 8;
	pixel_y = 4
	},
/obj/structure/filingcabinet{
	pixel_x = -8;
	pixel_y = 4
	},
/obj/effect/landmark/objective_landmark/medium,
/turf/open/floor/prison/floor_plate,
/area/template_noop)
"x" = (
/obj/structure/surface/table/reinforced/prison,
/obj/item/cell/super{
	pixel_y = 12
	},
/obj/item/cell/super,
/obj/item/storage/pill_bottle/happy{
	layer = 2.8;
	pixel_y = -7
	},
/turf/open/floor/prison/greenfull/east,
/area/template_noop)
"z" = (
/obj/structure/coatrack,
/obj/structure/machinery/light/double/blue{
	dir = 4;
	pixel_x = 10;
	pixel_y = -3
	},
/obj/item/clothing/suit/storage/bomber,
/obj/item/clothing/head/beret/centcom/officer{
	pixel_x = -2;
	pixel_y = 13
	},
/turf/open/floor/prison/greenfull/east,
/area/template_noop)
"D" = (
/obj/structure/closet/secure_closet/freezer/fridge/groceries,
/obj/structure/machinery/light/double/blue{
	dir = 4;
	pixel_x = 10;
	pixel_y = -3
	},
/turf/open/floor/prison/greenfull/east,
/area/template_noop)
"E" = (
/obj/structure/machinery/photocopier,
/obj/structure/machinery/light/double/blue{
	dir = 4;
	pixel_x = 10;
	pixel_y = -3
	},
/obj/item/paper{
	desc = "The image appears to be someone's backside, the page number is labled as 259."
	},
/turf/open/floor/prison/floor_plate,
/area/template_noop)
"F" = (
/obj/structure/surface/table/reinforced/prison,
/obj/item/storage/toolbox/electrical{
	pixel_x = -1;
	pixel_y = 11
	},
/obj/item/storage/toolbox/mechanical{
	pixel_y = 5;
	pixel_x = -1
	},
/obj/item/storage/toolbox/syndicate{
	pixel_x = -1
	},
/obj/structure/sign/poster/music{
	pixel_y = 29
	},
/obj/item/weapon/butterfly{
	pixel_x = 17
	},
/turf/open/floor/prison/greenfull/east,
/area/template_noop)
"O" = (
/obj/structure/surface/table/reinforced/prison,
/obj/structure/machinery/microwave{
	icon_state = "mwo";
	pixel_y = 6
	},
/turf/open/floor/prison/greenfull/east,
/area/template_noop)
"Q" = (
/obj/structure/machinery/door/airlock/almayer/generic{
	dir = 2;
	name = "Residential Apartment"
	},
/turf/open/floor/plating/prison,
/area/template_noop)
"S" = (
/obj/item/storage/firstaid/regular/empty{
	pixel_x = 14
	},
/turf/open/floor/prison/greenfull/east,
/area/template_noop)
"T" = (
/turf/open/floor/prison/floor_plate,
/area/template_noop)
"V" = (
/obj/structure/filingcabinet{
	pixel_x = 8;
	pixel_y = 4
	},
/obj/structure/filingcabinet{
	pixel_x = -8;
	pixel_y = 4
	},
/obj/effect/landmark/objective_landmark/close,
/obj/item/pamphlet/engineer,
/turf/open/floor/prison/floor_plate,
/area/template_noop)
"X" = (
/obj/structure/closet/secure_closet/engineering_electrical,
/obj/structure/machinery/light/double/blue{
	dir = 4;
	pixel_x = 10;
	pixel_y = -3
	},
/obj/effect/landmark/objective_landmark/medium,
/obj/item/storage/backpack/marine/engineerpack/satchel,
/turf/open/floor/prison/greenfull/east,
/area/template_noop)
"Z" = (
/obj/structure/surface/table/reinforced/prison,
/obj/item/clothing/head/beret/eng{
	pixel_x = 5;
	pixel_y = 3
	},
/obj/item/book/manual/engineering_guide{
	pixel_x = -4
	},
/turf/open/floor/prison/greenfull/east,
/area/template_noop)

(1,1,1) = {"
a
a
a
a
a
a
a
"}
(2,1,1) = {"
Q
h
n
a
F
S
Q
"}
(3,1,1) = {"
a
O
D
a
x
z
a
"}
(4,1,1) = {"
a
a
a
a
a
a
a
"}
(5,1,1) = {"
Q
h
Z
a
V
h
Q
"}
(6,1,1) = {"
a
k
X
a
t
E
a
"}
(7,1,1) = {"
a
a
a
a
a
a
a
"}
(8,1,1) = {"
o
o
o
o
o
e
e
"}
(9,1,1) = {"
T
o
T
s
s
s
s
"}
