//MAP CONVERTED BY dmm2tgm.py THIS HEADER COMMENT PREVENTS RECONVERSION, DO NOT REMOVE
"br" = (
/obj/structure/window/reinforced{
	dir = 1
	},
/obj/effect/decal/cleanable/dirt,
/turf/open/floor/almayer{
	icon_state = "plate";
	tag = "icon-sterile"
	},
/area/almayer/hull/lower_hull/l_m_p)
"bD" = (
/obj/structure{
	health = 150;
	icon = 'icons/obj/pipes/pipes.dmi';
	icon_state = "intact-scrubbers";
	indestructible = 1;
	layer = 4.5;
	pixel_x = -4;
	projectile_coverage = 0;
	unacidable = 1
	},
/turf/open/floor/plating/plating_catwalk,
/area/almayer/hull/lower_hull/l_m_p)
"bY" = (
/obj/effect/spider/spiderling/nogrow,
/turf/open/floor/plating/plating_catwalk,
/area/almayer/hull/lower_hull/l_m_p)
"cp" = (
/obj/structure/window/reinforced{
	dir = 1
	},
/obj/effect/decal/cleanable/blood,
/turf/open/floor/almayer{
	icon_state = "plate";
	tag = "icon-sterile"
	},
/area/almayer/hull/lower_hull/l_m_p)
"cr" = (
/obj/structure/disposalpipe/segment{
	dir = 4
	},
/obj/structure/pipes/standard/tank/oxygen{
	desc = "What the hell is this doing next to disposals? You see scratches and muck all over it. Nasty!"
	},
/obj/effect/spider/stickyweb,
/turf/open/floor/almayer{
	icon_state = "plate";
	tag = "icon-sterile"
	},
/area/almayer/hull/lower_hull/l_m_p)
"dl" = (
/obj/structure{
	dir = 4;
	health = 150;
	icon = 'icons/obj/pipes/pipes.dmi';
	icon_state = "intact-scrubbers";
	indestructible = 1;
	layer = 4.5;
	pixel_x = -14;
	pixel_y = 13;
	projectile_coverage = 0;
	unacidable = 1
	},
/turf/closed/wall/almayer/outer,
/area/almayer/hull/lower_hull/l_m_p)
"eD" = (
/obj/effect/decal/cleanable/blood,
/obj/structure{
	health = 150;
	icon = 'icons/obj/pipes/pipes.dmi';
	icon_state = "intact-scrubbers";
	indestructible = 1;
	layer = 4.5;
	pixel_x = -4;
	projectile_coverage = 0;
	unacidable = 1;
	dir = 8
	},
/obj/structure{
	health = 150;
	icon = 'icons/obj/pipes/pipes.dmi';
	icon_state = "intact-scrubbers";
	indestructible = 1;
	layer = 4.5;
	pixel_x = 5;
	projectile_coverage = 0;
	unacidable = 1;
	dir = 8
	},
/obj/effect/spider/eggcluster/inert,
/turf/open/floor/almayer{
	icon_state = "plate";
	tag = "icon-sterile"
	},
/area/almayer/hull/lower_hull/l_m_p)
"fT" = (
/obj/effect/decal/cleanable/dirt,
/obj/effect/spider/spiderling/nogrow,
/obj/effect/decal/cleanable/spiderling_remains,
/obj/effect/decal/cleanable/blood,
/turf/open/floor/almayer{
	icon_state = "plate";
	tag = "icon-sterile"
	},
/area/almayer/hull/lower_hull/l_m_p)
"gM" = (
/obj/effect/spider/spiderling/nogrow,
/obj/effect/decal/cleanable/spiderling_remains,
/turf/open/floor/almayer{
	icon_state = "plate";
	tag = "icon-sterile"
	},
/area/almayer/hull/lower_hull/l_m_p)
"hi" = (
/obj/structure/window/reinforced{
	dir = 4
	},
/obj/effect/decal/remains/human,
/obj/effect/spider/cocoon/map_fill_crate{
	fill_type_whitelist = list(/mob/living,/obj/item,/obj/effect/remains)
	},
/obj/item/clothing/under/rank/medical/nurse,
/obj/item/clothing/shoes/white,
/turf/open/floor/plating/plating_catwalk,
/area/almayer/hull/lower_hull/l_m_p)
"hz" = (
/obj/structure/machinery/conveyor{
	id = "lower_garbage";
	dir = 4
	},
/obj/structure/plasticflaps,
/turf/open/floor/almayer{
	icon_state = "plate";
	tag = "icon-sterile"
	},
/area/almayer/hull/lower_hull/l_m_p)
"hG" = (
/obj/structure/machinery/conveyor{
	id = "lower_garbage";
	dir = 4
	},
/obj/structure/sign/catclock{
	pixel_y = 32
	},
/obj/effect/spider/eggcluster/inert,
/turf/open/floor/almayer{
	icon_state = "plate";
	tag = "icon-sterile"
	},
/area/almayer/hull/lower_hull/l_m_p)
"iP" = (
/obj/structure/prop/holidays/string_lights{
	pixel_y = -11;
	name = "M0A1 pattern festive bulb strings";
	desc = "Festive bulb strings, still hanged up from last last last last last year's Christmas. You're pretty sure these are an earlier pattern that was recalled due to sudden ignition concerns.."
	},
/turf/closed/wall/almayer,
/area/almayer/hull/lower_hull/l_m_p)
"jk" = (
/obj/effect/decal/cleanable/generic,
/obj/effect/spider/spiderling/nogrow,
/obj/effect/decal/cleanable/blood/drip,
/turf/open/floor/almayer{
	icon_state = "plate";
	tag = "icon-sterile"
	},
/area/almayer/hull/lower_hull/l_m_p)
"jC" = (
/obj/structure/machinery/conveyor_switch{
	id = "lower_garbage"
	},
/obj/effect/decal/cleanable/vomit,
/obj/effect/decal/cleanable/spiderling_remains,
/turf/open/floor/almayer{
	icon_state = "plate";
	tag = "icon-sterile"
	},
/area/almayer/hull/lower_hull/l_m_p)
"ku" = (
/obj/structure/disposalpipe/segment{
	dir = 4
	},
/obj/structure/largecrate/supply/floodlights,
/obj/item/toy/prize/ripley{
	pixel_y = 19;
	pixel_x = -3;
	name = "promotional powerloader figurine";
	desc = "A promotional powerloader figurine, seems to be made entirely out of metal. Strange."
	},
/turf/open/floor/almayer{
	icon_state = "plate";
	tag = "icon-sterile"
	},
/area/almayer/hull/lower_hull/l_m_p)
"lp" = (
/obj/structure/machinery/door/airlock/almayer/engineering/glass{
	name = "\improper Disposals";
	dir = 2
	},
/turf/open/floor/almayer{
	icon_state = "plate";
	tag = "icon-sterile"
	},
/area/almayer/hull/lower_hull/l_m_p)
"lW" = (
/obj/structure/surface/rack,
/obj/structure/window/reinforced{
	dir = 8
	},
/obj/effect/spawner/random/tech_supply,
/obj/effect/spawner/random/tech_supply,
/obj/item/device/healthanalyzer{
	icon_state = "golden_health";
	desc = "A health analyzer, but it has REAL gold plating. Real FAKE gold plating."
	},
/obj/effect/decal/cleanable/cobweb2/dynamic,
/turf/open/floor/plating/plating_catwalk,
/area/almayer/hull/lower_hull/l_m_p)
"mk" = (
/obj/effect/decal/cleanable/dirt,
/obj/structure/disposalpipe/segment{
	dir = 4
	},
/obj/effect/spider/spiderling/nogrow,
/turf/open/floor/almayer{
	icon_state = "plate";
	tag = "icon-sterile"
	},
/area/almayer/hull/lower_hull/l_m_p)
"mn" = (
/obj/effect/decal/cleanable/dirt,
/obj/effect/spider/spiderling/nogrow,
/obj/effect/decal/cleanable/spiderling_remains,
/turf/open/floor/almayer{
	icon_state = "plate";
	tag = "icon-sterile"
	},
/area/almayer/hull/lower_hull/l_m_p)
"mt" = (
/obj/structure{
	health = 150;
	icon = 'icons/obj/pipes/pipes.dmi';
	icon_state = "intact-scrubbers";
	indestructible = 1;
	layer = 4.5;
	projectile_coverage = 0;
	unacidable = 1;
	pixel_y = -1
	},
/obj/structure/largecrate/supply/generator,
/obj/item/computer3_part/toybox{
	pixel_y = 9;
	pixel_x = -6
	},
/turf/open/floor/almayer{
	icon_state = "plate";
	tag = "icon-sterile"
	},
/area/almayer/hull/lower_hull/l_m_p)
"mE" = (
/obj/structure/disposalpipe/segment,
/obj/structure{
	dir = 4;
	health = 150;
	icon = 'icons/obj/pipes/pipes.dmi';
	icon_state = "intact-scrubbers";
	indestructible = 1;
	layer = 4.5;
	pixel_x = -14;
	pixel_y = 13;
	projectile_coverage = 0;
	unacidable = 1
	},
/obj/effect/decal/cleanable/blood,
/turf/open/floor/almayer{
	icon_state = "plate";
	tag = "icon-sterile"
	},
/area/almayer/hull/lower_hull/l_m_p)
"os" = (
/obj/effect/decal/cleanable/dirt,
/obj/structure/disposalpipe/segment{
	dir = 8;
	icon_state = "pipe-c"
	},
/obj/effect/decal/cleanable/spiderling_remains,
/turf/open/floor/almayer{
	icon_state = "plate";
	tag = "icon-sterile"
	},
/area/almayer/hull/lower_hull/l_m_p)
"pv" = (
/obj/effect/decal/cleanable/blood,
/obj/structure{
	health = 150;
	icon = 'icons/obj/pipes/pipes.dmi';
	icon_state = "intact-scrubbers";
	indestructible = 1;
	layer = 4.5;
	projectile_coverage = 0;
	unacidable = 1;
	dir = 6;
	pixel_y = -3
	},
/turf/open/floor/almayer{
	icon_state = "plate";
	tag = "icon-sterile"
	},
/area/almayer/hull/lower_hull/l_m_p)
"pE" = (
/obj/structure/machinery/conveyor{
	id = "lower_garbage";
	dir = 4
	},
/obj/structure/disposaloutlet,
/obj/structure/disposaloutlet{
	dir = 4
	},
/obj/structure/disposalpipe/trunk{
	dir = 2
	},
/obj/effect/decal/cleanable/cobweb2/dynamic,
/obj/effect/spider/stickyweb,
/turf/open/floor/almayer{
	icon_state = "plate";
	tag = "icon-sterile"
	},
/area/almayer/hull/lower_hull/l_m_p)
"qe" = (
/obj/structure/disposalpipe/segment,
/obj/structure/closet/crate/trashcart,
/obj/item/storage/box/lightstick/red,
/obj/item/storage/box/lights/mixed,
/obj/effect/spider/stickyweb,
/turf/open/floor/plating/plating_catwalk,
/area/almayer/hull/lower_hull/l_m_p)
"qf" = (
/obj/structure{
	health = 150;
	icon = 'icons/obj/pipes/pipes3.dmi';
	icon_state = "manifold";
	indestructible = 1;
	layer = 5.1;
	projectile_coverage = 0;
	unacidable = 1;
	dir = 4
	},
/obj/effect/decal/cleanable/spiderling_remains,
/turf/open/floor/almayer{
	icon_state = "plate";
	tag = "icon-sterile"
	},
/area/almayer/hull/lower_hull/l_m_p)
"qm" = (
/obj/structure/window/framed/almayer,
/turf/open/floor/almayer{
	icon_state = "plate";
	tag = "icon-sterile"
	},
/area/almayer/hull/lower_hull/l_m_p)
"rL" = (
/obj/item/tool/wet_sign{
	pixel_x = -3;
	pixel_y = 2
	},
/turf/open/floor/plating/plating_catwalk,
/area/almayer/hull/lower_hull/l_m_p)
"sW" = (
/obj/effect/decal/cleanable/blood/writing,
/turf/open/floor/almayer{
	icon_state = "plate";
	tag = "icon-sterile"
	},
/area/almayer/hull/lower_hull/l_m_p)
"us" = (
/obj/structure/closet/crate/freezer/cooler/oj{
	name = "cooler box";
	desc = "You will not find a cooler box anywhere else. Used for freezing beers to crack open with the boys on a warm evening. This one seems to be painted orange and filled with orange juice. Huh..."
	},
/obj/item/reagent_container/food/drinks/bottle/orangejuice,
/obj/item/reagent_container/food/drinks/bottle/orangejuice,
/obj/item/reagent_container/food/drinks/bottle/orangejuice,
/obj/item/reagent_container/food/drinks/bottle/orangejuice,
/obj/item/reagent_container/food/drinks/bottle/orangejuice,
/obj/item/reagent_container/food/drinks/bottle/orangejuice,
/obj/item/reagent_container/food/drinks/bottle/orangejuice,
/obj/item/reagent_container/food/drinks/bottle/orangejuice,
/obj/item/reagent_container/food/drinks/bottle/orangejuice,
/obj/item/reagent_container/food/drinks/bottle/orangejuice,
/obj/item/reagent_container/food/drinks/bottle/orangejuice,
/obj/item/reagent_container/food/drinks/bottle/orangejuice,
/obj/item/reagent_container/food/drinks/bottle/orangejuice,
/turf/open/floor/plating/plating_catwalk,
/area/almayer/hull/lower_hull/l_m_p)
"uw" = (
/obj/structure/prop/holidays/string_lights{
	pixel_y = -11;
	name = "M0A1 pattern festive bulb strings";
	desc = "Festive bulb strings, still hanged up from last last last last last year's Christmas. You're pretty sure these are an earlier pattern that was recalled due to sudden ignition concerns.."
	},
/obj/structure/window/framed/almayer,
/turf/open/floor/almayer{
	icon_state = "plate";
	tag = "icon-sterile"
	},
/area/almayer/hull/lower_hull/l_m_p)
"uG" = (
/obj/effect/decal/cleanable/blood,
/turf/open/floor/almayer{
	icon_state = "plate";
	tag = "icon-sterile"
	},
/area/almayer/hull/lower_hull/l_m_p)
"vl" = (
/obj/effect/decal/cleanable/dirt,
/obj/effect/spider/spiderling/nogrow,
/turf/open/floor/almayer{
	icon_state = "plate";
	tag = "icon-sterile"
	},
/area/almayer/hull/lower_hull/l_m_p)
"vw" = (
/obj/structure/disposalpipe/segment{
	dir = 4
	},
/obj/structure/pipes/standard/tank/nitrogen{
	desc = "Someone's somehow managed to cut a hole into this tank and put a tube with a valve on it at mouth-level. For some reason. The tank feels hollow to the touch, obviously from the imperfections in the hole leaking the nitrogen out.";
	icon_state = "co2_map";
	actual_icon_state = "co2_map"
	},
/obj/structure/sign/safety/distribution_pipes{
	pixel_x = 8;
	pixel_y = 32
	},
/obj/effect/spider/stickyweb,
/obj/structure/machinery/light/small/broken{
	dir = 1
	},
/turf/open/floor/almayer{
	icon_state = "plate";
	tag = "icon-sterile"
	},
/area/almayer/hull/lower_hull/l_m_p)
"vJ" = (
/obj/structure/disposalpipe/segment,
/turf/open/floor/plating/plating_catwalk,
/area/almayer/hull/lower_hull/l_m_p)
"vP" = (
/obj/structure/machinery/recycler,
/obj/structure/machinery/conveyor{
	id = "lower_garbage";
	dir = 4
	},
/obj/effect/decal/cleanable/cobweb2/dynamic,
/obj/effect/spider/stickyweb,
/turf/open/floor/almayer{
	icon_state = "plate";
	tag = "icon-sterile"
	},
/area/almayer/hull/lower_hull/l_m_p)
"wH" = (
/obj/structure/machinery/conveyor{
	id = "lower_garbage";
	dir = 4
	},
/obj/item/newspaper,
/obj/effect/spider/stickyweb,
/turf/open/floor/almayer{
	icon_state = "plate";
	tag = "icon-sterile"
	},
/area/almayer/hull/lower_hull/l_m_p)
"wN" = (
/obj/structure/janitorialcart,
/obj/structure{
	dir = 4;
	health = 150;
	icon = 'icons/obj/pipes/pipes.dmi';
	icon_state = "intact-scrubbers";
	indestructible = 1;
	layer = 4.5;
	pixel_x = -14;
	pixel_y = 13;
	projectile_coverage = 0;
	unacidable = 1
	},
/turf/open/floor/almayer{
	icon_state = "plate";
	tag = "icon-sterile"
	},
/area/almayer/hull/lower_hull/l_m_p)
"wW" = (
/obj/structure/machinery/conveyor{
	id = "lower_garbage";
	dir = 4
	},
/obj/effect/decal/cleanable/molten_item,
/obj/item/device/analyzer/plant_analyzer,
/obj/item/reagent_container/glass/rag{
	pixel_x = 8;
	pixel_y = 6
	},
/obj/structure/machinery/light/small/broken{
	dir = 1
	},
/turf/open/floor/almayer{
	icon_state = "plate";
	tag = "icon-sterile"
	},
/area/almayer/hull/lower_hull/l_m_p)
"wX" = (
/obj/structure{
	health = 150;
	icon = 'icons/obj/pipes/pipes.dmi';
	icon_state = "intact-scrubbers";
	indestructible = 1;
	layer = 4.5;
	pixel_x = -4;
	projectile_coverage = 0;
	unacidable = 1
	},
/obj/effect/spider/spiderling/nogrow,
/turf/open/floor/plating/plating_catwalk,
/area/almayer/hull/lower_hull/l_m_p)
"xE" = (
/obj/effect/decal/cleanable/generic,
/turf/open/floor/almayer{
	icon_state = "plate";
	tag = "icon-sterile"
	},
/area/almayer/hull/lower_hull/l_m_p)
"xP" = (
/obj/effect/decal/cleanable/dirt,
/obj/structure/largecrate/random/case/small,
/obj/structure/largecrate/random/mini/ammo{
	pixel_x = 3;
	pixel_y = 9
	},
/obj/item/spacecash/c20{
	pixel_x = 1;
	pixel_y = 15
	},
/turf/open/floor/almayer{
	icon_state = "plate";
	tag = "icon-sterile"
	},
/area/almayer/hull/lower_hull/l_m_p)
"yH" = (
/obj/effect/decal/cleanable/blood/drip,
/turf/open/floor/plating/plating_catwalk,
/area/almayer/hull/lower_hull/l_m_p)
"zd" = (
/obj/structure/disposalpipe/segment{
	dir = 4;
	icon_state = "pipe-c";
	tag = "icon-pipe-c (NORTH)"
	},
/obj/structure/largecrate/random/barrel/yellow,
/obj/effect/spider/stickyweb,
/turf/open/floor/plating/plating_catwalk,
/area/almayer/hull/lower_hull/l_m_p)
"AN" = (
/turf/closed/wall/almayer,
/area/almayer/hull/lower_hull/l_m_p)
"AZ" = (
/obj/structure/closet/emcloset,
/obj/item/tank/anesthetic,
/obj/effect/spider/stickyweb,
/turf/open/floor/almayer{
	icon_state = "plate";
	tag = "icon-sterile"
	},
/area/almayer/hull/lower_hull/l_m_p)
"CX" = (
/obj/structure/disposalpipe/segment,
/obj/structure/machinery/gravity_generator{
	name = "ring light";
	desc = "This fashionable ring light casts an even light onto the recipient, perfect for makeup or photo shoots! The cable on this one seems to have been chewed off. Damn rats!"
	},
/turf/open/floor/plating/plating_catwalk,
/area/almayer/hull/lower_hull/l_m_p)
"Db" = (
/obj/structure/machinery/conveyor{
	id = "lower_garbage";
	dir = 4
	},
/obj/effect/decal/cleanable/dirt,
/mob/living/simple_animal/hostile/giant_spider{
	name = "gigantic dead spider";
	desc = "JESUS! WHAT THE FUCK IS THAT!";
	health = 0
	},
/turf/open/floor/almayer{
	icon_state = "plate";
	tag = "icon-sterile"
	},
/area/almayer/hull/lower_hull/l_m_p)
"Fp" = (
/turf/closed/wall/almayer/outer,
/area/almayer/hull/lower_hull/l_m_p)
"FO" = (
/obj/structure/largecrate/random/barrel/green,
/obj/item/trash/plate{
	pixel_y = 17
	},
/obj/item/reagent_container/food/snacks/toastedsandwich{
	pixel_y = 25;
	name = "fungus-covered sandwich"
	},
/obj/item/reagent_container/food/snacks/grown/mushroom/libertycap{
	pixel_y = 20;
	pixel_x = -4
	},
/obj/item/reagent_container/food/snacks/grown/mushroom/angel{
	pixel_y = 21
	},
/turf/open/floor/plating/plating_catwalk,
/area/almayer/hull/lower_hull/l_m_p)
"Ha" = (
/obj/structure/disposalpipe/segment{
	dir = 4
	},
/obj/structure/largecrate/random/barrel/red,
/turf/open/floor/plating/plating_catwalk,
/area/almayer/hull/lower_hull/l_m_p)
"Hg" = (
/obj/structure/surface/table/almayer,
/obj/effect/spawner/random/toy,
/obj/effect/spawner/random/toy,
/obj/item/device/flashlight/lamp/green{
	pixel_x = -11;
	pixel_y = 12
	},
/obj/effect/spider/stickyweb,
/turf/open/floor/plating/plating_catwalk,
/area/almayer/hull/lower_hull/l_m_p)
"Ir" = (
/obj/effect/decal/cleanable/dirt,
/obj/structure/machinery/light/small/broken{
	dir = 4
	},
/obj/effect/spider/cocoon/map_fill_crate{
	fill_type_whitelist = list(/mob/living,/obj/item,/obj/effect/remains)
	},
/obj/effect/decal/remains/human,
/obj/item/tool/wrench,
/obj/item/clothing/head/hardhat/dblue,
/turf/open/floor/almayer{
	icon_state = "plate";
	tag = "icon-sterile"
	},
/area/almayer/hull/lower_hull/l_m_p)
"IA" = (
/obj/effect/decal/cleanable/cobweb2/dynamic,
/obj/item/reagent_container/food/drinks/flask/detflask{
	pixel_x = -3;
	pixel_y = 9
	},
/obj/effect/landmark/supplyspawner/engineering,
/turf/open/floor/plating/plating_catwalk,
/area/almayer/hull/lower_hull/l_m_p)
"IB" = (
/obj/structure/surface/rack,
/obj/structure/window/reinforced{
	dir = 4
	},
/obj/structure/window/reinforced{
	dir = 8
	},
/obj/structure/window/reinforced{
	dir = 8
	},
/obj/effect/spawner/random/attachment,
/obj/item/reagent_container/food/snacks/upp,
/turf/open/floor/plating/plating_catwalk,
/area/almayer/hull/lower_hull/l_m_p)
"JQ" = (
/obj/effect/decal/cleanable/generic,
/turf/open/floor/plating/plating_catwalk,
/area/almayer/hull/lower_hull/l_m_p)
"KR" = (
/obj/structure/disposalpipe/segment,
/turf/closed/wall/almayer,
/area/almayer/hull/lower_hull/l_m_p)
"Ld" = (
/obj/structure/window/reinforced{
	dir = 1
	},
/obj/effect/decal/cleanable/blood/gibs/robot,
/obj/structure/sign/poster{
	desc = "YOU ALWAYS KNOW A WORKING JOE. YOU ALWAYS KNOW A WORKING JOE. YOU ALWAYS KNOW A WORKING JOE. YOU ALWAYS KNOW A WORKING JOE. YOU ALWAYS KNOW A WORKING JOE.";
	icon_state = "poster11";
	name = "YOU ALWAYS KNOW A WORKING JOE.";
	pixel_x = 27;
	serial_number = 11
	},
/obj/effect/spider/eggcluster/inert,
/turf/open/floor/plating/plating_catwalk,
/area/almayer/hull/lower_hull/l_m_p)
"LT" = (
/obj/structure/disposalpipe/segment{
	dir = 4
	},
/obj/structure/largecrate/random/case/double,
/obj/effect/spider/stickyweb,
/turf/open/floor/plating/plating_catwalk,
/area/almayer/hull/lower_hull/l_m_p)
"Mr" = (
/obj/structure/disposalpipe/segment{
	dir = 4
	},
/obj/structure/prop/almayer{
	desc = "This is straight up, no frills, an USCM droppod that has some-fucking-how found its way into the ship's maintenance. You don't even want to think about how.";
	name = "battered USCM droppod";
	icon = 'icons/obj/structures/droppod_32x64.dmi';
	icon_state = "techpod_open"
	},
/obj/effect/decal/cleanable/cobweb2/dynamic,
/turf/open/floor/almayer{
	icon_state = "plate";
	tag = "icon-sterile"
	},
/area/almayer/hull/lower_hull/l_m_p)
"Nx" = (
/obj/structure/machinery/conveyor{
	id = "lower_garbage";
	dir = 4
	},
/obj/item/frame/light_fixture/small{
	pixel_y = 17
	},
/turf/open/floor/almayer{
	icon_state = "plate";
	tag = "icon-sterile"
	},
/area/almayer/hull/lower_hull/l_m_p)
"NZ" = (
/obj/structure/disposalpipe/segment{
	dir = 4
	},
/obj/effect/decal/cleanable/spiderling_remains,
/obj/effect/decal/cleanable/blood/writing,
/turf/open/floor/almayer{
	icon_state = "plate";
	tag = "icon-sterile"
	},
/area/almayer/hull/lower_hull/l_m_p)
"Oy" = (
/obj/structure/surface/rack,
/obj/item/tank/phoron,
/turf/open/floor/plating/plating_catwalk,
/area/almayer/hull/lower_hull/l_m_p)
"PM" = (
/obj/structure/disposalpipe/segment,
/obj/effect/decal/cleanable/vomit,
/obj/item/stack/sheet/metal,
/obj/effect/spider/stickyweb,
/obj/effect/spider/cocoon/map_fill_crate{
	fill_type_whitelist = list(/mob/living,/obj/item,/obj/effect/remains)
	},
/obj/item/attachable/bayonet,
/obj/item/clothing/head/helmet/marine,
/turf/open/floor/plating/plating_catwalk,
/area/almayer/hull/lower_hull/l_m_p)
"Qb" = (
/obj/structure/disposalpipe/segment{
	dir = 4
	},
/obj/effect/spider/stickyweb,
/obj/effect/spider/cocoon/map_fill_crate{
	fill_type_whitelist = list(/mob/living,/obj/item,/obj/effect/remains)
	},
/obj/effect/decal/remains/human,
/obj/item/weapon/melee/claymore/mercsword/machete/arnold{
	force = 35;
	desc = "An older issue USCM machete, never left testing. Designed in the Central African Republic. The notching made it hard to clean, and as such the USCM refused to adopt it - despite the superior bludgeoning power offered. Difficult to carry with the usual kit. This one seems to be plently damaged around the blade.";
	name = "blunt M2100 \"Ngájhe\" machete"
	},
/obj/item/clothing/head/cmcap/flap,
/obj/item/trash/cigbutt/cigarbutt,
/turf/open/floor/almayer{
	icon_state = "plate";
	tag = "icon-sterile"
	},
/area/almayer/hull/lower_hull/l_m_p)
"QW" = (
/obj/effect/decal/cleanable/dirt,
/obj/structure/disposalpipe/segment{
	dir = 4
	},
/obj/structure/kitchenspike{
	name = "bloody meat spike";
	desc = "A meat spike. It's utilized to hang animals up and skin them to easily collect their meat. What this is doing near Disposals you have no clue. There's brown fur and blood on it..."
	},
/obj/structure/sign/safety/distribution_pipes{
	pixel_x = 8;
	pixel_y = 32
	},
/obj/structure/machinery/light/small/broken{
	dir = 1
	},
/turf/open/floor/almayer{
	icon_state = "plate";
	tag = "icon-sterile"
	},
/area/almayer/hull/lower_hull/l_m_p)
"Rd" = (
/obj/structure/disposalpipe/segment,
/obj/effect/decal/cleanable/cobweb2/dynamic,
/obj/structure/disposalpipe/junction{
	dir = 1
	},
/obj/structure/largecrate/random/secure,
/obj/effect/spider/stickyweb,
/turf/open/floor/plating/plating_catwalk,
/area/almayer/hull/lower_hull/l_m_p)
"SN" = (
/obj/structure{
	health = 150;
	icon = 'icons/obj/pipes/pipes.dmi';
	icon_state = "intact-scrubbers";
	indestructible = 1;
	layer = 4.5;
	pixel_x = -4;
	projectile_coverage = 0;
	unacidable = 1;
	dir = 5
	},
/obj/structure/janitorialcart,
/obj/item/stack/cable_coil/blue{
	pixel_y = 6;
	pixel_x = -9;
	name = "flight wire";
	desc = "Flight wire, utilized by pilot officers to do... flight... stuff. At least, that's what that PO told you they do when he ordered you to grab some. Ten months ago."
	},
/turf/open/floor/almayer{
	icon_state = "plate";
	tag = "icon-sterile"
	},
/area/almayer/hull/lower_hull/l_m_p)
"Tp" = (
/obj/structure/disposalpipe/segment,
/obj/effect/spider/eggcluster,
/turf/open/floor/plating/plating_catwalk,
/area/almayer/hull/lower_hull/l_m_p)
"UN" = (
/obj/effect/spider/spiderling/nogrow,
/turf/open/floor/almayer{
	icon_state = "plate";
	tag = "icon-sterile"
	},
/area/almayer/hull/lower_hull/l_m_p)
"VJ" = (
/obj/structure/window/reinforced{
	dir = 1
	},
/obj/structure/surface/table/almayer,
/obj/structure/disposalpipe/segment,
/obj/effect/decal/cleanable/vomit,
/obj/item/cell/crap/empty{
	name = "iron sight battery";
	desc = "Holy shit, you finally found one! Now report back to your sergeant private, it's been a few years since they ordered you to fetch one; You're getting an ass whooping for sure."
	},
/obj/item/reagent_container/food/drinks/cup{
	pixel_x = 11
	},
/obj/structure/sign/poster/clf{
	desc = "What the fuck is this god damn CLF propaganda doing here? Tear it out off now. NOW.";
	name = "treacherous poster";
	pixel_x = -26
	},
/obj/item/device/cassette_tape/lz{
	pixel_x = -8;
	pixel_y = -3;
	desc = "It ain't me, it ain't me! I ain't no senator's son, no!"
	},
/turf/open/floor/plating/plating_catwalk,
/area/almayer/hull/lower_hull/l_m_p)
"Wl" = (
/obj/effect/decal/cleanable/flour,
/turf/open/floor/almayer{
	icon_state = "plate";
	tag = "icon-sterile"
	},
/area/almayer/hull/lower_hull/l_m_p)
"Xk" = (
/obj/effect/decal/cleanable/blood/oil,
/obj/structure/largecrate/random/barrel/white,
/obj/item/storage/fancy/candle_box{
	pixel_x = -1;
	pixel_y = 15
	},
/obj/structure/machinery/light/small/broken,
/turf/open/floor/almayer{
	icon_state = "plate";
	tag = "icon-sterile"
	},
/area/almayer/hull/lower_hull/l_m_p)
"Xv" = (
/obj/effect/decal/cleanable/generic,
/obj/structure{
	health = 150;
	icon = 'icons/obj/pipes/pipes3.dmi';
	icon_state = "manifold";
	indestructible = 1;
	layer = 5.1;
	projectile_coverage = 0;
	unacidable = 1;
	pixel_y = 3
	},
/obj/item/ammo_box/magazine/shotgun/beanbag/empty,
/turf/open/floor/almayer{
	icon_state = "plate";
	tag = "icon-sterile"
	},
/area/almayer/hull/lower_hull/l_m_p)
"Yj" = (
/obj/effect/decal/cleanable/generic,
/obj/structure/disposalpipe/segment{
	dir = 4
	},
/obj/structure/pipes/standard/tank/air{
	desc = "Seemingly a component of the USS Almayer's air system that vents breathable air all over the ship. It's right next to the Disposals room, for some fucking reason. No wonder the ship always smells like shit."
	},
/obj/structure/sign/safety/distribution_pipes{
	pixel_x = 8;
	pixel_y = 32
	},
/turf/open/floor/almayer{
	icon_state = "plate";
	tag = "icon-sterile"
	},
/area/almayer/hull/lower_hull/l_m_p)
"YF" = (
/obj/structure/surface/table/almayer,
/obj/effect/decal/cleanable/vomit,
/obj/effect/spawner/random/toy,
/obj/item/reagent_container/food/drinks/sillycup{
	pixel_x = -12
	},
/turf/open/floor/almayer{
	icon_state = "plate";
	tag = "icon-sterile"
	},
/area/almayer/hull/lower_hull/l_m_p)
"Zi" = (
/obj/structure/surface/rack,
/obj/structure/window/reinforced{
	dir = 4
	},
/obj/structure/window/reinforced{
	dir = 8
	},
/obj/structure/window/reinforced{
	dir = 8
	},
/obj/effect/spawner/random/tech_supply,
/obj/effect/spawner/random/tech_supply,
/obj/effect/spawner/random/tech_supply,
/obj/item/stack/sheet/wood/large_stack,
/obj/effect/spider/stickyweb,
/turf/open/floor/plating/plating_catwalk,
/area/almayer/hull/lower_hull/l_m_p)
"ZX" = (
/obj/structure{
	health = 150;
	icon = 'icons/obj/pipes/pipes.dmi';
	icon_state = "intact-scrubbers";
	indestructible = 1;
	layer = 4.5;
	pixel_x = -4;
	projectile_coverage = 0;
	unacidable = 1;
	dir = 9
	},
/obj/structure/largecrate/random/mini/med{
	pixel_x = 5;
	pixel_y = -3
	},
/obj/structure/largecrate/random/mini/med{
	pixel_x = -12;
	pixel_y = -3
	},
/obj/structure/largecrate/random/mini/chest{
	pixel_y = 8;
	pixel_x = -2
	},
/obj/structure/machinery/light/small/broken,
/turf/open/floor/almayer{
	icon_state = "plate";
	tag = "icon-sterile"
	},
/area/almayer/hull/lower_hull/l_m_p)

(1,1,1) = {"
AN
AN
Fp
Fp
Fp
Fp
Fp
Fp
Fp
"}
(2,1,1) = {"
AN
pE
VJ
PM
KR
Rd
qe
CX
Tp
"}
(3,1,1) = {"
AN
hz
br
fT
lp
NZ
sW
UN
xE
"}
(4,1,1) = {"
AN
Nx
jk
lW
iP
QW
yH
AZ
Fp
"}
(5,1,1) = {"
AN
hG
uG
hi
uw
ku
JQ
Xk
Fp
"}
(6,1,1) = {"
AN
Db
Wl
YF
uw
Mr
bY
xP
Fp
"}
(7,1,1) = {"
AN
wH
mn
Hg
uw
Qb
pv
mt
Fp
"}
(8,1,1) = {"
AN
wW
jC
IB
iP
Yj
qf
SN
Fp
"}
(9,1,1) = {"
AN
hz
cp
vl
lp
mk
rL
eD
Fp
"}
(10,1,1) = {"
AN
vP
Ld
Zi
AN
vw
wX
Xv
Fp
"}
(11,1,1) = {"
AN
AN
qm
qm
AN
cr
bD
ZX
Fp
"}
(12,1,1) = {"
AN
zd
vJ
vJ
mE
os
xE
FO
Fp
"}
(13,1,1) = {"
AN
LT
gM
Ir
wN
Oy
us
IA
Fp
"}
(14,1,1) = {"
AN
Ha
xE
Fp
dl
Fp
Fp
Fp
Fp
"}
