//MAP CONVERTED BY dmm2tgm.py THIS HEADER COMMENT PREVENTS RECONVERSION, DO NOT REMOVE
"a" = (
/turf/closed/wall/shiva/prefabricated/pink,
/area/shiva/exterior/lz2_fortress)
"u" = (
/turf/open/auto_turf/snow/layer2,
/area/shiva/exterior/cp_lz2)
"w" = (
/turf/open/floor/shiva/north,
/area/shiva/exterior/lz2_fortress)
"C" = (
/turf/open/auto_turf/snow/layer4,
/area/shiva/exterior/cp_lz2)

(1,1,1) = {"
w
w
a
a
w
w
"}
(2,1,1) = {"
w
w
a
a
w
w
"}
(3,1,1) = {"
a
a
a
a
a
a
"}
(4,1,1) = {"
a
a
a
a
a
a
"}
(5,1,1) = {"
u
C
a
a
C
C
"}
(6,1,1) = {"
u
C
a
a
u
u
"}
