//MAP CONVERTED BY dmm2tgm.py THIS HEADER COMMENT PREVENTS RECONVERSION, DO NOT REMOVE
"a" = (
/turf/closed/wall/shiva/prefabricated/reinforced/hull,
/area/shiva/exterior/lz2_fortress)
"c" = (
/turf/open/floor/shiva/north,
/area/shiva/exterior/lz2_fortress)
"s" = (
/turf/open/auto_turf/snow/layer4,
/area/shiva/exterior/cp_lz2)
"S" = (
/turf/open/auto_turf/snow/layer2,
/area/shiva/exterior/cp_lz2)

(1,1,1) = {"
c
c
a
a
c
c
"}
(2,1,1) = {"
c
c
a
a
c
c
"}
(3,1,1) = {"
a
a
a
a
a
a
"}
(4,1,1) = {"
a
a
a
a
a
a
"}
(5,1,1) = {"
S
s
a
a
s
s
"}
(6,1,1) = {"
S
s
a
a
S
S
"}
