//MAP CONVERTED BY dmm2tgm.py THIS HEADER COMMENT PREVENTS RECONVERSION, DO NOT REMOVE
"d" = (
/turf/closed/wall/rock/brown,
/area/lv624/ground/caves/central_caves)
"e" = (
/obj/effect/alien/weeds/node,
/turf/open/gm/dirt,
/area/lv624/ground/caves/central_caves)
"f" = (
/turf/open/gm/dirt,
/area/lv624/ground/caves/central_caves)
"g" = (
/obj/effect/landmark/structure_spawner/xvx_hive/xeno_door,
/obj/effect/landmark/structure_spawner/setup/distress/xeno_door,
/turf/open/gm/dirt,
/area/lv624/ground/caves/central_caves)
"h" = (
/obj/structure/blocker/forcefield/vehicles,
/turf/open/gm/dirt,
/area/lv624/ground/caves/central_caves)
"i" = (
/obj/structure/blocker/forcefield/vehicles,
/obj/effect/landmark/structure_spawner/xvx_hive/xeno_door,
/obj/effect/landmark/structure_spawner/setup/distress/xeno_door,
/turf/open/gm/dirt,
/area/lv624/ground/caves/south_central_caves)
"k" = (
/turf/open/gm/dirt,
/area/lv624/ground/barrens/north_east_barrens)
"l" = (
/turf/closed/wall/rock/brown,
/area/lv624/ground/caves/south_central_caves)
"m" = (
/obj/effect/alien/weeds/node,
/turf/open/gm/dirt,
/area/lv624/ground/barrens/north_east_barrens)
"n" = (
/obj/effect/landmark/structure_spawner/xvx_hive/xeno_wall,
/obj/effect/landmark/structure_spawner/setup/distress/xeno_wall,
/turf/open/gm/dirt,
/area/lv624/ground/caves/south_central_caves)
"o" = (
/obj/structure/fence,
/turf/open/floor{
	dir = 9;
	icon_state = "warning"
	},
/area/lv624/ground/barrens/containers)
"p" = (
/obj/structure/fence,
/turf/open/floor{
	dir = 1;
	icon_state = "warning"
	},
/area/lv624/ground/barrens/containers)
"w" = (
/obj/structure/blocker/forcefield/vehicles,
/turf/open/gm/dirt,
/area/lv624/ground/barrens/west_barrens)
"z" = (
/obj/effect/landmark/structure_spawner/xvx_hive/xeno_door,
/obj/effect/landmark/structure_spawner/setup/distress/xeno_door,
/obj/effect/alien/weeds/node,
/turf/open/gm/dirt,
/area/lv624/ground/caves/central_caves)
"A" = (
/obj/effect/landmark/structure_spawner/xvx_hive/xeno_wall,
/obj/effect/landmark/structure_spawner/setup/distress/xeno_wall,
/turf/open/gm/dirt,
/area/lv624/ground/caves/central_caves)
"G" = (
/obj/effect/alien/weeds/node,
/turf/open/gm/dirt,
/area/lv624/ground/caves/south_central_caves)
"Q" = (
/obj/effect/landmark/structure_spawner/xvx_hive/xeno_door,
/obj/effect/landmark/structure_spawner/setup/distress/xeno_door,
/turf/open/gm/dirt,
/area/lv624/ground/caves/south_central_caves)
"V" = (
/turf/open/gm/dirt,
/area/lv624/ground/caves/south_central_caves)

(1,1,1) = {"
f
z
V
V
V
V
G
V
V
Q
V
V
V
V
l
l
l
l
l
l
l
"}
(2,1,1) = {"
f
g
V
V
V
V
V
V
V
Q
V
V
V
V
l
l
l
l
l
l
l
"}
(3,1,1) = {"
f
g
V
G
V
V
l
l
n
n
V
G
V
V
l
l
l
l
l
l
w
"}
(4,1,1) = {"
f
A
V
V
l
l
l
l
l
l
V
V
V
V
V
l
l
l
V
V
w
"}
(5,1,1) = {"
d
l
l
l
l
l
l
l
l
l
V
V
V
V
V
l
l
V
V
V
w
"}
(6,1,1) = {"
d
l
l
l
l
l
l
l
l
l
V
V
V
V
V
l
V
V
V
G
w
"}
(7,1,1) = {"
d
l
l
l
l
l
l
l
l
l
l
V
V
G
V
V
V
V
V
V
w
"}
(8,1,1) = {"
d
l
l
l
l
l
l
l
l
l
l
l
V
V
V
V
V
V
V
V
w
"}
(9,1,1) = {"
d
l
l
l
l
l
l
l
l
l
l
l
V
V
V
V
G
n
n
l
l
"}
(10,1,1) = {"
d
l
l
l
l
l
l
l
l
l
l
l
V
V
V
V
n
n
l
l
l
"}
(11,1,1) = {"
d
l
l
l
l
l
l
l
l
l
l
l
l
V
V
n
n
l
l
l
l
"}
(12,1,1) = {"
d
l
l
l
l
l
l
l
l
l
l
l
l
l
n
n
l
l
l
l
l
"}
(13,1,1) = {"
d
l
l
l
l
l
l
l
l
l
l
l
l
l
l
l
l
l
l
l
l
"}
(14,1,1) = {"
d
l
l
l
l
l
l
l
l
l
l
l
l
l
l
l
l
l
l
l
l
"}
(15,1,1) = {"
d
l
l
l
l
l
l
l
l
l
l
l
l
l
l
l
l
l
l
l
l
"}
(16,1,1) = {"
d
l
l
l
l
l
l
l
l
l
l
l
l
l
l
l
l
l
l
l
l
"}
(17,1,1) = {"
d
l
l
l
l
l
l
l
l
l
l
l
l
n
n
V
l
l
l
l
l
"}
(18,1,1) = {"
d
l
l
l
l
V
l
l
l
l
n
n
n
n
G
V
V
n
l
l
l
"}
(19,1,1) = {"
d
l
l
l
V
V
V
l
l
n
n
V
V
V
V
V
V
n
l
l
l
"}
(20,1,1) = {"
d
l
l
V
V
V
V
V
V
Q
V
V
V
V
V
V
V
n
n
l
l
"}
(21,1,1) = {"
d
l
V
V
V
V
V
G
V
Q
V
V
V
V
V
V
G
V
n
l
l
"}
(22,1,1) = {"
d
V
V
V
V
V
V
V
V
Q
V
V
G
V
V
V
V
V
n
l
l
"}
(23,1,1) = {"
d
V
V
V
V
V
V
V
V
n
n
V
V
V
V
V
V
V
n
l
l
"}
(24,1,1) = {"
d
V
V
V
G
V
V
V
l
l
n
n
V
V
V
V
V
V
V
l
l
"}
(25,1,1) = {"
d
V
V
V
V
V
V
l
l
l
l
n
n
V
V
V
V
V
l
l
l
"}
(26,1,1) = {"
f
V
V
V
V
V
l
l
l
l
l
l
n
V
V
G
V
V
l
l
l
"}
(27,1,1) = {"
f
V
V
V
V
l
l
l
l
l
l
l
l
V
V
V
V
l
l
l
o
"}
(28,1,1) = {"
f
e
V
V
V
l
l
l
l
l
l
l
l
V
V
V
V
l
l
l
p
"}
(29,1,1) = {"
f
f
V
V
l
l
l
l
l
l
l
l
l
i
i
i
l
l
l
l
p
"}
(30,1,1) = {"
f
f
f
l
l
l
l
l
l
l
l
l
l
k
k
k
l
k
k
k
p
"}
(31,1,1) = {"
f
f
f
l
l
l
l
l
l
l
l
l
k
k
m
k
k
k
k
k
p
"}
(32,1,1) = {"
f
f
l
l
l
l
l
l
l
l
l
l
l
k
k
k
k
k
m
k
p
"}
(33,1,1) = {"
f
f
h
k
k
k
k
l
l
k
k
l
k
k
k
k
k
k
k
k
p
"}
