//MAP CONVERTED BY dmm2tgm.py THIS HEADER COMMENT PREVENTS RECONVERSION, DO NOT REMOVE
"d" = (
/turf/closed/wall/shiva/ice,
/area/lv624/ground/caves/central_caves)
"e" = (
/obj/effect/landmark/structure_spawner/setup/distress/xeno_weed_node,
/turf/open/auto_turf/snow/layer0,
/area/lv624/ground/caves/central_caves)
"g" = (
/obj/effect/landmark/structure_spawner/xvx_hive/xeno_door,
/obj/effect/landmark/structure_spawner/setup/distress/xeno_door,
/turf/open/auto_turf/snow/layer0,
/area/lv624/ground/caves/central_caves)
"h" = (
/obj/structure/blocker/forcefield/multitile_vehicles,
/turf/open/auto_turf/snow/layer2,
/area/lv624/ground/caves/central_caves)
"i" = (
/obj/structure/blocker/forcefield/multitile_vehicles,
/obj/effect/landmark/structure_spawner/xvx_hive/xeno_door,
/obj/effect/landmark/structure_spawner/setup/distress/xeno_door,
/turf/open/auto_turf/snow/layer0,
/area/lv624/ground/caves/south_central_caves)
"m" = (
/obj/effect/landmark/structure_spawner/setup/distress/xeno_weed_node,
/turf/open/auto_turf/snow/layer0,
/area/lv624/ground/barrens/north_east_barrens)
"n" = (
/obj/effect/landmark/structure_spawner/xvx_hive/xeno_wall,
/obj/effect/landmark/structure_spawner/setup/distress/xeno_wall,
/turf/open/auto_turf/snow/layer0,
/area/lv624/ground/caves/south_central_caves)
"o" = (
/obj/structure/fence,
/turf/open/floor{
	dir = 9;
	icon_state = "warning"
	},
/area/lv624/ground/barrens/containers)
"p" = (
/obj/structure/fence,
/turf/open/floor{
	dir = 1;
	icon_state = "warning"
	},
/area/lv624/ground/barrens/containers)
"w" = (
/obj/structure/blocker/forcefield/multitile_vehicles,
/turf/open/auto_turf/snow/layer0,
/area/lv624/ground/barrens/west_barrens)
"A" = (
/obj/effect/landmark/structure_spawner/xvx_hive/xeno_wall,
/obj/effect/landmark/structure_spawner/setup/distress/xeno_wall,
/turf/open/auto_turf/snow/layer0,
/area/lv624/ground/caves/central_caves)
"C" = (
/obj/effect/landmark/objective_landmark/close,
/turf/open/auto_turf/snow/layer0,
/area/lv624/ground/caves/south_central_caves)
"E" = (
/turf/closed/wall/shiva/ice,
/area/lv624/ground/caves/south_central_caves)
"G" = (
/obj/effect/landmark/structure_spawner/setup/distress/xeno_weed_node,
/turf/open/auto_turf/snow/layer0,
/area/lv624/ground/caves/south_central_caves)
"I" = (
/turf/open/auto_turf/snow/layer0,
/area/lv624/ground/barrens/north_east_barrens)
"M" = (
/turf/open/auto_turf/snow/layer2,
/area/lv624/ground/barrens/north_east_barrens)
"N" = (
/obj/effect/landmark/hunter_primary,
/turf/open/auto_turf/snow/layer0,
/area/lv624/ground/caves/south_central_caves)
"O" = (
/turf/open/auto_turf/snow/layer0,
/area/lv624/ground/caves/central_caves)
"Q" = (
/obj/effect/landmark/structure_spawner/xvx_hive/xeno_door,
/obj/effect/landmark/structure_spawner/setup/distress/xeno_door,
/turf/open/auto_turf/snow/layer0,
/area/lv624/ground/caves/south_central_caves)
"S" = (
/turf/open/auto_turf/snow/layer2,
/area/lv624/ground/caves/south_central_caves)
"U" = (
/obj/effect/landmark/structure_spawner/setup/distress/xeno_weed_node,
/turf/open/auto_turf/snow/layer2,
/area/lv624/ground/caves/south_central_caves)
"V" = (
/turf/open/auto_turf/snow/layer0,
/area/lv624/ground/caves/south_central_caves)
"Z" = (
/turf/open/auto_turf/snow/layer2,
/area/lv624/ground/caves/central_caves)

(1,1,1) = {"
O
g
V
V
N
S
S
V
V
Q
V
V
V
V
E
E
E
E
E
E
E
"}
(2,1,1) = {"
O
g
V
U
S
S
S
S
V
Q
V
V
V
V
E
E
E
E
E
E
E
"}
(3,1,1) = {"
O
g
V
S
S
E
E
E
V
Q
V
G
V
V
E
E
E
E
E
E
w
"}
(4,1,1) = {"
O
A
E
E
E
E
E
E
E
E
V
V
V
V
V
E
E
E
V
V
w
"}
(5,1,1) = {"
d
E
E
E
E
E
E
E
E
E
V
V
V
V
V
E
E
V
V
V
w
"}
(6,1,1) = {"
d
E
E
E
E
E
E
E
E
E
C
V
V
V
V
E
V
V
V
G
w
"}
(7,1,1) = {"
d
E
E
E
E
E
E
E
E
E
E
V
V
G
V
V
V
V
V
V
w
"}
(8,1,1) = {"
d
E
E
E
E
E
E
E
E
E
E
E
V
V
V
V
V
V
V
V
w
"}
(9,1,1) = {"
d
E
E
E
E
E
E
E
E
E
E
E
V
V
V
V
G
n
n
E
E
"}
(10,1,1) = {"
d
E
E
E
E
E
E
E
E
E
E
E
V
V
V
V
n
n
E
E
E
"}
(11,1,1) = {"
d
E
E
E
E
E
E
E
E
E
E
E
E
V
V
n
n
E
E
E
E
"}
(12,1,1) = {"
d
E
E
E
E
E
E
E
E
E
E
E
E
E
n
n
E
E
E
E
E
"}
(13,1,1) = {"
d
E
E
E
E
E
E
E
E
E
E
E
E
E
E
E
E
E
E
E
E
"}
(14,1,1) = {"
d
E
E
E
E
E
E
E
E
E
E
E
E
E
E
E
E
E
E
E
E
"}
(15,1,1) = {"
d
E
E
E
E
E
E
E
E
E
E
E
E
E
E
E
E
E
E
E
E
"}
(16,1,1) = {"
d
E
E
E
E
E
E
E
E
E
E
E
E
E
E
E
E
E
E
E
E
"}
(17,1,1) = {"
d
E
E
E
E
E
E
E
E
E
E
E
E
n
n
V
E
E
E
E
E
"}
(18,1,1) = {"
d
E
E
E
E
V
E
E
E
E
n
n
n
n
G
V
V
n
E
E
E
"}
(19,1,1) = {"
d
E
E
E
V
V
V
E
E
n
n
V
V
V
V
V
V
n
E
E
E
"}
(20,1,1) = {"
d
E
E
V
V
V
V
V
V
Q
V
V
V
V
V
V
V
n
n
E
E
"}
(21,1,1) = {"
d
E
V
V
V
V
V
G
V
Q
V
V
V
V
V
V
G
V
n
E
E
"}
(22,1,1) = {"
d
V
V
V
V
V
V
V
V
Q
V
V
G
V
V
V
V
V
n
E
E
"}
(23,1,1) = {"
d
V
V
V
V
V
V
V
V
n
n
V
V
V
V
V
V
V
n
E
E
"}
(24,1,1) = {"
d
V
V
V
G
V
V
V
E
E
n
n
V
V
V
V
V
V
V
E
E
"}
(25,1,1) = {"
d
V
V
V
V
V
V
E
E
E
E
n
n
V
V
V
V
V
E
E
E
"}
(26,1,1) = {"
O
V
V
V
V
V
E
E
E
E
E
E
n
V
V
G
V
C
E
E
E
"}
(27,1,1) = {"
O
V
V
V
V
E
E
E
E
E
E
E
E
V
V
V
V
E
E
E
o
"}
(28,1,1) = {"
O
e
V
V
V
E
E
E
E
E
E
E
E
V
V
V
V
E
E
E
p
"}
(29,1,1) = {"
O
O
S
S
E
E
E
E
E
E
E
E
E
i
i
i
E
E
E
E
p
"}
(30,1,1) = {"
O
O
Z
E
E
E
E
E
E
E
E
E
E
I
I
I
E
I
I
I
p
"}
(31,1,1) = {"
O
O
Z
E
E
E
E
E
E
E
E
E
I
I
m
I
I
I
I
I
p
"}
(32,1,1) = {"
O
Z
E
E
E
E
E
E
E
E
E
E
E
I
I
I
I
I
m
I
p
"}
(33,1,1) = {"
O
O
h
M
M
M
M
E
E
M
I
E
I
I
I
I
I
I
I
I
p
"}
