//MAP CONVERTED BY dmm2tgm.py THIS HEADER COMMENT PREVENTS RECONVERSION, DO NOT REMOVE
"b" = (
/obj/effect/decal/grass_overlay/grass1{
	dir = 8
	},
/turf/open/gm/dirt,
/area/lv624/ground/caves/south_central_caves)
"d" = (
/turf/closed/wall/rock/brown,
/area/lv624/ground/caves/central_caves)
"e" = (
/obj/effect/landmark/structure_spawner/setup/distress/xeno_weed_node,
/turf/open/gm/dirt,
/area/lv624/ground/caves/central_caves)
"f" = (
/turf/open/gm/dirt,
/area/lv624/ground/caves/central_caves)
"g" = (
/obj/effect/landmark/structure_spawner/xvx_hive/xeno_door,
/obj/effect/landmark/structure_spawner/setup/distress/xeno_door,
/turf/open/gm/dirt,
/area/lv624/ground/caves/central_caves)
"h" = (
/obj/structure/blocker/forcefield/multitile_vehicles,
/turf/open/auto_turf/strata_grass/layer1,
/area/lv624/ground/caves/central_caves)
"i" = (
/obj/structure/blocker/forcefield/multitile_vehicles,
/obj/effect/landmark/structure_spawner/xvx_hive/xeno_door,
/obj/effect/landmark/structure_spawner/setup/distress/xeno_door,
/turf/open/gm/dirt,
/area/lv624/ground/caves/south_central_caves)
"j" = (
/obj/item/reagent_container/food/snacks/grown/mushroom/amanita,
/turf/open/auto_turf/strata_grass/layer1,
/area/lv624/ground/caves/central_caves)
"k" = (
/turf/open/gm/dirt,
/area/lv624/ground/barrens/north_east_barrens)
"l" = (
/turf/closed/wall/rock/brown,
/area/lv624/ground/caves/south_central_caves)
"m" = (
/obj/effect/landmark/structure_spawner/setup/distress/xeno_weed_node,
/turf/open/gm/dirt,
/area/lv624/ground/barrens/north_east_barrens)
"n" = (
/obj/effect/landmark/structure_spawner/xvx_hive/xeno_wall,
/obj/effect/landmark/structure_spawner/setup/distress/xeno_wall,
/turf/open/gm/dirt,
/area/lv624/ground/caves/south_central_caves)
"o" = (
/obj/structure/fence,
/turf/open/floor/warning/northwest,
/area/lv624/ground/barrens/containers)
"p" = (
/obj/structure/fence,
/turf/open/floor/warning/north,
/area/lv624/ground/barrens/containers)
"q" = (
/obj/effect/decal/grass_overlay/grass1/inner,
/turf/open/gm/dirt,
/area/lv624/ground/caves/central_caves)
"r" = (
/obj/effect/decal/grass_overlay/grass1/inner{
	dir = 10
	},
/turf/open/gm/dirt,
/area/lv624/ground/caves/central_caves)
"t" = (
/obj/item/reagent_container/food/snacks/grown/mushroom/glowshroom{
	pixel_x = 4;
	light_on = 1;
	light_range = 1;
	light_system = 1
	},
/turf/open/auto_turf/strata_grass/layer1,
/area/lv624/ground/barrens/north_east_barrens)
"u" = (
/turf/open/auto_turf/strata_grass/layer1,
/area/lv624/ground/caves/central_caves)
"v" = (
/obj/effect/decal/grass_overlay/grass1,
/turf/open/gm/dirt,
/area/lv624/ground/caves/south_central_caves)
"w" = (
/obj/structure/blocker/forcefield/multitile_vehicles,
/turf/open/gm/dirt,
/area/lv624/ground/barrens/west_barrens)
"x" = (
/obj/effect/decal/grass_overlay/grass1/inner{
	dir = 6
	},
/turf/open/gm/dirt,
/area/lv624/ground/caves/central_caves)
"y" = (
/obj/effect/landmark/hunter_primary,
/obj/effect/decal/grass_overlay/grass1/inner{
	dir = 10
	},
/turf/open/gm/dirt,
/area/lv624/ground/caves/south_central_caves)
"z" = (
/obj/effect/decal/grass_overlay/grass1/inner{
	dir = 9
	},
/turf/open/gm/dirt,
/area/lv624/ground/caves/south_central_caves)
"A" = (
/obj/effect/landmark/structure_spawner/xvx_hive/xeno_wall,
/obj/effect/landmark/structure_spawner/setup/distress/xeno_wall,
/turf/open/gm/dirt,
/area/lv624/ground/caves/central_caves)
"B" = (
/obj/effect/decal/grass_overlay/grass1{
	dir = 9
	},
/turf/open/gm/dirt,
/area/lv624/ground/caves/south_central_caves)
"C" = (
/obj/effect/landmark/objective_landmark/close,
/turf/open/gm/dirt,
/area/lv624/ground/caves/south_central_caves)
"D" = (
/obj/effect/decal/grass_overlay/grass1/inner{
	dir = 8
	},
/turf/open/gm/dirt,
/area/lv624/ground/caves/south_central_caves)
"E" = (
/turf/closed/wall/strata_ice/jungle,
/area/lv624/ground/caves/south_central_caves)
"F" = (
/obj/effect/decal/grass_overlay/grass1{
	dir = 10
	},
/turf/open/gm/dirt,
/area/lv624/ground/caves/south_central_caves)
"G" = (
/obj/effect/landmark/structure_spawner/setup/distress/xeno_weed_node,
/turf/open/gm/dirt,
/area/lv624/ground/caves/south_central_caves)
"H" = (
/turf/open/auto_turf/strata_grass/layer1,
/area/lv624/ground/barrens/north_east_barrens)
"I" = (
/obj/effect/decal/grass_overlay/grass1{
	dir = 1
	},
/turf/open/gm/dirt,
/area/lv624/ground/barrens/north_east_barrens)
"K" = (
/obj/item/reagent_container/food/snacks/grown/mushroom/glowshroom{
	pixel_x = 2;
	pixel_y = 7;
	light_on = 1;
	light_range = 1;
	light_system = 1
	},
/turf/open/auto_turf/strata_grass/layer1,
/area/lv624/ground/caves/south_central_caves)
"M" = (
/obj/structure/flora/bush/ausbushes/var3/fullgrass,
/turf/open/auto_turf/strata_grass/layer1,
/area/lv624/ground/barrens/north_east_barrens)
"Q" = (
/obj/effect/landmark/structure_spawner/xvx_hive/xeno_door,
/obj/effect/landmark/structure_spawner/setup/distress/xeno_door,
/turf/open/gm/dirt,
/area/lv624/ground/caves/south_central_caves)
"R" = (
/obj/effect/decal/grass_overlay/grass1{
	dir = 1
	},
/turf/open/gm/dirt,
/area/lv624/ground/caves/south_central_caves)
"S" = (
/turf/open/auto_turf/strata_grass/layer1,
/area/lv624/ground/caves/south_central_caves)
"U" = (
/obj/effect/landmark/structure_spawner/setup/distress/xeno_weed_node,
/turf/open/auto_turf/strata_grass/layer1,
/area/lv624/ground/caves/south_central_caves)
"V" = (
/turf/open/gm/dirt,
/area/lv624/ground/caves/south_central_caves)
"Z" = (
/obj/structure/flora/bush/ausbushes/var3/ppflowers,
/turf/open/auto_turf/strata_grass/layer1,
/area/lv624/ground/caves/central_caves)

(1,1,1) = {"
l
l
l
l
l
l
l
V
V
V
V
Q
B
z
S
S
y
b
F
g
f
"}
(2,1,1) = {"
l
l
l
l
l
l
l
V
V
V
V
Q
R
S
S
K
S
U
v
g
f
"}
(3,1,1) = {"
w
l
l
l
l
l
l
V
V
G
V
Q
R
l
E
E
S
S
v
g
f
"}
(4,1,1) = {"
w
V
V
l
l
l
V
V
V
V
V
l
l
l
l
E
E
l
l
A
f
"}
(5,1,1) = {"
w
V
V
V
l
l
V
V
V
V
V
l
l
l
l
l
l
l
l
l
d
"}
(6,1,1) = {"
w
G
V
V
V
l
V
V
V
V
C
l
l
l
l
l
l
l
l
l
d
"}
(7,1,1) = {"
w
V
V
V
V
V
V
G
V
V
l
l
l
l
l
l
l
l
l
l
d
"}
(8,1,1) = {"
w
V
V
V
V
V
V
V
V
l
l
l
l
l
l
l
l
l
l
l
d
"}
(9,1,1) = {"
l
l
n
n
G
V
V
V
V
l
l
l
l
l
l
l
l
l
l
l
d
"}
(10,1,1) = {"
l
l
l
n
n
V
V
V
V
l
l
l
l
l
l
l
l
l
l
l
d
"}
(11,1,1) = {"
l
l
l
l
n
n
V
V
l
l
l
l
l
l
l
l
l
l
l
l
d
"}
(12,1,1) = {"
l
l
l
l
l
n
n
l
l
l
l
l
l
l
l
l
l
l
l
l
d
"}
(13,1,1) = {"
l
l
l
l
l
l
l
l
l
l
l
l
l
l
l
l
l
l
l
l
d
"}
(14,1,1) = {"
l
l
l
l
l
l
l
l
l
l
l
l
l
l
l
l
l
l
l
l
d
"}
(15,1,1) = {"
l
l
l
l
l
l
l
l
l
l
l
l
l
l
l
l
l
l
l
l
d
"}
(16,1,1) = {"
l
l
l
l
l
l
l
l
l
l
l
l
l
l
l
l
l
l
l
l
d
"}
(17,1,1) = {"
l
l
l
l
l
V
n
n
l
l
l
l
l
l
l
l
l
l
l
l
d
"}
(18,1,1) = {"
l
l
l
n
V
V
G
n
n
n
n
l
l
l
l
V
l
l
l
l
d
"}
(19,1,1) = {"
l
l
l
n
V
V
V
V
V
V
n
n
l
l
V
V
V
l
l
l
d
"}
(20,1,1) = {"
l
l
n
n
V
V
V
V
V
V
V
Q
V
V
V
V
V
V
l
l
d
"}
(21,1,1) = {"
l
l
n
V
G
V
V
V
V
V
V
Q
V
G
V
V
V
V
V
l
d
"}
(22,1,1) = {"
l
l
n
V
V
V
V
V
G
V
V
Q
V
V
V
V
V
V
V
V
d
"}
(23,1,1) = {"
l
l
n
V
V
V
V
V
V
V
n
n
V
V
V
V
V
V
V
V
d
"}
(24,1,1) = {"
l
l
V
V
V
V
V
V
V
n
n
l
l
V
V
V
G
V
V
V
d
"}
(25,1,1) = {"
l
l
l
V
V
V
V
V
n
n
l
l
l
l
V
V
V
V
V
V
d
"}
(26,1,1) = {"
l
l
l
C
V
G
V
V
n
l
l
l
l
l
l
V
V
V
V
V
f
"}
(27,1,1) = {"
o
l
l
l
V
V
V
V
l
l
l
l
l
l
l
l
V
V
V
V
f
"}
(28,1,1) = {"
p
l
l
l
V
V
V
V
l
l
l
l
l
l
l
l
D
D
D
e
f
"}
(29,1,1) = {"
p
l
l
l
l
i
i
i
l
l
l
l
l
l
l
l
l
S
S
q
f
"}
(30,1,1) = {"
p
k
k
k
l
k
k
k
l
l
l
l
l
l
l
l
l
l
j
q
f
"}
(31,1,1) = {"
p
k
k
k
k
k
m
k
k
l
l
l
l
l
l
l
l
E
Z
r
f
"}
(32,1,1) = {"
p
k
m
k
k
k
k
k
l
l
l
E
E
l
l
l
l
E
E
u
q
"}
(33,1,1) = {"
p
k
k
k
k
k
k
k
k
l
I
t
E
E
M
H
H
H
h
x
f
"}
