//MAP CONVERTED BY dmm2tgm.py THIS HEADER COMMENT PREVENTS RECONVERSION, DO NOT REMOVE
"aa" = (
/obj/structure/bed/chair/dropship/pilot{
	dir = 1
	},
/obj/item/clothing/head/helmet/marine/veteran/pmc/leader,
/turf/open/shuttle/bright_red,
/area/lv624/lazarus/crashed_ship_containers)
"ab" = (
/obj/structure/bed/chair/dropship/pilot{
	dir = 1
	},
/turf/open/shuttle/bright_red,
/area/lv624/lazarus/crashed_ship_containers)
"ac" = (
/obj/structure/girder/displaced,
/obj/structure/shuttle/engine/propulsion{
	dir = 1
	},
/turf/open/gm/dirt,
/area/lv624/lazarus/crashed_ship_containers)
"ad" = (
/obj/structure/girder/displaced,
/obj/effect/decal/cleanable/blood/oil,
/obj/structure/shuttle/engine/propulsion{
	dir = 1
	},
/turf/open/gm/dirt,
/area/lv624/lazarus/crashed_ship_containers)
"ae" = (
/obj/structure/shuttle/engine/propulsion{
	dir = 1
	},
/obj/effect/decal/cleanable/blood/oil,
/turf/open/gm/dirt,
/area/lv624/ground/barrens/north_east_barrens)
"aO" = (
/obj/structure/girder/displaced,
/obj/effect/decal/cleanable/blood/oil,
/turf/open/gm/dirt,
/area/lv624/lazarus/crashed_ship_containers)
"aY" = (
/obj/structure/girder,
/turf/open/gm/dirt,
/area/lv624/lazarus/crashed_ship_containers)
"bB" = (
/obj/item/clothing/shoes/veteran/pmc,
/obj/structure/foamed_metal,
/turf/open/shuttle/bright_red,
/area/lv624/lazarus/crashed_ship_containers)
"cv" = (
/obj/structure/bed/chair{
	dir = 8
	},
/turf/open/shuttle/bright_red,
/area/lv624/lazarus/crashed_ship_containers)
"cV" = (
/obj/item/storage/toolbox/electrical,
/turf/open/shuttle/bright_red,
/area/lv624/lazarus/crashed_ship_containers)
"cZ" = (
/obj/item/storage/toolbox/mechanical,
/obj/effect/decal/cleanable/blood,
/turf/open/gm/dirt,
/area/lv624/lazarus/crashed_ship_containers)
"eE" = (
/obj/structure/girder,
/obj/effect/decal/cleanable/blood/oil,
/turf/open/gm/dirt,
/area/lv624/lazarus/crashed_ship_containers)
"eW" = (
/obj/effect/landmark/crap_item,
/turf/open/floor/airless/asteroidfloor/northeast,
/area/lv624/ground/barrens/north_east_barrens)
"gu" = (
/obj/item/stack/cable_coil/random,
/obj/item/explosive/grenade/high_explosive,
/obj/item/explosive/grenade/high_explosive,
/obj/structure/foamed_metal,
/turf/open/shuttle/bright_red,
/area/lv624/lazarus/crashed_ship_containers)
"ip" = (
/obj/effect/decal/cleanable/blood,
/turf/open/shuttle/bright_red,
/area/lv624/lazarus/crashed_ship_containers)
"jo" = (
/obj/item/tool/shovel/spade,
/turf/open/gm/dirt,
/area/lv624/ground/barrens/north_east_barrens)
"jE" = (
/obj/structure/xenoautopsy/tank/broken,
/turf/open/shuttle/bright_red,
/area/lv624/lazarus/crashed_ship_containers)
"kp" = (
/obj/effect/landmark/crap_item,
/turf/open/shuttle/bright_red,
/area/lv624/lazarus/crashed_ship_containers)
"kP" = (
/obj/structure/girder/displaced,
/obj/structure/foamed_metal,
/turf/open/gm/dirt,
/area/lv624/lazarus/crashed_ship_containers)
"nt" = (
/obj/effect/landmark/crap_item,
/turf/open/gm/dirt,
/area/lv624/lazarus/crashed_ship_containers)
"nv" = (
/obj/structure/girder/displaced,
/turf/open/gm/dirt,
/area/lv624/lazarus/crashed_ship_containers)
"oT" = (
/obj/effect/spawner/random/toolbox,
/turf/open/gm/dirt,
/area/lv624/lazarus/crashed_ship_containers)
"pp" = (
/obj/structure/girder,
/turf/open/gm/dirt,
/area/lv624/ground/barrens/north_east_barrens)
"tf" = (
/obj/structure/machinery/constructable_frame{
	icon_state = "box_1"
	},
/obj/structure/foamed_metal,
/turf/open/gm/dirt,
/area/lv624/lazarus/crashed_ship_containers)
"tv" = (
/turf/open/shuttle/bright_red,
/area/lv624/ground/barrens/north_east_barrens)
"uw" = (
/obj/structure/bed/chair{
	dir = 8
	},
/turf/open/gm/dirt,
/area/lv624/lazarus/crashed_ship_containers)
"vA" = (
/obj/effect/landmark/objective_landmark/science,
/turf/open/shuttle/bright_red,
/area/lv624/lazarus/crashed_ship_containers)
"vD" = (
/obj/structure/surface/rack,
/obj/item/ammo_magazine/shotgun/buckshot,
/obj/item/ammo_magazine/shotgun/buckshot,
/obj/item/weapon/gun/shotgun/pump/dual_tube/cmb{
	pixel_y = 7
	},
/obj/item/weapon/gun/shotgun/pump/dual_tube/cmb,
/turf/open/gm/dirt,
/area/lv624/lazarus/crashed_ship_containers)
"xg" = (
/turf/open/shuttle/bright_red,
/area/lv624/lazarus/crashed_ship_containers)
"xt" = (
/obj/item/ammo_magazine/rifle/m16,
/obj/item/ammo_magazine/rifle/m16,
/turf/open/gm/dirt,
/area/lv624/lazarus/crashed_ship_containers)
"yj" = (
/obj/effect/landmark/objective_landmark/medium,
/turf/open/shuttle/bright_red,
/area/lv624/lazarus/crashed_ship_containers)
"yJ" = (
/obj/structure/machinery/constructable_frame{
	icon_state = "box_1"
	},
/turf/open/gm/dirt,
/area/lv624/lazarus/crashed_ship_containers)
"yV" = (
/turf/open/gm/dirt,
/area/lv624/lazarus/crashed_ship_containers)
"zH" = (
/obj/structure/foamed_metal,
/turf/open/gm/dirt,
/area/lv624/lazarus/crashed_ship_containers)
"AA" = (
/turf/closed/wall/rock/brown,
/area/lv624/ground/caves/central_caves)
"BQ" = (
/obj/structure/xenoautopsy/tank/hugger,
/turf/open/shuttle/bright_red,
/area/lv624/lazarus/crashed_ship_containers)
"Cn" = (
/obj/effect/landmark/objective_landmark/science,
/turf/open/gm/dirt,
/area/lv624/lazarus/crashed_ship_containers)
"Dw" = (
/obj/item/tool/shovel/spade,
/turf/open/gm/dirt,
/area/lv624/lazarus/crashed_ship_containers)
"DD" = (
/turf/closed/shuttle{
	icon_state = "wall3"
	},
/area/lv624/lazarus/crashed_ship_containers)
"DT" = (
/obj/structure/foamed_metal,
/turf/open/shuttle/bright_red,
/area/lv624/lazarus/crashed_ship_containers)
"Fg" = (
/obj/item/tool/warning_cone,
/turf/open/gm/dirt,
/area/lv624/lazarus/crashed_ship_containers)
"Fk" = (
/obj/effect/alien/weeds/node,
/turf/open/gm/dirt,
/area/lv624/ground/barrens/north_east_barrens)
"Gs" = (
/obj/structure/girder,
/turf/closed/shuttle{
	icon_state = "wall3"
	},
/area/lv624/lazarus/crashed_ship_containers)
"Gt" = (
/obj/effect/decal/cleanable/blood/oil,
/turf/open/gm/dirt,
/area/lv624/ground/barrens/north_east_barrens)
"HK" = (
/obj/structure/xenoautopsy/tank/broken,
/turf/open/gm/dirt,
/area/lv624/lazarus/crashed_ship_containers)
"Ie" = (
/obj/structure/surface/rack,
/obj/item/ammo_magazine/rifle/m16,
/obj/item/ammo_magazine/rifle/m16,
/obj/item/weapon/gun/rifle/m16,
/turf/open/gm/dirt,
/area/lv624/lazarus/crashed_ship_containers)
"IP" = (
/obj/effect/decal/remains/human,
/turf/open/gm/dirt,
/area/lv624/lazarus/crashed_ship_containers)
"Kz" = (
/obj/item/tool/crowbar,
/obj/effect/landmark/objective_landmark/science,
/turf/open/shuttle/bright_red,
/area/lv624/lazarus/crashed_ship_containers)
"LQ" = (
/obj/effect/landmark/corpsespawner/security,
/obj/effect/decal/cleanable/blood,
/turf/open/gm/dirt,
/area/lv624/lazarus/crashed_ship_containers)
"OV" = (
/obj/structure/girder,
/obj/structure/foamed_metal,
/turf/open/gm/dirt,
/area/lv624/lazarus/crashed_ship_containers)
"PE" = (
/turf/open/gm/dirt,
/area/lv624/ground/barrens/north_east_barrens)
"PS" = (
/turf/closed/wall/sulaco,
/area/lv624/ground/barrens/north_east_barrens)
"Ro" = (
/obj/effect/landmark/crap_item,
/turf/open/gm/dirt,
/area/lv624/ground/barrens/north_east_barrens)
"RT" = (
/obj/item/explosive/grenade/high_explosive/pmc,
/obj/structure/foamed_metal,
/turf/open/shuttle/bright_red,
/area/lv624/lazarus/crashed_ship_containers)
"SJ" = (
/turf/template_noop,
/area/lv624/ground/caves/central_caves)
"SX" = (
/obj/effect/decal/cleanable/blood,
/turf/open/gm/dirt,
/area/lv624/lazarus/crashed_ship_containers)
"UG" = (
/obj/item/clothing/suit/storage/hazardvest,
/obj/effect/decal/cleanable/blood,
/turf/open/gm/dirt,
/area/lv624/lazarus/crashed_ship_containers)
"Wu" = (
/obj/effect/decal/remains/human,
/turf/open/gm/dirt,
/area/lv624/ground/barrens/north_east_barrens)
"WF" = (
/obj/structure/girder/displaced,
/turf/closed/shuttle{
	icon_state = "wall3"
	},
/area/lv624/lazarus/crashed_ship_containers)
"WP" = (
/turf/closed/wall/rock/brown,
/area/lv624/ground/caves/south_east_caves)
"Xk" = (
/turf/closed/wall/sulaco,
/area/lv624/lazarus/crashed_ship_containers)
"Xy" = (
/obj/item/tool/pickaxe,
/turf/open/gm/dirt,
/area/lv624/lazarus/crashed_ship_containers)
"ZH" = (
/turf/open/floor/airless/asteroidfloor/northeast,
/area/lv624/ground/barrens/north_east_barrens)

(1,1,1) = {"
PE
PE
PE
PE
PE
PE
Fk
PE
Gt
ac
Gs
Xk
Xk
eE
nv
Xk
aY
Xk
Xk
AA
AA
"}
(2,1,1) = {"
PE
PE
PE
PE
PE
PS
PE
PE
WF
Xk
Xk
Xk
xg
Cn
cZ
xg
yJ
aa
tf
Xk
AA
"}
(3,1,1) = {"
PE
Fk
tv
eW
PE
PE
Wu
PE
zH
Xk
cV
yV
Dw
xg
nt
LQ
yj
yV
gu
Xk
AA
"}
(4,1,1) = {"
pp
PE
PS
PE
PE
PE
PE
PE
Fg
SX
nt
xg
vD
jE
HK
Xy
xg
oT
xg
Xk
AA
"}
(5,1,1) = {"
PE
PE
PE
PE
PE
PE
PE
PE
yV
Fg
xg
xg
bB
jE
BQ
cv
IP
yV
yJ
kP
AA
"}
(6,1,1) = {"
PE
PE
PE
Wu
Fk
PE
PS
jo
Fg
nt
IP
zH
DT
DT
Kz
zH
yV
Xy
xt
Xk
AA
"}
(7,1,1) = {"
tv
ZH
ae
pp
PE
ZH
PE
PE
Xk
Xk
vA
UG
ip
LQ
DT
RT
zH
kp
Ie
OV
AA
"}
(8,1,1) = {"
PS
PE
PE
PE
PE
tv
ZH
PE
DD
Xk
Gs
Xk
cv
uw
cv
zH
xg
ab
Xk
kP
AA
"}
(9,1,1) = {"
PE
Fk
PE
PE
PE
PS
Fk
PE
aO
ad
Gs
Xk
Gs
Gs
nv
Xk
nv
Xk
Xk
AA
AA
"}
(10,1,1) = {"
PE
PE
Ro
PE
PE
PE
PE
PE
PE
WP
WP
WP
WP
WP
WP
WP
WP
WP
WP
AA
SJ
"}
