//MAP CONVERTED BY dmm2tgm.py THIS HEADER COMMENT PREVENTS RECONVERSION, DO NOT REMOVE
"ad" = (
/turf/open/gm/coast/west,
/area/lv624/ground/river/west_river)
"af" = (
/obj/effect/landmark/lv624/fog_blocker,
/turf/open/gm/river,
/area/lv624/ground/river/west_river)
"al" = (
/obj/effect/landmark/hunter_secondary,
/turf/open/gm/dirt,
/area/lv624/ground/barrens/south_west_barrens)
"ao" = (
/turf/open/gm/coast/beachcorner2/south_west,
/area/lv624/ground/river/west_river)
"aq" = (
/turf/open/gm/coast/beachcorner/south_west,
/area/lv624/ground/river/west_river)
"as" = (
/obj/structure/flora/bush/ausbushes/var3/stalkybush,
/turf/open/gm/river,
/area/lv624/ground/river/west_river)
"at" = (
/obj/effect/decal/grass_overlay/grass1/inner{
	dir = 4
	},
/turf/open/gm/dirt,
/area/lv624/ground/barrens/south_west_barrens)
"au" = (
/obj/structure/barricade/metal/wired{
	dir = 4
	},
/turf/open/auto_turf/strata_grass/layer1,
/area/lv624/ground/barrens/south_west_barrens)
"ax" = (
/obj/structure/flora/bush/ausbushes/var3/sunnybush,
/obj/effect/decal/grass_overlay/grass1/inner{
	dir = 4
	},
/turf/open/gm/dirt,
/area/lv624/ground/barrens/south_west_barrens)
"az" = (
/turf/open/gm/dirt,
/area/lv624/ground/jungle/west_jungle)
"aC" = (
/obj/structure/flora/bush/ausbushes/palebush,
/turf/open/auto_turf/strata_grass/layer1,
/area/lv624/ground/jungle/west_jungle)
"aD" = (
/turf/open/auto_turf/strata_grass/layer1,
/area/lv624/ground/jungle/west_jungle)
"aE" = (
/obj/effect/decal/grass_overlay/grass1/inner{
	dir = 4
	},
/turf/open/gm/dirt,
/area/lv624/ground/jungle/west_jungle)
"aJ" = (
/obj/structure/flora/bush/ausbushes/var3/fullgrass,
/turf/open/gm/coast/south,
/area/lv624/ground/river/west_river)
"aU" = (
/obj/structure/flora/bush/ausbushes/var3/stalkybush,
/turf/open/auto_turf/strata_grass/layer1,
/area/lv624/ground/barrens/south_west_barrens)
"bc" = (
/turf/open/gm/river,
/area/lv624/ground/river/west_river)
"bf" = (
/obj/effect/landmark/structure_spawner/setup/distress/xeno_weed_node,
/turf/open/gm/dirt,
/area/lv624/ground/barrens/south_west_barrens)
"bh" = (
/obj/structure/flora/bush/ausbushes/reedbush,
/turf/open/gm/dirt,
/area/lv624/ground/barrens/south_west_barrens)
"bi" = (
/turf/open/gm/dirt,
/area/lv624/ground/barrens/south_west_barrens)
"bm" = (
/turf/open/gm/coast/beachcorner2/north_west,
/area/lv624/ground/river/west_river)
"bt" = (
/turf/open/gm/coast/south,
/area/lv624/ground/river/west_river)
"bw" = (
/obj/effect/decal/grass_overlay/grass1/inner{
	dir = 6
	},
/turf/open/gm/dirt,
/area/lv624/ground/barrens/south_west_barrens)
"bz" = (
/turf/open/gm/coast/beachcorner/north_west,
/area/lv624/ground/river/west_river)
"bL" = (
/turf/open/gm/coast/north,
/area/lv624/ground/river/west_river)
"bN" = (
/obj/structure/flora/bush/ausbushes/var3/fullgrass,
/turf/open/gm/river,
/area/lv624/ground/river/west_river)
"dO" = (
/obj/effect/landmark/monkey_spawn,
/turf/open/gm/dirt,
/area/lv624/ground/barrens/south_west_barrens)
"eP" = (
/obj/structure/barricade/metal/wired{
	dir = 4
	},
/obj/effect/decal/grass_overlay/grass1/inner{
	dir = 9
	},
/turf/open/gm/dirt,
/area/lv624/ground/barrens/south_west_barrens)
"gX" = (
/obj/effect/decal/grass_overlay/grass1/inner{
	dir = 1
	},
/turf/open/gm/dirt,
/area/lv624/ground/barrens/south_west_barrens)
"iR" = (
/obj/effect/decal/cleanable/blood/gibs/xeno/up,
/turf/open/auto_turf/strata_grass/layer1,
/area/lv624/ground/barrens/south_west_barrens)
"je" = (
/obj/effect/decal/grass_overlay/grass1/inner,
/turf/open/gm/dirt,
/area/lv624/ground/barrens/south_west_barrens)
"lT" = (
/obj/structure/flora/bush/ausbushes/reedbush,
/obj/effect/decal/grass_overlay/grass1/inner{
	dir = 6
	},
/turf/open/gm/dirt,
/area/lv624/ground/barrens/south_west_barrens)
"tV" = (
/obj/effect/decal/cleanable/blood/xeno,
/obj/effect/decal/grass_overlay/grass1/inner{
	dir = 1
	},
/turf/open/gm/dirt,
/area/lv624/ground/barrens/south_west_barrens)
"yn" = (
/obj/item/stack/sheet/metal{
	pixel_x = 16;
	pixel_y = -10
	},
/turf/open/auto_turf/strata_grass/layer1,
/area/lv624/ground/barrens/south_west_barrens)
"zW" = (
/obj/effect/landmark/lv624/fog_blocker,
/turf/open/gm/coast/south,
/area/lv624/ground/river/west_river)
"Dw" = (
/obj/effect/landmark/nightmare{
	insert_tag = "lv-leftsidepass"
	},
/turf/open/auto_turf/strata_grass/layer1,
/area/lv624/ground/jungle/west_jungle)
"ES" = (
/obj/effect/decal/cleanable/blood/xeno,
/turf/open/auto_turf/strata_grass/layer1,
/area/lv624/ground/barrens/south_west_barrens)
"Il" = (
/obj/effect/landmark/hunter_secondary,
/obj/structure/barricade/metal/wired{
	dir = 4
	},
/turf/open/gm/dirt,
/area/lv624/ground/barrens/south_west_barrens)
"JC" = (
/turf/closed/wall/rock/brown,
/area/lv624/ground/caves/south_west_caves)
"Kx" = (
/turf/open/auto_turf/strata_grass/layer1,
/area/lv624/ground/barrens/south_west_barrens)
"Ok" = (
/obj/structure/flora/jungle/alienplant1,
/turf/open/gm/river,
/area/lv624/ground/river/west_river)
"PV" = (
/obj/item/ammo_casing/bullet{
	icon_state = "cartridge_6_1"
	},
/turf/open/auto_turf/strata_grass/layer1,
/area/lv624/ground/barrens/south_west_barrens)
"Qw" = (
/obj/structure/flora/bush/ausbushes/var3/fullgrass,
/obj/effect/landmark/lv624/fog_blocker,
/turf/open/gm/coast/north,
/area/lv624/ground/river/west_river)
"RL" = (
/obj/effect/decal/cleanable/blood/gibs/xeno/up,
/turf/open/gm/dirt,
/area/lv624/ground/barrens/south_west_barrens)
"Za" = (
/obj/effect/decal/cleanable/blood/xeno,
/turf/open/gm/dirt,
/area/lv624/ground/barrens/south_west_barrens)

(1,1,1) = {"
JC
JC
JC
JC
bi
bi
gX
Kx
Kx
aU
Kx
Kx
Dw
"}
(2,1,1) = {"
JC
JC
JC
bi
bi
Il
eP
Kx
Kx
PV
ES
au
aC
"}
(3,1,1) = {"
JC
JC
bi
bi
bi
gX
Kx
iR
PV
Kx
Kx
Kx
aD
"}
(4,1,1) = {"
JC
JC
bi
RL
bi
tV
Kx
Kx
yn
bw
at
ax
aE
"}
(5,1,1) = {"
JC
bi
bi
bi
gX
Kx
Kx
Kx
Kx
je
bi
bi
az
"}
(6,1,1) = {"
JC
bi
bi
bi
gX
Kx
Kx
Kx
lT
bi
bi
Za
az
"}
(7,1,1) = {"
JC
bi
bi
bi
gX
Kx
Kx
Kx
je
bi
bi
bi
az
"}
(8,1,1) = {"
JC
bi
bi
bi
bi
at
at
at
bi
bi
bi
bi
az
"}
(9,1,1) = {"
JC
bi
bi
bi
bi
bi
bi
bi
bz
ad
aq
bh
bi
"}
(10,1,1) = {"
bf
bi
bi
bi
bi
bi
al
bi
bL
bc
ao
aq
bi
"}
(11,1,1) = {"
bi
bi
bi
dO
bi
bi
bi
bz
bm
as
bc
ao
aq
"}
(12,1,1) = {"
bi
bi
bi
bi
bi
bi
bi
bL
bc
bc
bc
bc
aJ
"}
(13,1,1) = {"
bi
bi
bi
bi
bi
bi
bz
bm
Ok
bc
bN
bc
bt
"}
(14,1,1) = {"
bi
bi
bi
bi
bi
bi
Qw
af
af
af
af
af
zW
"}
