//MAP CONVERTED BY dmm2tgm.py THIS HEADER COMMENT PREVENTS RECONVERSION, DO NOT REMOVE
"ab" = (
/obj/structure/fence,
/turf/open/floor/plating{
	dir = 9;
	icon_state = "warnplate"
	},
/area/lv624/ground/river/central_river)
"ac" = (
/obj/effect/decal/cleanable/blood/drip,
/turf/open/floor/plating{
	dir = 1;
	icon_state = "asteroidwarning"
	},
/area/lv624/ground/river/central_river)
"ad" = (
/obj/structure/fence,
/turf/open/floor/plating{
	dir = 5;
	icon_state = "warnplate"
	},
/area/lv624/ground/river/central_river)
"ae" = (
/obj/structure/fence,
/turf/open/floor/plating{
	dir = 8;
	icon_state = "warnplate"
	},
/area/lv624/ground/river/central_river)
"af" = (
/obj/structure/fence,
/turf/open/floor/plating{
	dir = 4;
	icon_state = "warnplate"
	},
/area/lv624/ground/river/central_river)
"ag" = (
/obj/structure/fence,
/turf/open/floor/plating{
	dir = 10;
	icon_state = "warnplate"
	},
/area/lv624/ground/river/central_river)
"ah" = (
/obj/structure/fence,
/turf/open/floor/plating{
	dir = 6;
	icon_state = "warnplate"
	},
/area/lv624/ground/river/central_river)
"ai" = (
/turf/open/auto_turf/snow/layer2,
/area/lv624/ground/river/central_river)
"ak" = (
/turf/open/auto_turf/snow/layer0,
/area/lv624/ground/jungle/north_jungle)
"al" = (
/obj/effect/decal/cleanable/blood/drip,
/turf/open/floor/plating{
	dir = 1;
	icon_state = "asteroidfloor"
	},
/area/lv624/ground/river/central_river)
"iW" = (
/obj/effect/landmark/crap_item,
/turf/open/floor/plating{
	dir = 1;
	icon_state = "asteroidfloor"
	},
/area/lv624/ground/river/central_river)
"lS" = (
/turf/open/auto_turf/snow/layer2,
/area/lv624/ground/jungle/north_jungle)
"lW" = (
/obj/effect/landmark/lv624/fog_blocker,
/turf/open/auto_turf/ice/layer1,
/area/lv624/ground/river/central_river)
"lY" = (
/turf/open/floor/plating{
	dir = 2;
	icon_state = "asteroidwarning"
	},
/area/lv624/ground/river/central_river)
"mq" = (
/obj/structure/machinery/colony_floodlight,
/turf/open/auto_turf/snow/layer2,
/area/lv624/ground/river/central_river)
"ms" = (
/obj/effect/landmark/lv624/fog_blocker,
/turf/open/auto_turf/snow/layer2,
/area/lv624/ground/river/central_river)
"mD" = (
/obj/effect/landmark/lv624/fog_blocker,
/turf/open/auto_turf/snow/layer2,
/area/lv624/ground/jungle/north_jungle)
"qL" = (
/obj/effect/spawner/gibspawner/human,
/obj/effect/decal/cleanable/blood,
/turf/open/floor/plating{
	dir = 1;
	icon_state = "asteroidfloor"
	},
/area/lv624/ground/river/central_river)
"xB" = (
/obj/effect/landmark/crap_item,
/turf/open/auto_turf/snow/layer2,
/area/lv624/ground/jungle/north_jungle)
"yj" = (
/turf/open/auto_turf/ice/layer1,
/area/lv624/ground/river/central_river)
"yu" = (
/turf/closed/wall/shiva/ice,
/area/lv624/ground/jungle/north_jungle)
"BW" = (
/obj/effect/decal/cleanable/blood,
/turf/open/floor/plating{
	dir = 1;
	icon_state = "asteroidfloor"
	},
/area/lv624/ground/river/central_river)
"DX" = (
/turf/open/floor/plating{
	dir = 1;
	icon_state = "asteroidfloor"
	},
/area/lv624/ground/river/central_river)
"EG" = (
/obj/effect/landmark/lv624/fog_blocker,
/turf/open/auto_turf/snow/layer2,
/area/lv624/ground/jungle/north_east_jungle)
"KA" = (
/turf/open/auto_turf/snow/layer0,
/area/lv624/ground/river/central_river)
"Pz" = (
/turf/closed/wall/shiva/ice,
/area/lv624/ground/jungle/north_east_jungle)
"Uh" = (
/obj/effect/landmark/corpsespawner/miner,
/obj/effect/decal/cleanable/blood,
/turf/open/floor/plating{
	dir = 1;
	icon_state = "asteroidfloor"
	},
/area/lv624/ground/river/central_river)
"Wb" = (
/turf/open/auto_turf/snow/layer2,
/area/lv624/ground/jungle/north_east_jungle)
"Yw" = (
/turf/open/floor/plating{
	dir = 1;
	icon_state = "asteroidwarning"
	},
/area/lv624/ground/river/central_river)

(1,1,1) = {"
lW
lW
yj
yj
yj
yj
yj
yj
yj
ai
mD
lS
lS
"}
(2,1,1) = {"
lW
yj
yj
yj
yj
yj
yj
yj
yj
ms
lS
lS
lS
"}
(3,1,1) = {"
lW
yj
yj
yj
yj
yj
yj
yj
lW
ai
lS
lS
lS
"}
(4,1,1) = {"
lW
yj
yj
yj
yj
yj
yj
yj
lW
ai
xB
lS
yu
"}
(5,1,1) = {"
lW
lW
lW
lW
lW
lW
lW
lW
lW
mq
lS
ak
yu
"}
(6,1,1) = {"
ab
ae
ae
ae
ae
ae
ae
ae
ag
ai
ak
ak
ak
"}
(7,1,1) = {"
ac
al
Uh
DX
DX
DX
iW
DX
lY
KA
ak
ak
ak
"}
(8,1,1) = {"
Yw
DX
DX
DX
BW
al
al
qL
lY
KA
ak
ak
ak
"}
(9,1,1) = {"
Yw
DX
iW
DX
DX
DX
DX
DX
lY
KA
ak
ak
lS
"}
(10,1,1) = {"
ad
af
af
af
af
af
af
af
ah
KA
ak
lS
lS
"}
(11,1,1) = {"
lW
lW
lW
lW
lW
lW
lW
lW
lW
mq
lS
lS
lS
"}
(12,1,1) = {"
lW
yj
yj
yj
yj
yj
yj
yj
yj
ms
Wb
Wb
Pz
"}
(13,1,1) = {"
lW
yj
yj
yj
yj
yj
yj
yj
yj
ms
Wb
EG
Pz
"}
