//MAP CONVERTED BY dmm2tgm.py THIS HEADER COMMENT PREVENTS RECONVERSION, DO NOT REMOVE
"aa" = (
/turf/open/gm/river,
/area/lv624/ground/river/central_river)
"ab" = (
/obj/structure/fence,
/turf/open/floor/plating/warnplate/northwest,
/area/lv624/ground/river/central_river)
"ad" = (
/obj/structure/fence,
/turf/open/floor/plating/warnplate/northeast,
/area/lv624/ground/river/central_river)
"ae" = (
/obj/structure/fence,
/turf/open/floor/plating/warnplate/west,
/area/lv624/ground/river/central_river)
"af" = (
/obj/structure/fence,
/turf/open/floor/plating/warnplate/east,
/area/lv624/ground/river/central_river)
"ag" = (
/obj/structure/fence,
/turf/open/floor/plating/warnplate/southwest,
/area/lv624/ground/river/central_river)
"ah" = (
/obj/structure/fence,
/turf/open/floor/plating/warnplate/southeast,
/area/lv624/ground/river/central_river)
"ai" = (
/turf/open/gm/dirt,
/area/lv624/ground/river/central_river)
"aj" = (
/turf/open/gm/grass/grass1,
/area/lv624/ground/jungle/north_jungle)
"ak" = (
/turf/open/gm/grass/grass2,
/area/lv624/ground/jungle/north_jungle)
"al" = (
/obj/effect/decal/cleanable/blood/drip,
/turf/open/floor/plating/asteroidfloor/north,
/area/lv624/ground/river/central_river)
"am" = (
/obj/effect/decal/cleanable/blood/drip,
/turf/open/floor/plating/asteroidwarning/south,
/area/lv624/ground/river/central_river)
"an" = (
/turf/open/floor/plating/asteroidwarning/south,
/area/lv624/ground/river/central_river)
"ao" = (
/obj/effect/landmark/lv624/fog_blocker,
/turf/open/gm/coast/beachcorner2/south_west,
/area/lv624/ground/river/central_river)
"ap" = (
/turf/open/gm/coast/beachcorner2/north_east,
/area/lv624/ground/river/central_river)
"aq" = (
/turf/open/gm/coast/north,
/area/lv624/ground/river/central_river)
"ar" = (
/turf/open/gm/coast/beachcorner/north_east,
/area/lv624/ground/river/central_river)
"as" = (
/obj/effect/landmark/lv624/fog_blocker,
/obj/structure/flora/jungle/plantbot1,
/turf/open/gm/dirt,
/area/lv624/ground/river/central_river)
"at" = (
/obj/effect/landmark/lv624/fog_blocker,
/turf/open/gm/dirtgrassborder/south,
/area/lv624/ground/jungle/north_jungle)
"au" = (
/turf/open/gm/dirtgrassborder/south,
/area/lv624/ground/jungle/north_jungle)
"av" = (
/obj/effect/landmark/crap_item,
/turf/open/gm/dirtgrassborder/south,
/area/lv624/ground/jungle/north_jungle)
"aw" = (
/turf/open/gm/dirtgrassborder/south,
/area/lv624/ground/jungle/north_east_jungle)
"ax" = (
/obj/structure/flora/jungle/planttop1,
/turf/open/gm/dirtgrassborder/south,
/area/lv624/ground/jungle/north_east_jungle)
"iW" = (
/obj/effect/landmark/crap_item,
/turf/open/floor/plating/asteroidfloor/north,
/area/lv624/ground/river/central_river)
"jr" = (
/obj/effect/landmark/lv624/fog_blocker,
/turf/open/gm/coast/north,
/area/lv624/ground/river/central_river)
"km" = (
/obj/effect/landmark/lv624/fog_blocker,
/turf/open/gm/river,
/area/lv624/ground/river/central_river)
"lW" = (
/obj/effect/landmark/lv624/fog_blocker,
/turf/open/gm/coast/south,
/area/lv624/ground/river/central_river)
"mq" = (
/obj/structure/machinery/colony_floodlight,
/turf/open/gm/dirt,
/area/lv624/ground/river/central_river)
"mr" = (
/obj/effect/landmark/lv624/fog_blocker,
/turf/open/gm/dirt,
/area/lv624/ground/river/central_river)
"qL" = (
/obj/effect/spawner/gibspawner/human,
/obj/effect/decal/cleanable/blood,
/turf/open/floor/plating/asteroidfloor/north,
/area/lv624/ground/river/central_river)
"yu" = (
/turf/closed/wall/strata_ice/jungle,
/area/lv624/ground/jungle/north_jungle)
"BW" = (
/obj/effect/decal/cleanable/blood,
/turf/open/floor/plating/asteroidfloor/north,
/area/lv624/ground/river/central_river)
"DX" = (
/turf/open/floor/plating/asteroidfloor/north,
/area/lv624/ground/river/central_river)
"EG" = (
/obj/effect/landmark/lv624/fog_blocker,
/turf/open/gm/grass/grass2,
/area/lv624/ground/jungle/north_east_jungle)
"Pz" = (
/turf/closed/wall/strata_ice/jungle,
/area/lv624/ground/jungle/north_east_jungle)
"Uh" = (
/obj/effect/landmark/corpsespawner/miner,
/obj/effect/decal/cleanable/blood,
/turf/open/floor/plating/asteroidfloor/north,
/area/lv624/ground/river/central_river)
"VN" = (
/turf/open/gm/grass/grass1,
/area/lv624/ground/jungle/north_east_jungle)
"Yw" = (
/turf/open/floor/plating/asteroidwarning/north,
/area/lv624/ground/river/central_river)

(1,1,1) = {"
aj
aj
at
ai
aq
aa
aa
aa
aa
aa
aa
km
lW
"}
(2,1,1) = {"
aj
aj
au
mr
aq
aa
aa
aa
aa
aa
aa
aa
lW
"}
(3,1,1) = {"
aj
aj
au
ai
jr
aa
aa
aa
aa
aa
aa
aa
lW
"}
(4,1,1) = {"
yu
aj
av
ai
jr
aa
aa
aa
aa
aa
aa
aa
lW
"}
(5,1,1) = {"
yu
ak
au
mq
jr
km
km
km
km
km
km
km
lW
"}
(6,1,1) = {"
aj
aj
au
ai
ab
ae
ae
ae
ae
ae
ae
ae
ag
"}
(7,1,1) = {"
ak
aj
au
ai
Yw
DX
iW
DX
DX
DX
Uh
al
am
"}
(8,1,1) = {"
aj
aj
au
ai
Yw
qL
al
al
BW
DX
DX
DX
an
"}
(9,1,1) = {"
aj
aj
au
ai
Yw
DX
DX
DX
DX
DX
iW
DX
an
"}
(10,1,1) = {"
aj
aj
au
ai
ad
af
af
af
af
af
af
af
ah
"}
(11,1,1) = {"
aj
aj
au
mq
jr
km
km
km
km
km
km
km
lW
"}
(12,1,1) = {"
Pz
VN
aw
mr
aq
aa
aa
aa
aa
aa
aa
aa
ao
"}
(13,1,1) = {"
Pz
EG
ax
as
ar
ap
aa
aa
aa
aa
aa
aa
km
"}
