//MAP CONVERTED BY dmm2tgm.py THIS HEADER COMMENT PREVENTS RECONVERSION, DO NOT REMOVE
"ci" = (
/turf/open/gm/dirtgrassborder/grassdirt_corner2/north_east,
/area/lv624/ground/barrens/south_eastern_jungle_barrens)
"cG" = (
/turf/open/gm/dirt,
/area/lv624/ground/barrens/south_eastern_jungle_barrens)
"df" = (
/turf/closed/wall/strata_ice/jungle,
/area/lv624/ground/barrens/south_eastern_jungle_barrens)
"gn" = (
/obj/structure/flora/bush/ausbushes/var3/sunnybush,
/turf/open/gm/dirt,
/area/lv624/ground/barrens/south_eastern_jungle_barrens)
"gs" = (
/obj/structure/flora/bush/ausbushes/ausbush,
/turf/open/auto_turf/strata_grass/layer1,
/area/lv624/ground/jungle/east_jungle)
"kf" = (
/turf/open/auto_turf/strata_grass/layer1,
/area/lv624/ground/jungle/east_jungle)
"lm" = (
/obj/structure/flora/bush/ausbushes/grassybush,
/obj/effect/decal/grass_overlay/grass1/inner{
	dir = 1
	},
/turf/open/gm/dirt,
/area/lv624/ground/barrens/south_eastern_jungle_barrens)
"lD" = (
/obj/structure/flora/bush/ausbushes/var3/stalkybush,
/obj/effect/landmark/lv624/fog_blocker,
/turf/open/gm/dirt,
/area/lv624/ground/barrens/south_eastern_jungle_barrens)
"mK" = (
/obj/structure/flora/bush/ausbushes/reedbush,
/turf/closed/wall/strata_ice/jungle,
/area/lv624/ground/jungle/east_jungle)
"oA" = (
/turf/open/gm/grass/grass1,
/area/lv624/ground/barrens/south_eastern_jungle_barrens)
"pf" = (
/obj/structure/flora/bush/ausbushes/reedbush,
/turf/closed/wall/strata_ice/jungle,
/area/lv624/ground/barrens/south_eastern_jungle_barrens)
"rD" = (
/obj/effect/landmark/structure_spawner/setup/distress/xeno_weed_node,
/turf/open/gm/dirt,
/area/lv624/ground/barrens/south_eastern_jungle_barrens)
"rP" = (
/obj/structure/flora/bush/ausbushes/reedbush,
/obj/effect/landmark/lv624/fog_blocker,
/turf/open/gm/dirt,
/area/lv624/ground/barrens/south_eastern_jungle_barrens)
"sn" = (
/turf/closed/wall/strata_ice/jungle,
/area/lv624/ground/jungle/east_jungle)
"tn" = (
/obj/structure/flora/bush/ausbushes/var3/fullgrass,
/turf/open/gm/dirt{
	icon_state = "desert_dug"
	},
/area/lv624/ground/barrens/south_eastern_jungle_barrens)
"tN" = (
/turf/open/gm/dirt{
	icon_state = "desert3"
	},
/area/lv624/ground/barrens/south_eastern_jungle_barrens)
"tT" = (
/obj/effect/landmark/nightmare{
	insert_tag = "lv-rightsidepass"
	},
/turf/open/gm/dirt,
/area/lv624/ground/jungle/east_jungle)
"zT" = (
/obj/structure/flora/bush/ausbushes/ppflowers,
/turf/open/gm/dirt,
/area/lv624/ground/barrens/south_eastern_jungle_barrens)
"CA" = (
/obj/structure/flora/bush/ausbushes/var3/sunnybush,
/turf/open/gm/dirtgrassborder/grassdirt_corner/north_east,
/area/lv624/ground/barrens/south_eastern_jungle_barrens)
"CL" = (
/turf/open/auto_turf/strata_grass/layer1,
/area/lv624/ground/barrens/south_eastern_jungle_barrens)
"Ek" = (
/obj/effect/landmark/lv624/fog_blocker,
/turf/open/gm/dirt,
/area/lv624/ground/barrens/south_eastern_jungle_barrens)
"El" = (
/obj/structure/flora/bush/ausbushes/var3/stalkybush,
/turf/open/gm/dirt,
/area/lv624/ground/barrens/south_eastern_jungle_barrens)
"Kp" = (
/obj/structure/flora/bush/ausbushes/var3/fullgrass,
/turf/open/auto_turf/strata_grass/layer1,
/area/lv624/ground/jungle/east_jungle)
"Ov" = (
/turf/open/gm/dirtgrassborder/north,
/area/lv624/ground/barrens/south_eastern_jungle_barrens)
"Pb" = (
/obj/effect/decal/grass_overlay/grass1/inner{
	dir = 8
	},
/turf/open/gm/dirt,
/area/lv624/ground/jungle/east_jungle)
"PE" = (
/obj/structure/flora/bush/ausbushes/var3/fullgrass,
/obj/effect/decal/grass_overlay/grass1/inner{
	dir = 8
	},
/turf/open/gm/dirt,
/area/lv624/ground/jungle/east_jungle)
"PV" = (
/obj/effect/decal/grass_overlay/grass1/inner{
	dir = 1
	},
/turf/open/gm/dirt,
/area/lv624/ground/barrens/south_eastern_jungle_barrens)
"Qb" = (
/obj/structure/flora/bush/ausbushes/var3/stalkybush,
/turf/open/auto_turf/strata_grass/layer1,
/area/lv624/ground/barrens/south_eastern_jungle_barrens)
"Qz" = (
/turf/open/gm/dirt,
/area/lv624/ground/jungle/east_jungle)
"RJ" = (
/obj/structure/flora/bush/ausbushes/var3/fullgrass,
/turf/open/gm/dirtgrassborder/north,
/area/lv624/ground/barrens/south_eastern_jungle_barrens)
"TQ" = (
/obj/effect/decal/grass_overlay/grass1/inner{
	dir = 9
	},
/turf/open/gm/dirt,
/area/lv624/ground/barrens/south_eastern_jungle_barrens)
"Wq" = (
/turf/open/gm/dirt{
	icon_state = "desert2"
	},
/area/lv624/ground/barrens/south_eastern_jungle_barrens)
"WK" = (
/obj/structure/flora/bush/ausbushes/reedbush,
/turf/open/auto_turf/strata_grass/layer1,
/area/lv624/ground/jungle/east_jungle)
"Xe" = (
/obj/structure/flora/bush/ausbushes/lavendergrass,
/turf/open/gm/grass/grass2,
/area/lv624/ground/barrens/south_eastern_jungle_barrens)
"Xq" = (
/obj/structure/flora/bush/ausbushes/var3/fullgrass,
/turf/open/gm/dirt,
/area/lv624/ground/barrens/south_eastern_jungle_barrens)

(1,1,1) = {"
cG
gn
cG
Ek
lD
Ek
Ek
Ek
Ek
Ek
Ek
rP
Qz
Qz
Qz
Qz
Qz
Qz
Qz
tT
"}
(2,1,1) = {"
cG
Wq
cG
cG
cG
cG
cG
cG
cG
El
cG
cG
Pb
Pb
Pb
Pb
PE
Pb
Pb
Pb
"}
(3,1,1) = {"
ci
cG
cG
cG
cG
cG
cG
cG
cG
cG
cG
TQ
kf
kf
kf
Kp
kf
kf
kf
kf
"}
(4,1,1) = {"
Ov
cG
rD
cG
cG
cG
cG
cG
cG
cG
TQ
CL
kf
kf
kf
kf
kf
kf
kf
kf
"}
(5,1,1) = {"
Ov
cG
cG
tn
cG
cG
cG
cG
cG
TQ
Qb
CL
kf
kf
kf
kf
kf
kf
kf
kf
"}
(6,1,1) = {"
CA
ci
cG
cG
cG
cG
cG
tN
PV
CL
CL
CL
kf
kf
kf
kf
kf
kf
kf
kf
"}
(7,1,1) = {"
oA
RJ
cG
zT
cG
cG
cG
cG
PV
CL
CL
CL
kf
WK
kf
kf
kf
kf
kf
kf
"}
(8,1,1) = {"
Xe
Ov
cG
cG
Xq
cG
cG
cG
lm
CL
CL
CL
kf
kf
kf
kf
kf
gs
kf
kf
"}
(9,1,1) = {"
df
df
df
df
df
df
pf
df
df
df
df
df
mK
sn
mK
sn
sn
sn
sn
sn
"}
