//MAP CONVERTED BY dmm2tgm.py THIS HEADER COMMENT PREVENTS RECONVERSION, DO NOT REMOVE
"fv" = (
/obj/effect/landmark/objective_landmark/far,
/turf/open/auto_turf/snow/layer2,
/area/lv624/ground/jungle/south_west_jungle)
"lR" = (
/obj/item/weapon/unathiknife{
	desc = "A curved blade made of a strange material. It looks both old and very sharp.";
	force = 30;
	name = "\improper alien blade";
	throwforce = 26
	},
/turf/open/auto_turf/snow/layer3,
/area/lv624/ground/jungle/south_west_jungle)
"FE" = (
/obj/effect/landmark/hunter_primary,
/turf/open/auto_turf/snow/layer2,
/area/lv624/ground/jungle/south_west_jungle)
"LM" = (
/obj/effect/landmark/lv624/xeno_tunnel,
/turf/open/auto_turf/snow/layer2,
/area/lv624/ground/jungle/south_west_jungle)
"NU" = (
/turf/open/auto_turf/snow/layer0,
/area/lv624/ground/jungle/south_west_jungle)
"TE" = (
/turf/closed/wall/shiva/ice,
/area/lv624/ground/jungle/south_west_jungle)
"WQ" = (
/turf/open/auto_turf/snow/layer2,
/area/lv624/ground/jungle/south_west_jungle)
"XG" = (
/obj/effect/landmark/yautja_teleport,
/turf/open/auto_turf/snow/layer0,
/area/lv624/ground/jungle/south_west_jungle)
"ZL" = (
/turf/open/auto_turf/snow/layer3,
/area/lv624/ground/jungle/south_west_jungle)

(1,1,1) = {"
lR
ZL
TE
TE
TE
WQ
WQ
LM
TE
TE
TE
TE
LM
TE
"}
(2,1,1) = {"
WQ
ZL
WQ
TE
TE
WQ
WQ
WQ
WQ
TE
TE
WQ
WQ
WQ
"}
(3,1,1) = {"
WQ
WQ
ZL
TE
TE
ZL
WQ
TE
TE
TE
TE
WQ
WQ
WQ
"}
(4,1,1) = {"
WQ
WQ
ZL
ZL
TE
ZL
WQ
TE
TE
WQ
WQ
WQ
WQ
WQ
"}
(5,1,1) = {"
TE
WQ
TE
ZL
ZL
ZL
WQ
TE
WQ
WQ
NU
NU
WQ
TE
"}
(6,1,1) = {"
TE
WQ
WQ
WQ
ZL
WQ
WQ
WQ
WQ
NU
XG
NU
WQ
TE
"}
(7,1,1) = {"
WQ
WQ
WQ
WQ
ZL
WQ
fv
WQ
WQ
WQ
NU
WQ
WQ
WQ
"}
(8,1,1) = {"
WQ
WQ
WQ
WQ
WQ
WQ
WQ
WQ
WQ
WQ
NU
WQ
WQ
WQ
"}
(9,1,1) = {"
WQ
WQ
WQ
WQ
WQ
WQ
WQ
WQ
WQ
WQ
TE
FE
TE
TE
"}
(10,1,1) = {"
WQ
WQ
WQ
WQ
WQ
WQ
WQ
WQ
WQ
WQ
TE
TE
TE
TE
"}
(11,1,1) = {"
TE
WQ
WQ
WQ
WQ
ZL
ZL
ZL
WQ
WQ
TE
TE
TE
TE
"}
(12,1,1) = {"
ZL
WQ
WQ
WQ
WQ
TE
TE
ZL
ZL
WQ
WQ
WQ
TE
TE
"}
(13,1,1) = {"
ZL
ZL
WQ
ZL
ZL
TE
TE
TE
ZL
WQ
WQ
WQ
WQ
TE
"}
(14,1,1) = {"
ZL
ZL
TE
ZL
ZL
ZL
TE
TE
TE
TE
WQ
WQ
WQ
TE
"}
(15,1,1) = {"
TE
TE
TE
ZL
ZL
ZL
TE
TE
TE
TE
TE
WQ
WQ
TE
"}
