//MAP CONVERTED BY dmm2tgm.py THIS HEADER COMMENT PREVENTS RECONVERSION, DO NOT REMOVE
"b" = (
/turf/closed/wall/solaris/reinforced,
/area/bigredv2/caves/eta/xenobiology)
"c" = (
/turf/closed/wall/solaris,
/area/bigredv2/caves/eta/xenobiology)
"d" = (
/turf/open/floor{
	tag = "icon-darkredcorners2 (WEST)";
	icon_state = "darkredcorners2";
	dir = 8
	},
/area/bigredv2/caves/eta/xenobiology)
"e" = (
/obj/effect/decal/cleanable/blood,
/turf/open/floor{
	tag = "icon-dark";
	icon_state = "dark";
	dir = 2
	},
/area/bigredv2/caves/eta/xenobiology)
"f" = (
/obj/structure/machinery/light{
	dir = 4;
	icon_state = "tube1"
	},
/obj/effect/decal/cleanable/dirt,
/turf/open/floor{
	tag = "icon-darkredcorners2";
	icon_state = "darkredcorners2"
	},
/area/bigredv2/caves/eta/xenobiology)
"g" = (
/turf/open/mars,
/area/bigredv2/caves/eta/xenobiology)
"h" = (
/obj/effect/landmark/monkey_spawn,
/turf/open/mars,
/area/bigredv2/caves/eta/xenobiology)
"i" = (
/obj/structure/window/framed/solaris/reinforced,
/turf/open/floor/plating,
/area/bigredv2/caves/eta/xenobiology)
"j" = (
/obj/structure/bed/chair{
	dir = 8
	},
/turf/open/floor{
	tag = "icon-darkred2 (WEST)";
	icon_state = "darkred2";
	dir = 8
	},
/area/bigredv2/caves/eta/xenobiology)
"k" = (
/obj/effect/decal/cleanable/dirt,
/turf/open/floor{
	tag = "icon-dark";
	icon_state = "dark";
	dir = 2
	},
/area/bigredv2/caves/eta/xenobiology)
"l" = (
/obj/effect/decal/cleanable/dirt,
/turf/open/floor{
	tag = "icon-darkredcorners2";
	icon_state = "darkredcorners2"
	},
/area/bigredv2/caves/eta/xenobiology)
"m" = (
/obj/structure/bed/chair{
	dir = 4
	},
/turf/open/floor{
	tag = "icon-darkred2 (EAST)";
	icon_state = "darkred2";
	dir = 4
	},
/area/bigredv2/caves/eta/xenobiology)
"n" = (
/obj/item/toy/beach_ball,
/turf/open/ice,
/area/bigredv2/caves/eta/xenobiology)
"o" = (
/turf/open/ice,
/area/bigredv2/caves/eta/xenobiology)
"p" = (
/obj/structure/machinery/light{
	icon_state = "tube1";
	dir = 8
	},
/turf/open/mars,
/area/bigredv2/caves/eta/xenobiology)
"q" = (
/obj/structure/machinery/door/airlock/almayer/research/glass{
	dir = 4;
	name = "\improper Eta Lab Cell";
	req_access = list()
	},
/turf/open/floor{
	tag = "icon-dark";
	icon_state = "dark";
	dir = 2
	},
/area/bigredv2/caves/eta/xenobiology)
"r" = (
/turf/open/floor{
	tag = "icon-dark";
	icon_state = "dark";
	dir = 2
	},
/area/bigredv2/caves/eta/xenobiology)
"s" = (
/obj/effect/landmark/monkey_spawn,
/turf/open/floor{
	tag = "icon-dark";
	icon_state = "dark";
	dir = 2
	},
/area/bigredv2/caves/eta/xenobiology)
"t" = (
/mob/living/simple_animal/hostile/carp{
	faction = "neutral";
	name = "strange fish"
	},
/turf/open/ice,
/area/bigredv2/caves/eta/xenobiology)
"u" = (
/obj/structure/machinery/light{
	dir = 4
	},
/turf/open/ice,
/area/bigredv2/caves/eta/xenobiology)
"v" = (
/obj/structure/machinery/light{
	dir = 8;
	icon_state = "tube1";
	pixel_y = 0
	},
/obj/effect/alien/weeds/node,
/turf/open/floor{
	tag = "icon-darkredcorners2 (WEST)";
	icon_state = "darkredcorners2";
	dir = 8
	},
/area/bigredv2/caves/eta/xenobiology)
"w" = (
/obj/effect/alien/weeds/node,
/turf/open/mars,
/area/bigredv2/caves/eta/xenobiology)
"x" = (
/obj/item/toy/farwadoll,
/turf/open/ice,
/area/bigredv2/caves/eta/xenobiology)
"y" = (
/obj/structure/machinery/light{
	dir = 4;
	icon_state = "tube1"
	},
/obj/effect/decal/cleanable/dirt,
/obj/effect/alien/weeds/node,
/turf/open/floor{
	tag = "icon-darkredcorners2";
	icon_state = "darkredcorners2"
	},
/area/bigredv2/caves/eta/xenobiology)
"z" = (
/turf/open/mars{
	tag = "icon-mars_dirt_12";
	icon_state = "mars_dirt_12"
	},
/area/bigredv2/caves/eta/xenobiology)
"A" = (
/turf/open/floor{
	tag = "icon-darkredcorners2";
	icon_state = "darkredcorners2"
	},
/area/bigredv2/caves/eta/xenobiology)
"B" = (
/obj/structure/machinery/light{
	icon_state = "tube1";
	dir = 8
	},
/turf/open/mars_cave{
	tag = "icon-mars_dirt_7";
	icon_state = "mars_dirt_7"
	},
/area/bigredv2/caves/eta/xenobiology)
"C" = (
/obj/effect/landmark/xeno_spawn,
/obj/effect/alien/weeds/node,
/turf/open/mars{
	tag = "icon-mars_dirt_10";
	icon_state = "mars_dirt_10"
	},
/area/bigredv2/caves/eta/xenobiology)
"D" = (
/turf/open/mars{
	tag = "icon-mars_dirt_10";
	icon_state = "mars_dirt_10"
	},
/area/bigredv2/caves/eta/xenobiology)
"E" = (
/turf/open/mars_cave{
	tag = "icon-mars_dirt_6";
	icon_state = "mars_dirt_6"
	},
/area/bigredv2/caves/eta/xenobiology)
"F" = (
/turf/open/mars_cave{
	tag = "icon-mars_dirt_5";
	icon_state = "mars_dirt_5"
	},
/area/bigredv2/caves/eta/xenobiology)
"G" = (
/obj/structure/mineral_door/resin,
/turf/open/mars_cave{
	tag = "icon-mars_cave_22";
	icon_state = "mars_cave_22"
	},
/area/bigredv2/caves/eta/xenobiology)

(1,1,1) = {"
b
b
b
b
b
b
b
b
b
b
b
b
b
"}
(2,1,1) = {"
b
g
p
h
b
h
p
g
b
z
B
g
b
"}
(3,1,1) = {"
b
h
g
g
b
w
g
g
b
g
C
E
G
"}
(4,1,1) = {"
b
g
g
h
b
g
g
h
b
g
D
F
b
"}
(5,1,1) = {"
b
i
q
i
b
i
q
i
b
i
q
i
b
"}
(6,1,1) = {"
c
j
r
j
c
j
r
j
c
j
r
j
b
"}
(7,1,1) = {"
d
d
s
d
v
d
s
d
d
d
k
d
b
"}
(8,1,1) = {"
e
k
k
k
r
k
k
k
r
k
r
r
b
"}
(9,1,1) = {"
f
l
k
l
l
l
k
l
y
A
r
A
G
"}
(10,1,1) = {"
c
m
r
m
c
m
r
m
c
m
r
m
b
"}
(11,1,1) = {"
b
i
q
i
b
i
q
i
b
i
q
i
b
"}
(12,1,1) = {"
b
n
o
t
b
o
o
o
b
t
o
o
b
"}
(13,1,1) = {"
b
o
t
o
b
o
t
o
b
t
o
t
b
"}
(14,1,1) = {"
b
o
u
o
b
t
u
x
b
o
u
o
b
"}
(15,1,1) = {"
b
b
b
b
b
b
b
b
b
b
b
b
b
"}
