//MAP CONVERTED BY dmm2tgm.py THIS HEADER COMMENT PREVENTS RECONVERSION, DO NOT REMOVE
"a" = (
/turf/closed/wall/solaris/rock,
/area/bigredv2/caves)
"b" = (
/turf/open/mars_cave{
	tag = "icon-mars_cave_23";
	icon_state = "mars_cave_23"
	},
/area/bigredv2/outside/sw)
"c" = (
/turf/open/mars_cave{
	tag = "icon-mars_cave_5";
	icon_state = "mars_cave_5"
	},
/area/bigredv2/outside/sw)
"d" = (
/turf/open/mars_cave{
	tag = "icon-mars_cave_2";
	icon_state = "mars_cave_2"
	},
/area/bigredv2/outside/sw)
"e" = (
/turf/open/mars_cave{
	tag = "icon-mars_cave_11";
	icon_state = "mars_cave_11"
	},
/area/bigredv2/outside/sw)
"f" = (
/turf/open/mars_cave{
	tag = "icon-mars_cave_2";
	icon_state = "mars_cave_2"
	},
/area/bigredv2/caves_sw)
"g" = (
/turf/closed/wall/solaris/reinforced/hull,
/area/bigredv2/caves_sw)
"h" = (
/obj/structure/machinery/door/poddoor/two_tile{
	name = "\improper Eta Tunnel Lockdown"
	},
/turf/open/floor{
	tag = "icon-asteroidfloor (NORTH)";
	icon_state = "asteroidfloor";
	dir = 1
	},
/area/bigredv2/caves_sw)
"i" = (
/turf/open/floor{
	tag = "icon-asteroidfloor (NORTH)";
	icon_state = "asteroidfloor";
	dir = 1
	},
/area/bigredv2/caves_sw)
"k" = (
/turf/open/mars_cave{
	tag = "icon-mars_cave_6";
	icon_state = "mars_cave_6"
	},
/area/bigredv2/caves_sw)
"l" = (
/turf/open/mars_cave,
/area/bigredv2/caves_sw)
"m" = (
/turf/open/mars_cave{
	tag = "icon-mars_cave_7";
	icon_state = "mars_cave_7"
	},
/area/bigredv2/caves_sw)
"n" = (
/obj/effect/landmark{
	name = "crap_item"
	},
/turf/open/mars_cave{
	tag = "icon-mars_cave_2";
	icon_state = "mars_cave_2"
	},
/area/bigredv2/caves_sw)
"o" = (
/turf/open/mars_cave{
	tag = "icon-mars_cave_5";
	icon_state = "mars_cave_5"
	},
/area/bigredv2/caves_sw)
"p" = (
/turf/open/mars_cave{
	tag = "icon-mars_cave_2";
	icon_state = "mars_cave_2"
	},
/area/bigredv2/caves_research)
"q" = (
/obj/structure/mineral_door/resin,
/turf/open/mars_cave{
	tag = "icon-mars_cave_2";
	icon_state = "mars_cave_2"
	},
/area/bigredv2/caves_research)
"r" = (
/obj/effect/alien/weeds/node,
/turf/open/mars_cave{
	tag = "icon-mars_cave_2";
	icon_state = "mars_cave_2"
	},
/area/bigredv2/caves_research)
"s" = (
/turf/open/mars_cave{
	tag = "icon-mars_cave_10";
	icon_state = "mars_cave_10"
	},
/area/bigredv2/caves_research)
"t" = (
/obj/effect/landmark{
	name = "crap_item"
	},
/turf/open/mars_cave{
	tag = "icon-mars_cave_7";
	icon_state = "mars_cave_7"
	},
/area/bigredv2/caves_research)
"u" = (
/turf/open/mars_cave{
	tag = "icon-mars_cave_6";
	icon_state = "mars_cave_6"
	},
/area/bigredv2/caves_research)
"v" = (
/turf/open/mars_cave,
/area/bigredv2/caves_research)
"w" = (
/turf/open/mars_cave{
	tag = "icon-mars_cave_11";
	icon_state = "mars_cave_11"
	},
/area/bigredv2/caves_research)

(1,1,1) = {"
a
a
a
a
a
a
m
n
f
o
a
a
a
a
a
a
a
a
a
a
"}
(2,1,1) = {"
a
a
a
a
a
a
m
f
f
o
a
a
a
a
a
a
a
a
a
a
"}
(3,1,1) = {"
a
a
a
a
a
f
m
f
f
o
a
a
a
a
a
a
a
a
a
a
"}
(4,1,1) = {"
b
a
g
a
a
f
f
f
f
f
f
a
a
a
a
a
a
a
a
a
"}
(5,1,1) = {"
c
g
g
g
k
f
f
f
f
f
f
f
a
a
a
a
a
a
a
a
"}
(6,1,1) = {"
d
h
i
h
l
f
f
f
f
f
f
f
f
a
a
a
a
a
a
a
"}
(7,1,1) = {"
d
i
i
i
f
f
f
f
f
f
f
f
f
a
a
a
a
a
a
a
"}
(8,1,1) = {"
e
g
g
g
f
f
f
f
f
f
f
f
f
f
a
a
a
a
a
a
"}
(9,1,1) = {"
d
d
g
a
a
f
f
f
f
f
f
f
f
f
f
a
a
a
a
a
"}
(10,1,1) = {"
a
a
a
a
a
a
a
a
f
f
f
f
f
f
f
a
a
a
a
a
"}
(11,1,1) = {"
a
a
a
a
a
a
a
a
a
a
f
f
f
f
f
f
a
a
a
a
"}
(12,1,1) = {"
a
a
a
a
a
a
a
a
a
a
a
f
f
f
f
f
a
a
a
a
"}
(13,1,1) = {"
a
a
a
a
a
a
a
a
a
a
a
a
f
f
f
f
a
a
a
a
"}
(14,1,1) = {"
a
a
a
a
a
a
a
a
a
a
a
a
f
f
f
f
a
a
a
a
"}
(15,1,1) = {"
a
a
a
a
a
a
a
a
a
a
a
f
f
f
f
a
a
a
a
a
"}
(16,1,1) = {"
a
a
a
a
a
a
a
a
a
a
a
f
f
f
f
a
a
a
a
a
"}
(17,1,1) = {"
f
a
a
a
a
a
a
a
a
a
a
f
f
f
a
a
a
a
a
a
"}
(18,1,1) = {"
f
a
a
a
a
a
a
a
a
a
f
f
f
f
a
a
a
a
a
a
"}
(19,1,1) = {"
f
a
a
a
a
a
a
a
a
a
f
f
f
a
a
a
a
a
a
a
"}
(20,1,1) = {"
f
f
a
a
a
a
a
a
a
a
f
f
f
a
a
a
a
a
a
a
"}
(21,1,1) = {"
f
f
f
a
a
a
a
a
a
a
a
f
f
f
a
a
a
a
a
a
"}
(22,1,1) = {"
f
f
f
f
a
a
a
a
a
a
a
q
q
q
a
a
a
a
a
a
"}
(23,1,1) = {"
f
f
f
f
a
a
a
a
a
a
a
p
p
p
p
a
a
a
a
a
"}
(24,1,1) = {"
f
f
f
f
a
a
a
a
a
a
a
p
p
p
p
a
a
a
a
a
"}
(25,1,1) = {"
f
f
f
f
a
a
a
a
a
a
a
p
p
p
p
p
a
a
a
a
"}
(26,1,1) = {"
f
f
f
f
a
a
a
a
a
a
a
a
p
r
p
p
a
a
a
a
"}
(27,1,1) = {"
f
f
f
f
a
a
a
a
a
a
a
a
p
p
p
p
a
a
a
a
"}
(28,1,1) = {"
f
f
f
f
a
a
a
a
a
a
a
a
p
p
p
p
p
a
a
a
"}
(29,1,1) = {"
f
f
f
f
a
a
a
a
a
a
a
a
p
p
p
p
p
a
a
a
"}
(30,1,1) = {"
f
f
f
f
a
a
a
a
a
a
a
a
a
p
r
p
p
a
a
a
"}
(31,1,1) = {"
f
f
f
f
a
a
a
a
a
a
a
a
a
p
p
p
p
p
a
a
"}
(32,1,1) = {"
f
f
f
f
a
a
a
a
a
a
a
a
a
p
p
p
p
p
a
a
"}
(33,1,1) = {"
f
f
f
a
a
a
a
a
a
a
a
a
a
p
p
p
p
a
a
a
"}
(34,1,1) = {"
f
f
f
a
a
a
a
a
a
a
a
a
a
p
p
p
p
a
a
a
"}
(35,1,1) = {"
f
f
f
a
a
a
a
a
a
a
a
a
a
a
q
q
q
a
a
a
"}
(36,1,1) = {"
f
f
f
a
a
a
a
a
a
a
a
a
a
a
p
p
p
p
a
a
"}
(37,1,1) = {"
f
f
f
a
a
a
a
a
a
a
a
a
a
p
p
r
p
p
p
p
"}
(38,1,1) = {"
f
f
a
a
a
a
a
a
a
a
a
a
p
p
p
p
p
p
p
p
"}
(39,1,1) = {"
f
f
a
a
a
a
a
a
a
a
a
a
p
p
p
p
p
p
p
r
"}
(40,1,1) = {"
f
f
a
a
a
a
a
a
a
a
a
a
p
p
p
p
p
u
p
v
"}
(41,1,1) = {"
f
a
a
a
a
a
a
a
a
a
a
p
p
p
t
p
p
p
p
p
"}
(42,1,1) = {"
a
a
a
a
a
a
a
a
a
a
p
p
p
s
r
p
p
v
w
a
"}
