//MAP CONVERTED BY dmm2tgm.py THIS HEADER COMMENT PREVENTS RECONVERSION, DO NOT REMOVE
"aa" = (
/obj/structure/machinery/landinglight/ds1/delaythree{
	dir = 8;
	icon_state = "landingstripe";
	tag = "icon-landingstripe (WEST)"
	},
/turf/open/floor{
	dir = 8;
	icon_state = "asteroidwarning";
	tag = "icon-asteroidwarning (WEST)"
	},
/area/bigredv2/outside/space_port)
"ab" = (
/turf/open/floor{
	dir = 4;
	icon_state = "asteroidwarning";
	tag = "icon-asteroidwarning (EAST)"
	},
/area/bigredv2/outside/space_port)
"ac" = (
/turf/closed/wall/solaris/reinforced,
/area/bigredv2/outside/space_port)
"ad" = (
/obj/structure/window/framed/solaris/reinforced,
/turf/open/floor/plating,
/area/bigredv2/outside/space_port)
"ae" = (
/obj/structure/window_frame/solaris,
/turf/open/floor/plating,
/area/bigredv2/outside/space_port)
"ah" = (
/obj/structure/window_frame/solaris,
/obj/item/shard,
/turf/open/floor/plating,
/area/bigredv2/outside/space_port)
"ai" = (
/obj/structure/window/framed/solaris/reinforced,
/obj/structure/machinery/door/poddoor/shutters/almayer{
	id = "Spaceport2";
	name = "\improper Spaceport Shutters"
	},
/turf/open/floor/plating,
/area/bigredv2/outside/space_port)
"aj" = (
/obj/structure/machinery/light{
	dir = 4
	},
/turf/closed/wall/solaris/reinforced,
/area/bigredv2/outside/space_port)
"ak" = (
/turf/open/floor{
	dir = 1;
	icon_state = "asteroidfloor";
	tag = "icon-asteroidfloor (NORTH)"
	},
/area/bigredv2/outside/space_port)
"al" = (
/obj/item/shard,
/turf/open/floor{
	dir = 1;
	icon_state = "asteroidfloor";
	tag = "icon-asteroidfloor (NORTH)"
	},
/area/bigredv2/outside/space_port)
"am" = (
/obj/structure/largecrate/random/barrel,
/turf/open/floor{
	dir = 1;
	icon_state = "asteroidfloor";
	tag = "icon-asteroidfloor (NORTH)"
	},
/area/bigredv2/outside/space_port)
"an" = (
/obj/structure/surface/rack,
/obj/effect/spawner/random/toolbox,
/turf/open/floor{
	dir = 9;
	icon_state = "darkgreen2";
	tag = "icon-darkgreen2 (NORTHWEST)"
	},
/area/bigredv2/outside/space_port)
"ao" = (
/obj/structure/machinery/disposal,
/turf/open/floor{
	dir = 1;
	icon_state = "darkgreen2";
	tag = "icon-darkgreen2 (NORTH)"
	},
/area/bigredv2/outside/space_port)
"ap" = (
/obj/item/shard,
/turf/open/floor{
	dir = 1;
	icon_state = "darkgreen2";
	tag = "icon-darkgreen2 (NORTH)"
	},
/area/bigredv2/outside/space_port)
"aq" = (
/turf/open/floor{
	dir = 1;
	icon_state = "darkgreen2";
	tag = "icon-darkgreen2 (NORTH)"
	},
/area/bigredv2/outside/space_port)
"ar" = (
/obj/structure/noticeboard{
	pixel_x = 0;
	pixel_y = 30
	},
/turf/open/floor{
	dir = 1;
	icon_state = "darkgreen2";
	tag = "icon-darkgreen2 (NORTH)"
	},
/area/bigredv2/outside/space_port)
"as" = (
/obj/structure/machinery/vending/cigarette/colony,
/turf/open/floor{
	dir = 5;
	icon_state = "darkgreen2";
	tag = "icon-darkgreen2 (NORTHEAST)"
	},
/area/bigredv2/outside/space_port)
"at" = (
/turf/open/floor{
	dir = 1;
	icon_state = "asteroidwarning";
	tag = "icon-asteroidwarning (NORTH)"
	},
/area/bigredv2/outside/space_port)
"au" = (
/obj/effect/decal/cleanable/dirt,
/turf/open/floor{
	dir = 1;
	icon_state = "asteroidwarning";
	tag = "icon-asteroidwarning (NORTH)"
	},
/area/bigredv2/outside/space_port)
"av" = (
/obj/effect/landmark/crap_item,
/turf/open/floor{
	dir = 5;
	icon_state = "asteroidwarning";
	tag = "icon-asteroidwarning (NORTHEAST)"
	},
/area/bigredv2/outside/space_port)
"aw" = (
/turf/open/floor{
	dir = 2;
	icon_state = "dark";
	tag = "icon-dark"
	},
/area/bigredv2/outside/space_port)
"ax" = (
/obj/structure/pipes/standard/simple/hidden/green{
	dir = 6
	},
/obj/effect/decal/cleanable/dirt,
/turf/open/floor{
	dir = 2;
	icon_state = "dark";
	tag = "icon-dark"
	},
/area/bigredv2/outside/space_port)
"ay" = (
/obj/structure/pipes/standard/simple/hidden/green{
	dir = 4;
	layer = 2.4
	},
/turf/open/floor{
	dir = 2;
	icon_state = "dark";
	tag = "icon-dark"
	},
/area/bigredv2/outside/space_port)
"az" = (
/obj/structure/pipes/vents/pump{
	dir = 8
	},
/turf/open/floor{
	dir = 2;
	icon_state = "dark";
	tag = "icon-dark"
	},
/area/bigredv2/outside/space_port)
"aA" = (
/obj/effect/decal/cleanable/dirt,
/turf/open/floor{
	dir = 2;
	icon_state = "dark";
	tag = "icon-dark"
	},
/area/bigredv2/outside/space_port)
"aB" = (
/obj/structure/filingcabinet,
/obj/item/document_objective/report,
/turf/open/floor{
	dir = 4;
	icon_state = "darkgreen2";
	tag = "icon-darkgreen2 (EAST)"
	},
/area/bigredv2/outside/space_port)
"aC" = (
/obj/structure/pipes/standard/simple/hidden/green{
	dir = 6
	},
/turf/open/floor{
	dir = 1;
	icon_state = "asteroidfloor";
	tag = "icon-asteroidfloor (NORTH)"
	},
/area/bigredv2/outside/space_port)
"aD" = (
/obj/structure/pipes/standard/simple/hidden/green{
	dir = 4;
	layer = 2.4
	},
/turf/open/floor{
	dir = 1;
	icon_state = "asteroidfloor";
	tag = "icon-asteroidfloor (NORTH)"
	},
/area/bigredv2/outside/space_port)
"aE" = (
/obj/structure/pipes/standard/simple/hidden/green{
	dir = 4;
	layer = 2.4
	},
/obj/effect/decal/cleanable/dirt,
/turf/open/floor{
	dir = 1;
	icon_state = "asteroidfloor";
	tag = "icon-asteroidfloor (NORTH)"
	},
/area/bigredv2/outside/space_port)
"aF" = (
/obj/structure/pipes/standard/manifold/hidden/green{
	dir = 1
	},
/turf/open/floor{
	dir = 1;
	icon_state = "asteroidfloor";
	tag = "icon-asteroidfloor (NORTH)"
	},
/area/bigredv2/outside/space_port)
"aG" = (
/obj/structure/pipes/standard/simple/hidden/green{
	dir = 4;
	layer = 2.4
	},
/turf/open/floor{
	dir = 4;
	icon_state = "asteroidwarning";
	tag = "icon-asteroidwarning (EAST)"
	},
/area/bigredv2/outside/space_port)
"aI" = (
/obj/structure/pipes/standard/simple/hidden/green{
	dir = 4;
	layer = 2.4
	},
/obj/structure/machinery/door/airlock/multi_tile/almayer/generic{
	dir = 1;
	name = "\improper Spaceport"
	},
/turf/open/floor{
	dir = 2;
	icon_state = "dark";
	tag = "icon-dark"
	},
/area/bigredv2/outside/space_port)
"aJ" = (
/obj/structure/pipes/standard/simple/hidden/green{
	dir = 9
	},
/turf/open/floor{
	dir = 2;
	icon_state = "dark";
	tag = "icon-dark"
	},
/area/bigredv2/outside/space_port)
"aK" = (
/obj/effect/decal/cleanable/blood,
/turf/open/floor{
	dir = 2;
	icon_state = "dark";
	tag = "icon-dark"
	},
/area/bigredv2/outside/space_port)
"aL" = (
/obj/structure/surface/table,
/obj/item/device/flashlight/lamp,
/obj/structure/machinery/door_control{
	id = "Spaceport2";
	name = "Storm Shutters";
	pixel_x = 32;
	unacidable = 1;
	unslashable = 1
	},
/turf/open/floor{
	dir = 4;
	icon_state = "darkgreen2";
	tag = "icon-darkgreen2 (EAST)"
	},
/area/bigredv2/outside/space_port)
"aM" = (
/obj/structure/pipes/standard/simple/hidden/green,
/turf/open/floor{
	dir = 1;
	icon_state = "asteroidfloor";
	tag = "icon-asteroidfloor (NORTH)"
	},
/area/bigredv2/outside/space_port)
"aN" = (
/obj/effect/decal/cleanable/dirt,
/turf/open/floor{
	icon_state = "asteroidwarning";
	tag = "icon-asteroidwarning"
	},
/area/bigredv2/outside/space_port)
"aO" = (
/turf/open/floor{
	icon_state = "asteroidwarning";
	tag = "icon-asteroidwarning"
	},
/area/bigredv2/outside/space_port)
"aP" = (
/obj/structure/window/framed/solaris/reinforced,
/obj/structure/machinery/door/poddoor/shutters/almayer{
	dir = 4;
	id = "Spaceport2";
	name = "\improper Spaceport Shutters"
	},
/turf/open/floor/plating,
/area/bigredv2/outside/space_port)
"aQ" = (
/turf/open/floor{
	dir = 8;
	icon_state = "darkgreen2";
	tag = "icon-darkgreen2 (WEST)"
	},
/area/bigredv2/outside/space_port)
"aR" = (
/obj/structure/bed/chair/office/dark,
/turf/open/floor{
	dir = 2;
	icon_state = "dark";
	tag = "icon-dark"
	},
/area/bigredv2/outside/space_port)
"aS" = (
/obj/structure/bed/chair/office/dark{
	dir = 4;
	layer = 3.25
	},
/turf/open/floor{
	dir = 2;
	icon_state = "dark";
	tag = "icon-dark"
	},
/area/bigredv2/outside/space_port)
"aT" = (
/obj/structure/surface/table,
/obj/structure/machinery/computer/objective{
	dir = 8;
	icon_state = "medlaptop"
	},
/turf/open/floor{
	dir = 4;
	icon_state = "darkgreen2";
	tag = "icon-darkgreen2 (EAST)"
	},
/area/bigredv2/outside/space_port)
"aU" = (
/obj/structure/pipes/standard/simple/hidden/green{
	dir = 9
	},
/turf/open/floor{
	dir = 4;
	icon_state = "asteroidwarning";
	tag = "icon-asteroidwarning (EAST)"
	},
/area/bigredv2/outside/space_port)
"aV" = (
/obj/structure/largecrate,
/turf/open/floor{
	dir = 1;
	icon_state = "asteroidfloor";
	tag = "icon-asteroidfloor (NORTH)"
	},
/area/bigredv2/outside/space_port)
"aW" = (
/obj/effect/decal/cleanable/dirt,
/turf/open/floor{
	dir = 8;
	icon_state = "asteroidwarning";
	tag = "icon-asteroidwarning (WEST)"
	},
/area/bigredv2/outside/space_port)
"aX" = (
/obj/structure/pipes/standard/simple/hidden/green,
/obj/effect/decal/cleanable/dirt,
/turf/open/floor{
	dir = 1;
	icon_state = "asteroidfloor";
	tag = "icon-asteroidfloor (NORTH)"
	},
/area/bigredv2/outside/space_port)
"aY" = (
/obj/structure/surface/table,
/obj/effect/landmark/crap_item,
/turf/open/floor{
	dir = 10;
	icon_state = "darkgreen2";
	tag = "icon-darkgreen2 (SOUTHWEST)"
	},
/area/bigredv2/outside/space_port)
"aZ" = (
/obj/structure/surface/table,
/obj/structure/machinery/computer/security{
	dir = 1;
	icon_state = "cameras"
	},
/turf/open/floor{
	dir = 2;
	icon_state = "darkgreen2";
	tag = "icon-darkgreen2"
	},
/area/bigredv2/outside/space_port)
"ba" = (
/obj/structure/surface/table,
/obj/item/device/radio,
/turf/open/floor{
	dir = 2;
	icon_state = "darkgreen2";
	tag = "icon-darkgreen2"
	},
/area/bigredv2/outside/space_port)
"bb" = (
/turf/open/floor{
	dir = 2;
	icon_state = "darkgreen2";
	tag = "icon-darkgreen2"
	},
/area/bigredv2/outside/space_port)
"bc" = (
/obj/effect/decal/cleanable/dirt,
/turf/open/floor{
	dir = 2;
	icon_state = "darkgreen2";
	tag = "icon-darkgreen2"
	},
/area/bigredv2/outside/space_port)
"bd" = (
/obj/structure/surface/table,
/obj/item/paper,
/obj/item/tool/pen,
/turf/open/floor{
	dir = 2;
	icon_state = "darkgreen2";
	tag = "icon-darkgreen2"
	},
/area/bigredv2/outside/space_port)
"be" = (
/obj/structure/surface/table,
/obj/item/paper_bin,
/turf/open/floor{
	dir = 6;
	icon_state = "darkgreen2";
	tag = "icon-darkgreen2 (SOUTHEAST)"
	},
/area/bigredv2/outside/space_port)
"bh" = (
/turf/closed/wall/solaris/rock,
/area/bigredv2/caves)
"bi" = (
/turf/open/mars,
/area/bigredv2/outside/nw)
"bj" = (
/turf/open/mars{
	icon_state = "mars_dirt_11";
	tag = "icon-mars_dirt_11"
	},
/area/bigredv2/outside/nw)
"bk" = (
/obj/effect/decal/cleanable/dirt,
/turf/open/mars_cave{
	icon_state = "mars_dirt_4";
	tag = "icon-mars_dirt_4"
	},
/area/bigredv2/outside/nw)
"bl" = (
/turf/open/mars_cave{
	icon_state = "mars_dirt_4";
	tag = "icon-mars_dirt_4"
	},
/area/bigredv2/outside/nw)
"bm" = (
/turf/open/floor{
	dir = 10;
	icon_state = "asteroidwarning";
	tag = "icon-asteroidwarning (SOUTHWEST)"
	},
/area/bigredv2/outside/nw)
"bn" = (
/turf/open/floor{
	icon_state = "asteroidwarning";
	tag = "icon-asteroidwarning"
	},
/area/bigredv2/outside/nw)
"bo" = (
/obj/structure/pipes/standard/simple/hidden/green,
/turf/open/floor{
	icon_state = "asteroidwarning";
	tag = "icon-asteroidwarning"
	},
/area/bigredv2/outside/nw)
"bp" = (
/obj/effect/decal/cleanable/dirt,
/turf/open/floor{
	dir = 6;
	icon_state = "asteroidwarning";
	tag = "icon-asteroidwarning (SOUTHEAST)"
	},
/area/bigredv2/outside/nw)
"bq" = (
/obj/structure/lz_sign/solaris_sign,
/turf/open/floor{
	icon_state = "asteroidwarning";
	tag = "icon-asteroidwarning"
	},
/area/bigredv2/outside/nw)
"br" = (
/turf/open/floor{
	dir = 6;
	icon_state = "asteroidwarning";
	tag = "icon-asteroidwarning (SOUTHEAST)"
	},
/area/bigredv2/outside/nw)
"bs" = (
/turf/open/mars{
	icon_state = "mars_dirt_12";
	tag = "icon-mars_dirt_12"
	},
/area/bigredv2/outside/nw)
"bt" = (
/turf/open/mars{
	icon_state = "mars_dirt_13";
	tag = "icon-mars_dirt_13"
	},
/area/bigredv2/outside/nw)
"bu" = (
/obj/structure/fence,
/turf/open/mars_cave{
	icon_state = "mars_dirt_4";
	tag = "icon-mars_dirt_4"
	},
/area/bigredv2/outside/nw)
"bv" = (
/turf/open/floor{
	dir = 8;
	icon_state = "asteroidwarning";
	tag = "icon-asteroidwarning (WEST)"
	},
/area/bigredv2/outside/nw)
"bw" = (
/obj/structure/pipes/standard/simple/hidden/green,
/obj/effect/decal/cleanable/dirt,
/turf/open/floor{
	dir = 1;
	icon_state = "asteroidfloor";
	tag = "icon-asteroidfloor (NORTH)"
	},
/area/bigredv2/outside/nw)
"bx" = (
/obj/effect/decal/cleanable/dirt,
/turf/open/floor{
	dir = 4;
	icon_state = "asteroidwarning";
	tag = "icon-asteroidwarning (EAST)"
	},
/area/bigredv2/outside/nw)
"by" = (
/obj/effect/decal/cleanable/dirt,
/turf/open/mars,
/area/bigredv2/outside/nw)
"bz" = (
/obj/structure/pipes/standard/simple/hidden/green,
/turf/open/floor{
	dir = 1;
	icon_state = "asteroidfloor";
	tag = "icon-asteroidfloor (NORTH)"
	},
/area/bigredv2/outside/nw)
"bA" = (
/turf/open/mars{
	icon_state = "mars_dirt_10";
	tag = "icon-mars_dirt_10"
	},
/area/bigredv2/outside/nw)
"bB" = (
/obj/structure/fence,
/turf/open/mars{
	icon_state = "mars_dirt_10";
	tag = "icon-mars_dirt_10"
	},
/area/bigredv2/outside/nw)
"bC" = (
/obj/effect/decal/cleanable/dirt,
/turf/open/mars{
	icon_state = "mars_dirt_11";
	tag = "icon-mars_dirt_11"
	},
/area/bigredv2/outside/nw)
"bD" = (
/obj/effect/decal/cleanable/dirt,
/obj/structure/largecrate,
/turf/open/floor{
	dir = 9;
	icon_state = "asteroidwarning";
	tag = "icon-asteroidwarning (NORTHWEST)"
	},
/area/bigredv2/outside/nw)
"bE" = (
/turf/open/floor{
	dir = 1;
	icon_state = "asteroidwarning";
	tag = "icon-asteroidwarning (NORTH)"
	},
/area/bigredv2/outside/nw)
"bF" = (
/obj/effect/decal/cleanable/dirt,
/turf/open/floor{
	dir = 8;
	icon_state = "asteroidwarning";
	tag = "icon-asteroidwarning (WEST)"
	},
/area/bigredv2/outside/nw)
"bG" = (
/turf/open/floor{
	dir = 1;
	icon_state = "asteroidfloor";
	tag = "icon-asteroidfloor (NORTH)"
	},
/area/bigredv2/outside/nw)
"bH" = (
/obj/structure/cargo_container{
	icon_state = "WY 0,0";
	tag = "icon-WY 0,0"
	},
/turf/open/floor{
	dir = 1;
	icon_state = "asteroidfloor";
	tag = "icon-asteroidfloor (NORTH)"
	},
/area/bigredv2/outside/nw)
"bI" = (
/obj/structure/cargo_container{
	icon_state = "WY 1,0";
	tag = "icon-WY 1,0"
	},
/turf/open/floor{
	dir = 1;
	icon_state = "asteroidfloor";
	tag = "icon-asteroidfloor (NORTH)"
	},
/area/bigredv2/outside/nw)
"bJ" = (
/obj/structure/cargo_container{
	icon_state = "WY 2,0";
	tag = "icon-WY 2,0"
	},
/turf/open/floor{
	dir = 1;
	icon_state = "asteroidfloor";
	tag = "icon-asteroidfloor (NORTH)"
	},
/area/bigredv2/outside/nw)
"bK" = (
/obj/effect/landmark/crap_item,
/obj/effect/decal/cleanable/dirt,
/turf/open/floor{
	dir = 8;
	icon_state = "asteroidwarning";
	tag = "icon-asteroidwarning (WEST)"
	},
/area/bigredv2/outside/nw)
"bL" = (
/obj/structure/pipes/standard/simple/hidden/green{
	dir = 5
	},
/turf/open/floor{
	dir = 1;
	icon_state = "asteroidfloor";
	tag = "icon-asteroidfloor (NORTH)"
	},
/area/bigredv2/outside/nw)
"bM" = (
/obj/structure/pipes/standard/simple/hidden/green{
	dir = 4;
	layer = 2.4
	},
/turf/open/floor{
	dir = 1;
	icon_state = "asteroidfloor";
	tag = "icon-asteroidfloor (NORTH)"
	},
/area/bigredv2/outside/nw)
"bN" = (
/obj/structure/pipes/standard/simple/hidden/green{
	dir = 10
	},
/turf/open/floor{
	dir = 1;
	icon_state = "asteroidfloor";
	tag = "icon-asteroidfloor (NORTH)"
	},
/area/bigredv2/outside/nw)
"bP" = (
/obj/structure/cargo_container{
	icon_state = "gorg 0,0";
	tag = "icon-WY 0,0"
	},
/turf/open/floor{
	icon_state = "asteroidwarning";
	tag = "icon-asteroidwarning"
	},
/area/bigredv2/outside/nw)
"bQ" = (
/obj/structure/cargo_container{
	icon_state = "gorg 2,0";
	tag = "icon-WY 0,0"
	},
/turf/open/floor{
	icon_state = "asteroidwarning";
	tag = "icon-asteroidwarning"
	},
/area/bigredv2/outside/nw)
"bR" = (
/turf/open/floor{
	dir = 5;
	icon_state = "asteroidwarning";
	tag = "icon-asteroidwarning (NORTHWEST)"
	},
/area/bigredv2/outside/nw)
"bS" = (
/obj/effect/decal/cleanable/dirt,
/turf/open/floor{
	dir = 1;
	icon_state = "asteroidfloor";
	tag = "icon-asteroidfloor (NORTH)"
	},
/area/bigredv2/outside/nw)
"bT" = (
/obj/structure/fence,
/turf/open/mars,
/area/bigredv2/outside/nw)
"bU" = (
/turf/open/floor{
	dir = 4;
	icon_state = "asteroidwarning";
	tag = "icon-asteroidwarning (EAST)"
	},
/area/bigredv2/outside/nw)
"bV" = (
/obj/structure/pipes/standard/simple/hidden/green,
/turf/open/floor{
	dir = 4;
	icon_state = "asteroidwarning";
	tag = "icon-asteroidwarning (EAST)"
	},
/area/bigredv2/outside/nw)
"bW" = (
/obj/structure/fence,
/turf/open/mars{
	icon_state = "mars_dirt_3";
	tag = "icon-mars_dirt_3"
	},
/area/bigredv2/outside/nw)
"bX" = (
/obj/effect/decal/cleanable/dirt,
/turf/open/floor{
	icon_state = "asteroidwarning";
	tag = "icon-asteroidwarning"
	},
/area/bigredv2/outside/nw)
"bY" = (
/turf/open/floor{
	dir = 6;
	icon_state = "asteroidwarning";
	tag = "icon-asteroidwarning (NORTHWEST)"
	},
/area/bigredv2/outside/nw)
"bZ" = (
/obj/effect/decal/cleanable/dirt,
/turf/open/floor{
	dir = 1;
	icon_state = "asteroidwarning";
	tag = "icon-asteroidwarning (NORTH)"
	},
/area/bigredv2/outside/nw)
"ca" = (
/turf/open/mars{
	icon_state = "mars_dirt_9";
	tag = "icon-mars_dirt_9"
	},
/area/bigredv2/outside/nw)
"cb" = (
/turf/open/mars{
	icon_state = "mars_dirt_14";
	tag = "icon-mars_dirt_14"
	},
/area/bigredv2/outside/nw)
"cc" = (
/obj/effect/decal/cleanable/blood,
/obj/effect/landmark/corpsespawner/engineer,
/turf/open/floor{
	dir = 2;
	icon_state = "dark";
	tag = "icon-dark"
	},
/area/bigredv2/outside/space_port)

(1,1,1) = {"
aa
ak
ak
ak
ak
aD
ac
bh
bi
by
by
by
bE
bG
bG
bS
bG
bn
bi
"}
(2,1,1) = {"
ab
ab
ak
aC
aM
aU
ac
bi
bt
bj
bC
bj
bR
bU
bx
bU
bU
bY
bi
"}
(3,1,1) = {"
ac
ac
at
aD
aN
ac
ac
bj
bk
bu
bu
bu
bT
bT
bE
bn
bi
bi
bi
"}
(4,1,1) = {"
ac
ak
at
aE
aN
aV
ac
bk
bk
bu
bD
bF
bm
bT
bZ
bX
bi
bi
bi
"}
(5,1,1) = {"
ad
ak
at
aD
aO
ak
ac
bl
bl
bu
bE
bH
bP
bT
bZ
bn
bi
bi
bi
"}
(6,1,1) = {"
ae
al
au
aD
aO
aV
ac
bm
bk
bu
bE
bI
bQ
bT
bE
bn
by
bi
bi
"}
(7,1,1) = {"
ac
ak
au
aE
aO
ak
ac
bn
bu
bu
bE
bJ
bn
bT
bE
bn
bi
bi
bi
"}
(8,1,1) = {"
ac
am
au
aE
ak
aW
aW
bm
bv
bv
bF
bK
bv
bv
bG
bG
bv
bv
bv
"}
(9,1,1) = {"
ad
ak
at
aF
aM
aX
aM
bo
bw
bz
bz
bL
bG
bG
bG
bG
bG
bG
bS
"}
(10,1,1) = {"
ad
ak
av
aG
ab
ab
ab
bp
bx
bx
bG
bM
bG
bU
bU
bU
bU
bU
bU
"}
(11,1,1) = {"
ac
am
ak
aD
ak
ak
ac
bq
bu
bu
bE
bM
bn
bu
bl
bl
bl
bl
bl
"}
(12,1,1) = {"
ac
ac
aw
aI
aP
aP
ac
br
bl
bu
bE
bM
bn
bu
bl
bl
bl
bl
bl
"}
(13,1,1) = {"
ac
an
ax
aJ
aQ
aY
ac
bs
bs
bl
bE
bM
bG
bv
bv
bv
bv
bv
bv
"}
(14,1,1) = {"
ac
ao
ay
aA
aR
aZ
ac
bi
bi
bA
bE
bM
bG
bG
bG
bG
bG
bG
bG
"}
(15,1,1) = {"
ae
ap
az
aw
aK
ba
ai
bi
bi
bA
bE
bN
bz
bV
bV
bV
bV
bV
bV
"}
(16,1,1) = {"
ah
aq
aw
aA
aA
bb
ai
bi
bi
bB
bE
bG
bn
bu
bu
bs
bs
bl
bl
"}
(17,1,1) = {"
ai
aq
aA
cc
aw
bc
ai
bi
bi
bB
bE
bG
bn
bu
ca
bi
bi
cb
bs
"}
(18,1,1) = {"
ac
ar
aw
aA
aS
bd
ac
bi
bi
bB
bE
bG
bn
bW
bi
bi
bi
bi
bi
"}
(19,1,1) = {"
aj
as
aB
aL
aT
be
ac
bi
bi
bB
bE
bG
bn
bW
bi
bi
bi
bi
bi
"}
