//MAP CONVERTED BY dmm2tgm.py THIS HEADER COMMENT PREVENTS RECONVERSION, DO NOT REMOVE
"a" = (
/turf/open/gm/grass/grass1,
/area/lv624/ground/jungle/east_jungle)
"b" = (
/obj/structure/largecrate/random/barrel/blue,
/turf/open/floor/vault,
/area/lv624/lazarus/quartstorage)
"n" = (
/turf/closed/wall,
/area/lv624/lazarus/quartstorage)
"o" = (
/obj/effect/landmark/monkey_spawn,
/turf/open/gm/grass/grass1,
/area/lv624/ground/jungle/east_jungle)
"p" = (
/obj/structure/window/framed/colony/reinforced,
/turf/open/floor/plating,
/area/lv624/lazarus/quartstorage)
"q" = (
/obj/structure/largecrate,
/obj/structure/machinery/light/small,
/turf/open/floor/vault,
/area/lv624/lazarus/quartstorage)
"r" = (
/turf/open/floor/vault,
/area/lv624/lazarus/quartstorage)
"s" = (
/obj/structure/largecrate/supply/weapons/hpr,
/turf/open/floor/vault,
/area/lv624/lazarus/quartstorage)
"t" = (
/obj/structure/largecrate/supply/explosives/mines{
	unacidable = 1;
	unslashable = 1
	},
/turf/open/floor/vault,
/area/lv624/lazarus/quartstorage)
"u" = (
/obj/structure/window_frame/colony,
/turf/open/floor/plating,
/area/lv624/lazarus/quartstorage)
"v" = (
/obj/structure/largecrate,
/turf/open/floor/vault,
/area/lv624/lazarus/quartstorage)
"I" = (
/obj/item/defenses/handheld/sentry/flamer,
/obj/structure/closet/crate,
/turf/open/floor/vault,
/area/lv624/lazarus/quartstorage)

(1,1,1) = {"
I
v
q
n
n
"}
(2,1,1) = {"
r
r
b
p
a
"}
(3,1,1) = {"
r
r
s
p
a
"}
(4,1,1) = {"
v
r
t
p
a
"}
(5,1,1) = {"
p
p
u
n
o
"}
